game_id,home_team,away_team,week,season,home_pass_yards,home_rush_yards,away_pass_yards,away_rush_yards,home_total_yards,away_total_yards,avg_home_total_yards,avg_away_total_yards,avg_home_total_yards_against,avg_away_total_yards_against,home_total_offense_rank,away_total_offense_rank,home_total_defense_rank,away_total_defense_rank
2000_01_ARI_NYG,NYG,ARI,1,2000,172,223,318,43,395,361,0,0,0,0,30,30,30,30
2000_01_BAL_PIT,PIT,BAL,1,2000,199,30,199,140,229,339,0,0,0,0,30,30,30,30
2000_01_CAR_WAS,WAS,CAR,1,2000,234,162,183,112,396,295,0,0,0,0,30,30,30,30
2000_01_CHI_MIN,MIN,CHI,1,2000,190,186,290,153,376,443,0,0,0,0,30,30,30,30
2000_01_DEN_STL,LA,DEN,1,2000,441,80,307,150,521,457,0,0,0,0,30,30,30,30
2000_01_DET_NO,NO,DET,1,2000,169,106,100,98,275,198,0,0,0,0,30,30,30,30
2000_01_IND_KC,KC,IND,1,2000,212,74,273,119,286,392,0,0,0,0,30,30,30,30
2000_01_JAX_CLE,CLE,JAX,1,2000,160,96,301,119,256,420,0,0,0,0,30,30,30,30
2000_01_NYJ_GB,GB,NYJ,1,2000,152,62,261,118,214,379,0,0,0,0,30,30,30,30
2000_01_PHI_DAL,DAL,PHI,1,2000,135,67,130,306,202,436,0,0,0,0,30,30,30,30
2000_01_SD_OAK,LV,LAC,1,2000,176,67,197,76,243,273,0,0,0,0,30,30,30,30
2000_01_SEA_MIA,MIA,SEA,1,2000,134,181,84,71,315,155,0,0,0,0,30,30,30,30
2000_01_SF_ATL,ATL,SF,1,2000,264,95,253,92,359,345,0,0,0,0,30,30,30,30
2000_01_TB_NE,NE,TB,1,2000,216,88,167,140,304,307,0,0,0,0,30,30,30,30
2000_01_TEN_BUF,BUF,TEN,1,2000,174,129,152,53,303,205,0,0,0,0,30,30,30,30
2000_02_ATL_DEN,DEN,ATL,2,2000,268,152,171,47,420,218,457,359,521,345,29,19,30,18
2000_02_CAR_SF,SF,CAR,2,2000,307,90,364,98,397,462,345,295,359,396,18,12,19,25
2000_02_CHI_TB,TB,CHI,2,2000,186,156,96,116,342,212,307,443,304,376,15,28,15,21
2000_02_CLE_CIN,CIN,CLE,2,2000,250,111,259,105,361,364,0,256,0,420,1,8,1,26
2000_02_DAL_ARI,ARI,DAL,2,2000,243,98,243,90,341,333,361,202,395,436,20,4,24,27
2000_02_GB_BUF,BUF,GB,2,2000,259,89,269,40,348,309,303,214,205,379,13,6,5,22
2000_02_JAX_BAL,BAL,JAX,2,2000,262,89,386,46,351,432,339,420,229,256,17,26,7,9
2000_02_KC_TEN,TEN,KC,2,2000,255,121,144,62,376,206,205,286,303,392,5,11,14,23
2000_02_MIA_MIN,MIN,MIA,2,2000,355,125,175,49,480,224,376,315,443,155,21,16,28,2
2000_02_NE_NYJ,NYJ,NE,2,2000,281,59,229,100,340,329,379,304,214,307,22,14,6,16
2000_02_NO_SD,LAC,NO,2,2000,137,72,259,64,209,323,273,275,243,198,9,10,8,3
2000_02_NYG_PHI,PHI,NYG,2,2000,214,56,220,167,270,387,436,395,202,361,27,24,4,20
2000_02_OAK_IND,IND,LV,2,2000,367,111,207,152,478,359,392,243,286,273,23,7,12,10
2000_02_STL_SEA,SEA,LA,2,2000,245,101,386,97,346,483,155,521,315,457,2,30,17,29
2000_02_WAS_DET,DET,WAS,2,2000,194,62,245,104,256,349,198,396,275,295,3,25,11,13
2000_03_ATL_CAR,CAR,ATL,3,2000,241,59,174,108,300,282,378.5,288.5,371,438.5,21,7,18,25
2000_03_BAL_MIA,MIA,BAL,3,2000,160,106,189,118,266,307,269.5,345,428,426,6,15,23,22
2000_03_BUF_NYJ,NYJ,BUF,3,2000,188,91,291,80,279,371,359.5,325.5,316.5,261.5,17,13,8,5
2000_03_CIN_JAX,JAX,CIN,3,2000,176,84,183,71,260,254,426,361,345,364,23,18,13,17
2000_03_DAL_WAS,WAS,DAL,3,2000,241,107,185,153,348,338,372.5,267.5,227,351,20,5,2,14
2000_03_DEN_OAK,LV,DEN,3,2000,159,123,213,180,282,393,301,438.5,435,288.5,9,25,24,7
2000_03_MIN_NE,NE,MIN,3,2000,190,103,177,154,293,331,316.5,428,359.5,269.5,11,24,16,6
2000_03_NO_SEA,SEA,NO,3,2000,193,126,159,116,319,275,250.5,299,502,241,3,8,26,3
2000_03_NYG_CHI,CHI,NYG,3,2000,202,48,251,172,250,423,327.5,391,324.5,353,14,22,9,15
2000_03_PHI_GB,GB,PHI,3,2000,189,79,118,85,268,203,261.5,353,325.5,391,4,16,10,21
2000_03_PIT_CLE,CLE,PIT,3,2000,322,61,181,170,383,351,310,229,180.5,339,10,2,1,12
2000_03_SF_STL,LA,SF,3,2000,394,140,290,111,534,401,502,371,250.5,378.5,26,19,4,20
2000_03_TB_DET,DET,TB,3,2000,277,17,211,120,294,331,227,324.5,372.5,327.5,1,12,19,11
2000_04_CIN_BAL,BAL,CIN,4,2000,215,176,105,4,391,109,332.3333333333333,307.5,268.3333333333333,343,18,15,5,20
2000_04_CLE_OAK,LV,CLE,4,2000,179,113,156,89,292,245,294.6666666666667,334.3333333333333,423.3333333333333,269.6666666666667,12,20,27,6
2000_04_DET_CHI,CHI,DET,4,2000,261,147,207,80,408,287,301.6666666666667,249.33333333333334,401.6666666666667,326.6666666666667,13,3,26,17
2000_04_GB_ARI,ARI,GB,4,2000,189,28,288,176,217,464,351,263.6666666666667,267.5,303,21,4,4,15
2000_04_JAX_IND,IND,JAX,4,2000,440,93,229,97,533,326,435,370.6666666666667,301,325.3333333333333,27,23,13,16
2000_04_KC_DEN,DEN,KC,4,2000,208,145,250,49,353,299,423.3333333333333,246,294.6666666666667,290.5,26,2,11,8
2000_04_NE_MIA,MIA,NE,4,2000,153,99,161,56,252,217,268.3333333333333,308.6666666666667,332.3333333333333,395.6666666666667,5,16,18,25
2000_04_NYJ_TB,TB,NYJ,4,2000,135,119,204,98,254,302,326.6666666666667,332.6666666666667,249.33333333333334,340.6666666666667,17,19,2,19
2000_04_PHI_NO,NO,PHI,4,2000,163,146,222,67,309,289,291,303,273.3333333333333,263.6666666666667,11,14,7,3
2000_04_SEA_SD,LAC,SEA,4,2000,220,91,196,108,311,304,241,273.3333333333333,299,291,1,6,12,10
2000_04_SF_DAL,DAL,SF,4,2000,250,76,178,261,326,439,291,381,364.3333333333333,512.6666666666666,11,24,23,28
2000_04_STL_ATL,ATL,LA,4,2000,264,68,336,74,332,410,286.3333333333333,512.6666666666666,352.3333333333333,381,7,28,22,24
2000_04_TEN_PIT,PIT,TEN,4,2000,260,115,292,85,375,377,290,290.5,346.5,246,8,9,21,1
2000_04_WAS_NYG,NYG,WAS,4,2000,210,93,289,110,303,399,401.6666666666667,364.3333333333333,301.6666666666667,291,25,22,14,10
2000_05_ARI_SF,SF,ARI,5,2000,220,130,239,126,350,365,395.5,306.3333333333333,299.75,330.44444444444446,24,11,12,19
2000_05_ATL_PHI,PHI,ATL,5,2000,311,195,156,61,506,217,299.5,297.75,295.5,487,9,8,10,28
2000_05_BAL_CLE,CLE,BAL,5,2000,207,23,169,188,230,357,312,347,294,257.875,13,19,9,1
2000_05_CHI_GB,GB,CHI,5,2000,333,44,203,178,377,381,313.75,328.25,317.5,258.75,14,17,14,3
2000_05_DAL_CAR,CAR,DAL,5,2000,161,119,131,173,280,304,352.3333333333333,299.75,286.3333333333333,395.5,20,10,8,25
2000_05_IND_BUF,BUF,IND,5,2000,246,170,187,81,416,268,340.6666666666667,467.6666666666667,332.6666666666667,355.77777777777783,18,27,20,22
2000_05_MIA_CIN,CIN,MIA,5,2000,178,191,155,159,369,314,241.33333333333334,264.25,351.88888888888886,285.75,1,4,21,7
2000_05_MIN_DET,DET,MIN,5,2000,239,129,269,178,368,447,258.75,395.6666666666667,328.25,308.6666666666667,2,25,18,13
2000_05_NE_DEN,DEN,NE,5,2000,361,79,271,54,440,325,405.75,285.75,259.25,264.25,26,7,4,5
2000_05_NYG_TEN,TEN,NYG,5,2000,293,152,197,24,445,221,319.3333333333333,377,318.3333333333333,373,16,23,15,23
2000_05_PIT_JAX,JAX,PIT,5,2000,225,26,132,209,251,341,359.5,318.3333333333333,459.5,319.3333333333333,21,15,27,16
2000_05_SD_STL,LA,LAC,5,2000,465,163,348,48,628,396,487,264.3333333333333,297.75,283.55555555555554,28,5,11,6
2000_05_SEA_KC,KC,SEA,5,2000,256,136,140,186,392,326,263.6666666666667,281,399.88888888888886,258.5,3,6,26,2
2000_05_TB_WAS,WAS,TB,5,2000,207,145,202,72,352,274,373,308.5,377,325,22,12,24,17
2000_06_BAL_JAX,JAX,BAL,6,2000,260,95,154,56,355,210,337.8,349,322.8666666666667,295.6,16,20,13,6
2000_06_CLE_ARI,ARI,CLE,6,2000,171,146,138,104,317,242,321,295.6,384.125,349,11,8,23,20
2000_06_DEN_SD,LAC,DEN,6,2000,237,65,235,96,302,331,297.25,412.6,522.25,293.6,9,25,26,5
2000_06_GB_DET,DET,GB,6,2000,199,74,293,69,273,362,280.6,326.4,405.93333333333334,338.8,2,14,24,17
2000_06_IND_NE,NE,IND,6,2000,204,118,334,84,322,418,293.6,417.75,412.6,359.5,5,26,25,21
2000_06_NO_CHI,CHI,NO,6,2000,202,72,232,186,274,418,338.8,295.5,326.4,299.5,17,7,14,7
2000_06_NYG_ATL,ATL,NYG,6,2000,255,13,151,104,268,255,281.6,345.8,340.8,344.46666666666664,3,19,18,19
2000_06_OAK_SF,SF,LV,6,2000,336,136,310,164,472,474,386.4,294,318.06666666666666,312,23,6,12,11
2000_06_PIT_NYJ,NYJ,PIT,6,2000,99,112,140,193,211,333,325,324,308.5,332.375,13,12,10,15
2000_06_SEA_CAR,CAR,SEA,6,2000,332,125,172,63,457,235,334.25,290,300.8125,289.33333333333337,15,4,8,4
2000_06_TB_MIN,MIN,TB,6,2000,231,115,295,63,346,358,408.5,301.6,286.0625,368.8,24,10,3,22
2000_06_TEN_CIN,CIN,TEN,6,2000,85,129,230,203,214,433,273.25,350.75,276.6875,338,1,21,1,16
2000_06_WAS_PHI,PHI,WAS,6,2000,207,90,289,155,297,444,340.8,368.8,281.6,301.6,18,22,2,9
2000_07_ATL_STL,LA,ATL,7,2000,313,227,220,61,540,281,515.2,279.3333333333333,290.66666666666663,330.6666666666667,28,2,6,18
2000_07_BAL_WAS,WAS,BAL,7,2000,158,101,135,91,259,226,381.3333333333333,325.8333333333333,333.5,340.6666666666667,23,13,19,21
2000_07_CAR_NO,NO,CAR,7,2000,195,215,172,10,410,182,320,358.8,325.84000000000003,279,10,20,17,2
2000_07_CIN_PIT,PIT,CIN,7,2000,173,103,136,120,276,256,325.8,261.4,302.2,367.2,12,1,10,23
2000_07_CLE_DEN,DEN,CLE,7,2000,353,146,287,38,499,325,399,286.6666666666667,298.0416666666667,320.3333333333333,25,4,8,13
2000_07_DAL_NYG,NYG,DAL,7,2000,119,203,211,76,322,287,330.6666666666667,300.6,279.3333333333333,337.8666666666667,16,8,4,20
2000_07_IND_SEA,SEA,IND,7,2000,283,65,281,219,348,500,280.8333333333333,417.8,354.7083333333333,299.28000000000003,3,27,22,9
2000_07_JAX_TEN,TEN,JAX,7,2000,234,175,196,143,409,339,367.2,340.6666666666667,261.4,325.8333333333333,22,19,1,16
2000_07_MIN_CHI,CHI,MIN,7,2000,210,98,198,191,308,389,328,396,315.9166666666667,312.88,14,24,12,11
2000_07_NYJ_NE,NE,NYJ,7,2000,244,51,139,164,295,303,298.3333333333333,302.2,417.7916666666667,325.8,7,9,28,15
2000_07_OAK_KC,KC,LV,7,2000,288,58,244,161,346,405,295.75,330,292.25,403.52,5,15,7,26
2000_07_PHI_ARI,ARI,PHI,7,2000,213,98,226,172,311,398,320.2,333.5,284.88,381.3333333333333,11,18,5,24
2000_07_SD_BUF,BUF,LAC,7,2000,351,95,287,52,446,339,359.5,298.2,417.75,396.28000000000003,21,6,27,25
2000_07_SF_GB,GB,SF,7,2000,266,132,336,95,398,431,332.3333333333333,400.6666666666667,279.3333333333333,324,17,26,4,14
2000_08_ARI_DAL,DAL,ARI,8,2000,154,200,180,109,354,289,298.3333333333333,318.6666666666667,329.22222222222223,344.25,8,14,14,20
2000_08_BUF_MIN,MIN,BUF,8,2000,251,97,294,120,348,414,394.8333333333333,376.8,324.6666666666667,306.36,24,23,13,9
2000_08_CHI_PHI,PHI,CHI,8,2000,207,97,177,114,304,291,342.7142857142857,325.14285714285717,318.88571428571424,395,20,15,12,24
2000_08_CLE_PIT,PIT,CLE,8,2000,120,143,63,49,263,112,317.5,292.14285714285717,260.5,413.2857142857143,13,6,1,26
2000_08_DEN_CIN,CIN,DEN,8,2000,34,407,365,142,441,507,260.5,413.2857142857143,317.5,292.14285714285717,1,26,11,5
2000_08_DET_TB,TB,DET,8,2000,149,109,144,170,258,314,311,279.3333333333333,398.0833333333333,332.3333333333333,11,3,25,16
2000_08_MIA_NYJ,NYJ,MIA,8,2000,378,79,250,198,457,448,302.3333333333333,274.2,297.77777777777777,266.8666666666667,9,2,6,2
2000_08_NE_IND,IND,NE,8,2000,268,130,231,155,398,386,431.5,297.85714285714283,292.02777777777777,302.3142857142857,27,7,4,7
2000_08_NO_ATL,ATL,NO,8,2000,240,75,209,196,315,405,279.57142857142856,335,518.7428571428571,329.3333333333333,4,17,28,15
2000_08_SEA_OAK,LV,SEA,8,2000,176,206,149,137,382,286,342.5,290.42857142857144,304.125,429.54285714285714,19,5,8,27
2000_08_SF_CAR,CAR,SF,8,2000,309,98,307,128,407,435,329.3333333333333,405,335,341.7142857142857,16,25,17,19
2000_08_STL_KC,KC,LA,8,2000,375,106,390,66,481,456,305.8,519.3333333333334,345,279.6111111111111,10,28,21,3
2000_08_TEN_BAL,BAL,TEN,8,2000,290,113,101,90,403,191,311.57142857142856,374.1666666666667,363.85714285714283,340.3888888888889,12,22,22,18
2000_08_WAS_JAX,JAX,WAS,8,2000,271,146,269,130,417,399,340.42857142857144,363.85714285714283,373.1714285714285,311.57142857142856,18,21,23,10
2000_09_CAR_ATL,ATL,CAR,9,2000,191,97,202,30,288,232,284,340.42857142857144,343.75,409.2857142857143,2,17,17,26
2000_09_CIN_CLE,CLE,CIN,9,2000,147,54,84,179,201,263,269.625,286.2857142857143,310.6875,426.6734693877551,1,4,10,27
2000_09_DET_IND,IND,DET,9,2000,288,139,190,154,427,344,426.7142857142857,284.2857142857143,310.4489795918367,303.42857142857144,27,3,9,7
2000_09_GB_MIA,MIA,GB,9,2000,158,140,194,133,298,327,303.1666666666667,341.7142857142857,328.1111111111111,405,6,18,14,25
2000_09_JAX_DAL,DAL,JAX,9,2000,220,118,231,161,338,392,306.2857142857143,350,314.42857142857144,368.25,9,22,11,21
2000_09_KC_SEA,SEA,KC,9,2000,224,143,342,76,367,418,289.875,335,347.4375,508.77777777777783,5,15,18,28
2000_09_MIN_TB,TB,MIN,9,2000,267,152,313,99,419,412,303.42857142857144,388.14285714285717,284.2857142857143,382.11428571428576,7,25,2,23
2000_09_NO_ARI,ARI,NO,9,2000,289,125,167,89,414,256,314.42857142857144,345,306.2857142857143,284.63265306122446,11,19,8,3
2000_09_NYJ_BUF,BUF,NYJ,9,2000,253,86,293,51,339,344,383,324.42857142857144,387.02777777777777,299.0285714285714,24,13,24,6
2000_09_OAK_SD,LAC,LV,9,2000,222,29,156,83,251,239,305,348.14285714285717,373.9166666666667,289.79591836734693,8,21,22,4
2000_09_PHI_NYG,NYG,PHI,9,2000,253,152,129,72,405,201,329.42857142857144,337.875,298.6571428571429,320.875,14,16,5,12
2000_09_PIT_BAL,BAL,PIT,9,2000,152,135,133,120,287,253,323,309.7142857142857,351.27083333333337,266.40816326530614,12,10,20,1
2000_09_STL_SF,SF,LA,9,2000,243,92,310,149,335,459,408.75,510.2857142857143,339.04166666666663,330.8285714285715,26,28,16,15
2000_09_TEN_WAS,WAS,TEN,9,2000,202,90,96,96,292,192,368.25,348,350,324.6326530612245,23,20,19,13
2000_10_BAL_CIN,CIN,BAL,10,2000,137,44,244,142,181,386,283.375,319,261.046875,303.41269841269843,2,12,1,9
2000_10_BUF_NE,NE,BUF,10,2000,116,89,179,141,205,320,308.875,376.7142857142857,427.3125,327.2244897959184,9,25,29,14
2000_10_CAR_STL,LA,CAR,10,2000,431,31,214,90,462,304,503.875,326.875,399.53125,284.5,30,17,27,4
2000_10_DAL_PHI,PHI,DAL,10,2000,228,129,109,204,357,313,322.6666666666667,310.25,337.82539682539687,355.25,14,10,19,23
2000_10_DEN_NYJ,NYJ,DEN,10,2000,293,88,327,130,381,457,326.875,425,377.5,283.0625,17,28,25,2
2000_10_IND_CHI,CHI,IND,10,2000,227,143,302,90,370,392,320.875,426.75,337.875,291.75,13,29,20,5
2000_10_KC_OAK,LV,KC,10,2000,242,231,504,39,473,543,334.5,346.85714285714283,298.25,300.89285714285717,20,23,6,7
2000_10_MIA_DET,DET,MIA,10,2000,169,99,112,189,268,301,291.75,302.42857142857144,426.75,339.61224489795916,4,7,28,21
2000_10_MIN_GB,GB,MIN,10,2000,235,81,276,157,316,433,339.875,391.125,302.52083333333337,317.875,22,26,8,10
2000_10_NYG_CLE,CLE,NYG,10,2000,176,41,257,149,217,406,262,338.875,283.6984126984127,320.765625,1,21,3,12
2000_10_PIT_TEN,TEN,PIT,10,2000,227,148,112,74,375,186,328.5,302.625,358.71875,318.5,18,8,24,11
2000_10_SD_SEA,SEA,LAC,10,2000,85,50,283,116,135,399,298.44444444444446,297.2857142857143,344.22222222222223,332.5510204081633,6,5,22,17
2000_10_SF_NO,NO,SF,10,2000,288,111,262,84,399,346,333.875,400.55555555555554,326.875,504.5873015873015,19,27,13,30
2000_10_TB_ATL,ATL,TB,10,2000,247,59,146,126,306,272,284.44444444444446,317.875,328.3809523809524,391.125,3,11,15,26
2000_10_WAS_ARI,ARI,WAS,10,2000,146,45,276,164,191,440,326.875,359.77777777777777,333.875,330.6666666666667,17,24,18,16
2000_11_ARI_MIN,MIN,ARI,11,2000,306,158,219,51,464,270,395.77777777777777,311.77777777777777,337.22222222222223,368.69135802469134,27,11,19,24
2000_11_ATL_DET,DET,ATL,11,2000,128,107,126,114,235,240,289.1111111111111,286.6,302.26984126984127,313.2875,5,4,8,12
2000_11_BAL_TEN,TEN,BAL,11,2000,228,62,281,103,290,384,333.6666666666667,325.7,289.6666666666667,273.1375,18,14,6,2
2000_11_CHI_BUF,BUF,CHI,11,2000,200,105,146,99,305,245,369.625,326.3333333333333,295.890625,422.8888888888889,24,16,7,28
2000_11_CIN_DAL,DAL,CIN,11,2000,308,97,68,139,405,207,310.55555555555554,272,326.4814814814815,326.44444444444446,10,2,16,15
2000_11_GB_TB,TB,GB,11,2000,164,108,210,97,272,307,312.77777777777777,337.22222222222223,286.8395061728395,395.77777777777777,12,19,4,27
2000_11_KC_SF,SF,KC,11,2000,244,149,276,49,393,325,395.1,371.375,340.3875,351.8125,26,25,20,22
2000_11_MIA_SD,LAC,MIA,11,2000,178,82,160,84,260,244,310,302.25,278.0138888888889,288.78125,9,8,3,5
2000_11_NE_CLE,CLE,NE,11,2000,138,139,212,102,277,314,257.5,297.3333333333333,345.5875,370.41269841269843,1,7,21,25
2000_11_NO_CAR,CAR,NO,11,2000,295,53,179,157,348,336,324.3333333333333,341.1111111111111,499.22222222222223,394.4938271604938,13,20,30,26
2000_11_NYJ_IND,IND,NYJ,11,2000,210,148,271,96,358,367,422.8888888888889,332.8888888888889,326.3333333333333,428.55555555555554,28,17,14,29
2000_11_OAK_DEN,DEN,LV,11,2000,264,72,390,34,336,424,428.55555555555554,349.8888888888889,332.8888888888889,368.6507936507936,29,22,17,23
2000_11_PHI_PIT,PIT,PHI,11,2000,159,182,213,88,341,301,289.6666666666667,326.1,333.6666666666667,310.525,6,15,18,11
2000_11_SEA_JAX,JAX,SEA,11,2000,340,122,231,96,462,327,354.6666666666667,282.1,309.8095238095238,307.45714285714286,23,3,10,9
2000_11_STL_NYG,NYG,LA,11,2000,240,135,272,141,375,413,346.3333333333333,499.22222222222223,257,324.3333333333333,21,30,1,13
2000_12_ARI_PHI,PHI,ARI,12,2000,217,134,191,54,351,245,323.8181818181818,307.6,294.33333333333337,402.6,13,9,6,27
2000_12_ATL_SF,SF,ATL,12,2000,210,127,154,93,337,247,394.90909090909093,282.3636363636364,367.15909090909093,284.19191919191917,26,3,25,4
2000_12_BUF_KC,KC,BUF,12,2000,341,103,240,75,444,315,366.22222222222223,362.44444444444446,394.8666666666667,317.2962962962963,24,22,26,13
2000_12_CAR_MIN,MIN,CAR,12,2000,357,117,272,78,474,350,402.6,326.7,307.6,340.6,27,14,10,21
2000_12_CIN_NE,NE,CIN,12,2000,258,39,236,137,297,373,299,265.5,259.45,320,7,2,1,14
2000_12_CLE_TEN,TEN,CLE,12,2000,204,182,103,45,386,148,329.3,259.27272727272725,331.53,298.8484848484848,15,1,18,8
2000_12_DAL_BAL,BAL,DAL,12,2000,242,250,138,55,492,193,331,320,329.69696969696975,265.5,16,12,17,2
2000_12_DET_NYG,NYG,DET,12,2000,350,53,225,95,403,320,349.2,283.7,490.6,281.94,20,4,30,3
2000_12_IND_GB,GB,IND,12,2000,301,145,294,71,446,365,334.2,416.4,308.7,336.3,17,28,11,20
2000_12_JAX_PIT,PIT,JAX,12,2000,188,147,190,240,335,430,294.8,365.4,323.59000000000003,286.59000000000003,5,23,15,5
2000_12_NYJ_MIA,MIA,NYJ,12,2000,128,83,113,133,211,246,295.77777777777777,336.3,304.44444444444446,416.4,6,18,9,28
2000_12_OAK_NO,NO,LV,12,2000,226,133,168,159,359,327,340.6,357.3,326.7,419.3,19,21,16,29
2000_12_SD_DEN,DEN,LAC,12,2000,462,93,311,86,555,397,419.3,304.44444444444446,357.3,295.77777777777777,29,8,23,7
2000_12_TB_CHI,CHI,TB,12,2000,165,83,91,165,248,256,318.2,308.7,363.1625,334.2,11,10,24,19
2000_12_WAS_STL,LA,WAS,12,2000,366,50,269,138,416,407,490.6,367.8,349.2,313.2875,30,25,22,12
2000_13_ATL_OAK,LV,ATL,13,2000,231,270,182,31,501,213,354.54545454545456,279.4166666666667,342.27272727272725,390.0833333333333,22,3,16,26
2000_13_BUF_TB,TB,BUF,13,2000,106,114,319,139,220,458,303.90909090909093,357.7,311.8181818181818,374,10,23,10,25
2000_13_CHI_NYJ,NYJ,CHI,13,2000,218,59,98,135,277,233,328.09090909090907,311.8181818181818,288.0707070707071,303.90909090909093,15,12,4,8
2000_13_CLE_BAL,BAL,CLE,13,2000,214,247,138,28,461,166,344.4166666666667,250,309.4166666666667,334.02500000000003,20,1,9,15
2000_13_DEN_SEA,SEA,DEN,13,2000,274,85,244,301,359,545,286.1818181818182,431.6363636363636,364.42424242424244,312.85858585858585,4,29,22,11
2000_13_GB_CAR,CAR,GB,13,2000,243,133,267,87,376,354,328.8181818181818,344.3636363636364,409.09090909090907,411.72727272727275,16,19,27,28
2000_13_KC_SD,LAC,KC,13,2000,177,52,130,77,229,207,313.7,374,432.87000000000006,357.7,13,26,29,21
2000_13_MIA_IND,IND,MIA,13,2000,209,144,183,82,353,265,411.72727272727275,287.3,344.3636363636364,327.27000000000004,28,6,17,13
2000_13_MIN_DAL,DAL,MIN,13,2000,276,128,205,168,404,373,308.45454545454544,409.09090909090907,345.6363636363636,328.8181818181818,11,27,18,14
2000_13_NE_DET,DET,NE,13,2000,204,110,154,66,314,220,287,298.8181818181818,354.09090909090907,275.27272727272725,5,8,19,2
2000_13_NO_STL,LA,NO,13,2000,289,28,190,147,317,337,483.8181818181818,342.27272727272725,371.3636363636364,354.54545454545456,30,18,24,20
2000_13_NYG_ARI,ARI,NYG,13,2000,211,88,232,146,299,378,301.90909090909093,354.09090909090907,326.2892561983471,287,9,21,12,3
2000_13_PHI_WAS,WAS,PHI,13,2000,288,44,137,171,332,308,371.3636363636364,326.0833333333333,483.8181818181818,302.3833333333334,25,14,30,7
2000_13_PIT_CIN,CIN,PIT,13,2000,129,209,209,185,338,394,275.27272727272725,298.45454545454544,298.8181818181818,371.27272727272725,2,7,6,23
2000_13_TEN_JAX,JAX,TEN,13,2000,237,111,228,117,348,345,371.27272727272725,334.45454545454544,298.45454545454544,249.15702479338842,24,17,5,1
2000_14_ARI_CIN,CIN,ARI,14,2000,109,292,278,72,401,350,280.5,301.6666666666667,306.4166666666667,356.0833333333333,3,9,12,21
2000_14_CLE_JAX,JAX,CLE,14,2000,218,244,33,62,462,95,369.3333333333333,243.53846153846155,335.3333333333333,353.38461538461536,25,1,17,20
2000_14_DAL_TB,TB,DAL,14,2000,65,250,168,113,315,281,296.9166666666667,316.4166666666667,366.05833333333334,406.0833333333333,8,13,24,27
2000_14_DEN_NO,NO,DEN,14,2000,441,21,201,283,462,484,341.8333333333333,441.0833333333333,469.9166666666667,292.25,18,29,30,7
2000_14_DET_MIN,MIN,DET,14,2000,160,145,246,139,305,385,406.0833333333333,289.25,316.4166666666667,292.25,27,5,13,7
2000_14_GB_CHI,CHI,GB,14,2000,233,104,225,81,337,306,305.25,345.1666666666667,323.8333333333333,332.75,10,19,14,16
2000_14_IND_NYJ,NYJ,IND,14,2000,295,211,339,49,506,388,323.8333333333333,406.8333333333333,305.25,285.44166666666666,14,28,10,4
2000_14_KC_NE,NE,KC,14,2000,282,105,350,68,387,418,292.25,358.8181818181818,289.25,306,7,21,5,11
2000_14_MIA_BUF,BUF,MIA,14,2000,75,160,214,133,235,347,366.8181818181818,285.27272727272725,296.2809917355372,406.3884297520662,23,4,8,28
2000_14_NYG_WAS,WAS,NYG,14,2000,269,29,164,141,298,305,368.0833333333333,356.0833333333333,324.57638888888886,301.6666666666667,24,20,15,9
2000_14_OAK_PIT,PIT,LV,14,2000,143,199,273,117,342,390,306.4166666666667,366.75,280.5,273.88194444444446,12,22,3,1
2000_14_SEA_ATL,ATL,SEA,14,2000,233,97,252,83,330,335,274.3076923076923,292.25,365.81118881118886,441.0833333333333,2,7,23,29
2000_14_SF_SD,LAC,SF,14,2000,266,49,319,73,315,392,306,390.0833333333333,358.8181818181818,279.4166666666667,11,26,22,2
2000_14_STL_CAR,CAR,LA,14,2000,195,68,189,99,263,288,332.75,469.9166666666667,345.1666666666667,341.8333333333333,16,30,19,18
2000_14_TEN_PHI,PHI,TEN,14,2000,239,56,224,118,295,342,324.6923076923077,335.3333333333333,368.3356643356643,369.3333333333333,15,17,25,26
2000_15_ARI_JAX,JAX,ARI,15,2000,255,214,181,40,469,221,376.46153846153845,305.38461538461536,232.11242603550298,289.7692307692308,25,8,1,4
2000_15_BUF_IND,IND,BUF,15,2000,132,121,270,66,253,336,405.38461538461536,355.8333333333333,337.84615384615387,290.4166666666667,28,21,17,5
2000_15_CAR_KC,KC,CAR,15,2000,315,138,252,23,453,275,363.75,327.38461538461536,300.1458333333333,455.9230769230769,23,14,8,30
2000_15_CIN_TEN,TEN,CIN,15,2000,345,112,131,60,457,191,335.84615384615387,289.7692307692308,322.40828402366867,305.38461538461536,15,2,14,9
2000_15_DET_GB,GB,DET,15,2000,208,128,190,103,336,293,342.15384615384613,296.61538461538464,307.6923076923077,398.3076923076923,17,5,11,27
2000_15_MIN_STL,LA,MIN,15,2000,346,162,221,104,508,325,455.9230769230769,398.3076923076923,327.38461538461536,296.61538461538464,30,27,15,6
2000_15_NE_CHI,CHI,NE,15,2000,239,102,225,38,341,263,307.6923076923077,299.53846153846155,342.15384615384613,363.3706293706294,10,7,18,23
2000_15_NO_SF,SF,NO,15,2000,305,110,203,216,415,419,390.2307692307692,351.0769230769231,306.6923076923077,444.38461538461536,26,18,10,29
2000_15_NYJ_OAK,LV,NYJ,15,2000,161,180,315,10,341,325,368.53846153846155,337.84615384615387,309.15384615384613,405.38461538461536,24,16,12,28
2000_15_PHI_CLE,CLE,PHI,15,2000,332,101,390,41,433,431,232.92857142857142,322.57142857142856,375.9523809523809,335.8095238095238,1,13,25,16
2000_15_PIT_NYG,NYG,PIT,15,2000,333,68,224,47,401,271,352.15384615384613,309.15384615384613,362.6923076923077,368.53846153846155,19,11,22,24
2000_15_SD_BAL,BAL,LAC,15,2000,187,110,78,64,297,142,353.38461538461536,306.75,243.53846153846155,390.2430555555555,20,9,2,26
2000_15_SEA_DEN,DEN,SEA,15,2000,201,131,298,107,332,405,444.38461538461536,295.53846153846155,351.0769230769231,278.59171597633133,29,4,19,3
2000_15_TB_MIA,MIA,TB,15,2000,175,84,147,100,259,247,290.4166666666667,298.3076923076923,355.8333333333333,313.6923076923077,3,6,21,13
2000_15_WAS_DAL,DAL,WAS,15,2000,89,242,235,79,331,314,313.6923076923077,362.6923076923077,298.3076923076923,352.15384615384613,12,22,7,20
2000_16_ATL_NO,NO,ATL,16,2000,285,92,126,64,377,190,355.92857142857144,278.2857142857143,392,295.30357142857144,21,2,26,5
2000_16_BAL_ARI,ARI,BAL,16,2000,266,51,70,177,317,247,299.35714285714283,349.35714285714283,383.07142857142856,294.98214285714283,9,18,25,4
2000_16_CHI_SF,SF,CHI,16,2000,402,77,73,39,479,112,392,310.07142857142856,355.92857142857144,296.92857142857144,26,12,21,7
2000_16_DEN_KC,KC,DEN,16,2000,160,264,234,66,424,300,370.61538461538464,436.35714285714283,323.35502958579883,303.35714285714283,24,29,13,9
2000_16_DET_NYJ,NYJ,DET,16,2000,194,51,110,210,245,320,336.92857142857144,296.35714285714283,366.57142857142856,341.7142857142857,15,7,23,16
2000_16_GB_MIN,MIN,GB,16,2000,335,68,290,154,403,444,393.07142857142856,341.7142857142857,459.64285714285717,296.35714285714283,27,16,30,6
2000_16_IND_MIA,MIA,IND,16,2000,150,140,206,132,290,338,288,394.5,294.3609467455621,354.41666666666663,4,28,3,19
2000_16_JAX_CIN,CIN,JAX,16,2000,171,106,170,114,277,284,282.7142857142857,383.07142857142856,344.5,299.35714285714283,3,25,17,8
2000_16_NE_BUF,BUF,NE,16,2000,197,178,156,189,375,345,354.3076923076923,296.92857142857144,393.66272189349115,310.07142857142856,19,8,28,11
2000_16_NYG_DAL,DAL,NYG,16,2000,119,75,140,99,194,239,314.92857142857144,355.64285714285717,359.2142857142857,306.42857142857144,13,20,22,10
2000_16_OAK_SEA,SEA,LV,16,2000,177,173,136,227,350,363,303.35714285714283,366.57142857142856,436.35714285714283,336.92857142857144,10,23,29,15
2000_16_SD_CAR,CAR,LAC,16,2000,180,11,259,100,191,359,323.64285714285717,294.0769230769231,370.125,349.0473372781065,14,5,24,18
2000_16_STL_TB,TB,LA,16,2000,256,205,316,90,461,406,294.64285714285717,459.64285714285717,288.1726190476191,393.07142857142856,6,30,2,27
2000_16_TEN_CLE,CLE,TEN,16,2000,75,50,105,212,125,317,246.26666666666668,344.5,329.8,282.7142857142857,1,17,14,1
2000_16_WAS_PIT,PIT,WAS,16,2000,175,200,231,64,375,295,306.42857142857144,359.2142857142857,355.64285714285717,314.92857142857144,11,22,20,12
2000_17_ARI_WAS,WAS,ARI,17,2000,190,140,144,104,330,248,354.93333333333334,300.53333333333336,311,342.53333333333336,20,8,14,17
2000_17_BUF_SEA,SEA,BUF,17,2000,195,126,366,213,321,579,306.46666666666664,355.7857142857143,366.3333333333333,300.3622448979592,10,21,23,9
2000_17_CAR_OAK,LV,CAR,17,2000,230,179,235,79,409,314,366.3333333333333,314.8,306.46666666666664,298.4051282051283,23,13,12,8
2000_17_CHI_DET,DET,CHI,17,2000,170,100,183,105,270,288,297.93333333333334,296.8666666666667,330.8,397.8,5,4,16,28
2000_17_CIN_PHI,PHI,CIN,17,2000,198,138,183,102,336,285,329.8,282.3333333333333,246.26666666666668,376.46666666666664,14,2,2,25
2000_17_DAL_TEN,TEN,DAL,17,2000,216,158,35,86,374,121,342.6666666666667,306.8666666666667,238.18222222222224,347.8666666666667,17,11,1,18
2000_17_JAX_NYG,NYG,JAX,17,2000,321,80,262,70,401,332,347.8666666666667,376.46666666666664,306.8666666666667,282.3333333333333,18,25,13,4
2000_17_KC_ATL,ATL,KC,17,2000,163,131,230,49,294,279,272.4,374.42857142857144,357.3333333333333,426.6173469387755,1,24,22,29
2000_17_MIA_NE,NE,MIA,17,2000,312,37,271,47,349,318,300.1333333333333,288.14285714285717,355.6871794871795,390.4642857142857,7,3,21,26
2000_17_MIN_IND,IND,MIN,17,2000,283,128,175,67,411,242,390.73333333333335,393.73333333333335,288.1333333333333,348.53333333333336,26,27,5,19
2000_17_NYJ_BAL,BAL,NYJ,17,2000,99,64,481,51,163,532,342.53333333333336,330.8,300.53333333333336,297.93333333333334,16,15,10,7
2000_17_PIT_SD,LAC,PIT,17,2000,171,31,190,131,202,321,298.7142857142857,311,314.1683673469388,354.93333333333334,6,12,15,20
2000_17_SF_DEN,DEN,SF,17,2000,219,159,188,46,378,234,427.26666666666665,397.8,374.174358974359,296.8666666666667,29,28,24,6
2000_17_STL_NO,NO,LA,17,2000,208,73,248,246,281,494,357.3333333333333,456.06666666666666,272.4,305.73333333333335,22,30,3,11
2000_17_TB_GB,GB,TB,17,2000,196,135,237,56,331,293,348.53333333333336,305.73333333333335,393.73333333333335,456.06666666666666,19,9,27,30
2000_18_DEN_BAL,BAL,DEN,18,2000,130,122,178,42,252,220,331.3125,424.1875,343.375,387.5625,4,7,3,7
2000_18_IND_MIA,MIA,IND,18,2000,185,258,194,99,443,293,290.1333333333333,392,303.3911111111111,384.25,1,6,2,6
2000_18_STL_NO,NO,LA,18,2000,266,50,365,34,316,399,352.5625,458.4375,458.4375,352.5625,5,8,8,5
2000_18_TB_PHI,PHI,TB,18,2000,161,126,171,50,287,221,330.1875,304.9375,282.5,347.4375,3,2,1,4
2000_19_BAL_TEN,TEN,BAL,19,2000,195,126,117,49,321,166,344.625,326.6470588235294,295.25,412.1764705882353,4,2,1,7
2000_19_MIA_OAK,LV,MIA,19,2000,143,140,176,41,283,217,369,299.6875,314.75,385.8125,7,1,3,5
2000_19_NO_MIN,MIN,NO,19,2000,302,127,295,69,429,364,384.25,350.4117647058824,392,454.94117647058823,8,5,6,8
2000_19_PHI_NYG,NYG,PHI,19,2000,125,112,181,46,237,227,351.1875,327.6470588235294,373.6875,300,6,3,4,2
2000_20_BAL_OAK,LV,BAL,20,2000,187,24,190,110,211,300,363.94117647058823,317.72222222222223,294.8235294117647,343.3125,3,1,1,3
2000_20_MIN_NYG,NYG,MIN,20,2000,385,138,78,54,523,132,344.47058823529414,386.88235294117646,321.7266435986159,351.2110726643599,2,4,2,4
2000_21_BAL_NYG,NYG,BAL,21,2000,112,66,153,111,178,264,354.3888888888889,316.7894736842105,372.72222222222223,355.89164086687305,2,1,2,1
2001_01_ATL_SF,SF,ATL,1,2001,335,105,121,134,440,255,0,0,0,0,30,30,30,30
2001_01_CAR_MIN,MIN,CAR,1,2001,236,109,223,91,345,314,0,0,0,0,30,30,30,30
2001_01_CHI_BAL,BAL,CHI,1,2001,262,54,138,56,316,194,0,0,0,0,30,30,30,30
2001_01_DET_GB,GB,DET,1,2001,260,179,276,56,439,332,0,0,0,0,30,30,30,30
2001_01_IND_NYJ,NYJ,IND,1,2001,199,138,231,154,337,385,0,0,0,0,30,30,30,30
2001_01_MIA_TEN,TEN,MIA,1,2001,228,105,225,82,333,307,0,0,0,0,30,30,30,30
2001_01_NE_CIN,CIN,NE,1,2001,204,157,241,68,361,309,0,0,0,0,30,30,30,30
2001_01_NO_BUF,BUF,NO,1,2001,160,125,209,109,285,318,0,0,0,0,30,30,30,30
2001_01_NYG_DEN,DEN,NYG,1,2001,330,143,258,63,473,321,0,0,0,0,30,30,30,30
2001_01_OAK_KC,KC,LV,1,2001,222,35,341,100,257,441,0,0,0,0,30,30,30,30
2001_01_PIT_JAX,JAX,PIT,1,2001,198,101,181,120,299,301,0,0,0,0,30,30,30,30
2001_01_SEA_CLE,CLE,SEA,1,2001,176,90,178,101,266,279,0,0,0,0,30,30,30,30
2001_01_STL_PHI,PHI,LA,1,2001,312,57,308,82,369,390,0,0,0,0,30,30,30,30
2001_01_TB_DAL,DAL,TB,1,2001,34,99,195,71,133,266,0,0,0,0,30,30,30,30
2001_01_WAS_SD,LAC,WAS,1,2001,129,133,119,44,262,163,0,0,0,0,30,30,30,30
2001_02_BAL_CIN,CIN,BAL,2,2001,154,67,329,64,221,393,361,316,309,194,21,15,12,3
2001_02_BUF_IND,IND,BUF,2,2001,421,137,257,145,558,402,385,285,337,318,23,10,19,15
2001_02_CAR_ATL,ATL,CAR,2,2001,271,121,276,89,392,365,255,314,440,345,5,14,26,20
2001_02_DEN_ARI,ARI,DEN,2,2001,242,84,242,147,326,389,0,473,0,321,1,28,1,16
2001_02_DET_CLE,CLE,DET,2,2001,138,139,212,82,277,294,266,332,279,439,8,17,9,25
2001_02_MIN_CHI,CHI,MIN,2,2001,237,47,233,104,284,337,194,345,316,314,4,20,14,13
2001_02_NYG_KC,KC,NYG,2,2001,184,88,208,98,272,306,257,321,441,473,6,16,27,28
2001_02_NYJ_NE,NE,NYJ,2,2001,205,107,137,111,312,248,309,337,361,385,13,19,21,23
2001_02_OAK_MIA,MIA,LV,2,2001,217,144,125,96,361,221,307,441,333,257,12,27,18,5
2001_02_PHI_SEA,SEA,PHI,2,2001,62,126,283,102,188,385,279,369,266,390,9,22,8,24
2001_02_SD_DAL,DAL,LAC,2,2001,193,101,348,130,294,478,133,262,266,163,2,7,8,2
2001_02_STL_SF,SF,LA,2,2001,121,116,321,115,237,436,440,390,255,369,26,24,4,22
2001_02_TEN_JAX,JAX,TEN,2,2001,235,119,215,87,354,302,299,333,301,307,11,18,10,11
2001_02_WAS_GB,GB,WAS,2,2001,236,160,102,71,396,173,439,163,332,262,25,3,17,6
2001_03_ATL_ARI,ARI,ATL,3,2001,276,90,286,111,366,397,326,323.5,389,339.5,14,13,25,20
2001_03_BAL_DEN,DEN,BAL,3,2001,191,61,221,112,252,333,431,354.5,163,291,27,22,2,9
2001_03_CIN_SD,LAC,CIN,3,2001,133,133,135,111,266,246,370,291,213.5,354.5,23,7,4,22
2001_03_CLE_JAX,JAX,CLE,3,2001,170,98,249,95,268,344,326.5,271.5,317.5,313,15,6,15,13
2001_03_DAL_PHI,PHI,DAL,3,2001,162,131,77,181,293,258,377,213.5,233.5,370,24,2,5,23
2001_03_GB_CAR,CAR,GB,3,2001,160,36,308,75,196,383,339.5,417.5,323.5,168,19,26,16,3
2001_03_IND_NE,NE,IND,3,2001,168,177,253,82,345,335,310.5,471.5,292.5,343.5,10,28,10,21
2001_03_KC_WAS,WAS,KC,3,2001,116,111,347,200,227,547,168,264.5,417.5,313.5,1,4,27,14
2001_03_MIA_STL,LA,MIA,3,2001,328,123,204,64,451,268,413,334,338.5,331,25,17,19,17
2001_03_NO_NYG,NYG,NO,3,2001,135,153,291,74,288,365,313.5,318,264.5,285,11,12,7,8
2001_03_PIT_BUF,BUF,PIT,3,2001,148,52,107,170,200,277,343.5,301,471.5,299,21,9,28,11
2001_03_SEA_OAK,LV,SEA,3,2001,251,93,343,42,344,385,331,233.5,334,377,16,3,18,24
2001_03_SF_NYJ,NYJ,SF,3,2001,202,82,141,233,284,374,292.5,338.5,310.5,413,8,18,12,26
2001_03_TB_MIN,MIN,TB,3,2001,322,90,224,108,412,332,341,266,239,133,20,5,6,1
2001_04_ARI_PHI,PHI,ARI,4,2001,280,179,238,97,459,335,349,346,228.33333333333334,360.25,24,21,2,25
2001_04_CAR_SF,SF,CAR,4,2001,212,150,275,61,362,336,350.3333333333333,291.6666666666667,289.6666666666667,406,25,8,8,28
2001_04_CHI_ATL,ATL,CHI,4,2001,261,103,230,79,364,309,348,239,339.3333333333333,341,23,3,19,20
2001_04_CIN_PIT,PIT,CIN,4,2001,151,275,164,65,426,229,289,276,271.75,335.3333333333333,6,4,4,18
2001_04_DAL_OAK,LV,DAL,4,2001,209,101,130,108,310,238,335.3333333333333,228.33333333333334,284,349,19,2,6,22
2001_04_GB_TB,TB,GB,4,2001,184,99,258,69,283,327,299,406,376.5,291.6666666666667,11,29,27,9
2001_04_JAX_SEA,SEA,JAX,4,2001,219,185,233,57,404,290,284,307,335.3333333333333,295.6666666666667,5,13,18,11
2001_04_KC_DEN,DEN,KC,4,2001,121,197,283,42,318,325,371.3333333333333,358.6666666666667,347.3333333333333,187.66666666666666,28,26,21,1
2001_04_MIN_NO,NO,MIN,4,2001,210,160,332,34,370,366,341.5,364.6666666666667,300.75,288,20,27,12,7
2001_04_NE_MIA,MIA,NE,4,2001,87,209,86,80,296,166,312,322,425.6666666666667,426,14,17,29,30
2001_04_NYJ_BUF,BUF,NYJ,4,2001,325,162,173,162,487,335,295.6666666666667,289.6666666666667,293,350.3333333333333,10,7,10,23
2001_04_SD_CLE,CLE,LAC,4,2001,203,97,149,126,300,275,295.6666666666667,335.3333333333333,307,276,10,19,13,5
2001_04_STL_DET,DET,LA,4,2001,262,105,291,94,367,385,313,425.6666666666667,271.5,312,15,30,3,14
2001_04_TEN_BAL,BAL,TEN,4,2001,259,207,154,47,466,201,347.3333333333333,317.5,371.3333333333333,326.5,22,16,26,15
2001_04_WAS_NYG,NYG,WAS,4,2001,177,142,151,57,319,208,305,187.66666666666666,333.6666666666667,358.6666666666667,12,1,16,24
2001_05_ARI_CHI,CHI,ARI,5,2001,116,137,216,82,253,298,262.3333333333333,342.3333333333333,353.3333333333333,385.6666666666667,3,18,22,26
2001_05_BAL_GB,GB,BAL,5,2001,337,60,208,158,397,366,386.25,377,295,288.375,26,25,7,6
2001_05_CLE_CIN,CIN,CLE,5,2001,201,199,194,40,400,234,264.25,296.75,323.25,320.25,4,8,15,13
2001_05_DEN_SEA,SEA,DEN,5,2001,110,161,209,92,271,301,314,358,302.75,350.25,13,23,10,20
2001_05_DET_MIN,MIN,DET,5,2001,244,145,345,129,389,474,365,331,348.625,412.11111111111114,24,16,19,28
2001_05_MIA_NYJ,NYJ,MIA,5,2001,168,128,241,115,296,356,301,308,343.5,283,9,11,18,5
2001_05_NO_CAR,CAR,NO,5,2001,196,34,180,198,230,378,302.75,351,353.25,365.11111111111114,10,20,21,24
2001_05_NYG_STL,LA,NYG,5,2001,316,41,242,97,357,339,415.5,308.5,326.5,192.75,27,12,16,1
2001_05_OAK_IND,IND,LV,5,2001,241,118,243,101,359,344,426,329,322,230.75,28,15,14,2
2001_05_PIT_KC,KC,PIT,5,2001,127,165,141,203,292,344,350.25,334.6666666666667,358,260.3333333333333,19,17,23,4
2001_05_SD_NE,NE,LAC,5,2001,364,29,270,85,393,355,283,320.25,308,296.75,6,14,11,8
2001_05_SF_ATL,ATL,SF,5,2001,268,88,332,187,356,519,352,353.25,256.5,302.75,21,22,3,10
2001_05_TB_TEN,TEN,TB,5,2001,239,142,287,24,381,311,278.6666666666667,293.6666666666667,386.88888888888886,379.6666666666667,5,7,27,25
2001_05_WAS_DAL,DAL,WAS,5,2001,177,211,132,103,388,235,230.75,192.75,329,308.5,2,1,17,12
2001_06_ATL_NO,NO,ATL,6,2001,249,63,185,124,312,309,357.75,352.8,284.5625,386.4,19,18,4,24
2001_06_BAL_CLE,CLE,BAL,6,2001,149,88,262,113,237,375,284.2,374.8,291.4,388.4,3,22,5,25
2001_06_BUF_JAX,JAX,BUF,6,2001,150,115,238,98,265,336,302.75,343.5,314,301,8,16,11,7
2001_06_CAR_WAS,WAS,CAR,6,2001,346,98,226,124,444,350,201.2,288.2,262.2,356.4,1,4,2,20
2001_06_CHI_CIN,CIN,CHI,6,2001,244,35,232,203,279,435,291.4,260,284.2,331.25,5,2,3,15
2001_06_DEN_SD,LAC,DEN,6,2001,280,107,212,81,387,293,327.2,346.6,305,305.4,12,17,9,10
2001_06_GB_MIN,MIN,GB,6,2001,184,200,169,74,384,243,369.8,388.4,359.6,374.8,21,24,21,23
2001_06_KC_ARI,ARI,KC,6,2001,228,135,352,119,363,471,331.25,338.6,260,336.53333333333336,13,15,1,18
2001_06_NE_IND,IND,NE,6,2001,335,179,262,123,514,385,409.25,305,332.75,327.2,26,10,16,14
2001_06_PHI_NYG,NYG,PHI,6,2001,162,96,154,91,258,245,314.6,376.5,403.8,343.25,11,23,26,19
2001_06_PIT_TB,TB,PIT,6,2001,283,64,132,220,347,352,298,337,304.25,335.6875,6,14,8,17
2001_06_STL_NYJ,NYJ,LA,6,2001,142,132,225,190,274,415,300,403.8,317.6,314.6,7,25,13,12
2001_06_TEN_DET,DET,TEN,6,2001,338,41,237,102,379,339,366.75,304.25,371,298,20,9,22,6
2001_07_ARI_DAL,DAL,ARI,7,2001,93,145,233,75,238,308,262.2,337.6,201.2,365.08000000000004,2,16,1,24
2001_07_BUF_SD,LAC,BUF,7,2001,254,95,316,105,349,421,337.1666666666667,342,337.6666666666667,295.2,15,19,16,6
2001_07_CIN_DET,DET,CIN,7,2001,239,61,204,224,300,428,369.2,289.3333333333333,311.2,289.1666666666667,23,3,12,5
2001_07_IND_KC,KC,IND,7,2001,324,101,201,194,425,395,360.6666666666667,430.2,336.5416666666667,321,22,28,14,13
2001_07_JAX_BAL,BAL,JAX,7,2001,222,114,306,81,336,387,374.8333333333333,295.2,276.3333333333333,342,25,5,3,18
2001_07_MIA_SEA,SEA,MIA,7,2001,230,96,213,76,326,289,305.4,317.6,346.6,300,9,12,20,9
2001_07_MIN_TB,TB,MIN,7,2001,276,177,154,65,453,219,307.8,372.1666666666667,340,364.1666666666667,10,24,17,23
2001_07_NE_DEN,DEN,NE,7,2001,283,86,203,117,369,320,337.6666666666667,318.3333333333333,337.1666666666667,426.7083333333333,17,13,15,28
2001_07_NO_STL,LA,NO,7,2001,436,48,254,82,484,336,405.6666666666667,348.6,295.6666666666667,344.04,27,20,7,19
2001_07_NYG_WAS,WAS,NYG,7,2001,221,157,346,42,378,388,241.66666666666666,305.1666666666667,298.5,354.5833333333333,1,8,8,22
2001_07_NYJ_CAR,CAR,NYJ,7,2001,76,92,181,186,168,367,298.5,295.6666666666667,241.66666666666666,405.6666666666667,7,6,2,26
2001_07_OAK_PHI,PHI,LV,7,2001,133,78,158,202,211,360,350.2,332,303.28000000000003,412.6,21,14,10,27
2001_07_SF_CHI,CHI,SF,7,2001,229,135,269,83,364,352,295,386.4,288.91999999999996,352.8,4,26,4,21
2001_07_TEN_PIT,PIT,TEN,7,2001,289,133,175,57,422,232,340,311.2,307.8,369.2,18,11,11,25
2001_08_BAL_PIT,PIT,BAL,8,2001,236,123,158,41,359,199,353.6666666666667,369.2857142857143,298,308.3142857142857,21,25,4,7
2001_08_CAR_MIA,MIA,CAR,8,2001,287,59,199,103,346,302,312.8333333333333,279.85714285714283,308.8333333333333,305.85714285714283,10,4,8,5
2001_08_CLE_CHI,CHI,CLE,8,2001,357,99,211,70,456,281,306.5,276.3333333333333,380.6666666666667,374.8333333333333,7,3,26,25
2001_08_DAL_NYG,NYG,DAL,8,2001,280,93,262,86,373,348,317,258.1666666666667,261.14285714285717,332.6666666666667,11,1,2,14
2001_08_DEN_OAK,LV,DEN,8,2001,242,114,271,119,356,390,336.6666666666667,342.14285714285717,327,318.57142857142856,16,18,13,12
2001_08_DET_SF,SF,DET,8,2001,296,145,90,58,441,148,380.6666666666667,357.6666666666667,306.5,312.4444444444444,27,23,6,9
2001_08_IND_BUF,BUF,IND,8,2001,172,84,199,144,256,343,355.1666666666667,424.3333333333333,339.1388888888889,371.3888888888889,22,28,16,23
2001_08_JAX_TEN,TEN,JAX,8,2001,241,146,261,70,387,331,298,310.5,353.6666666666667,368.3611111111111,5,9,21,22
2001_08_KC_SD,LAC,KC,8,2001,282,66,186,208,348,394,338.85714285714283,369.85714285714283,353.2857142857143,425.1714285714285,17,26,20,28
2001_08_NE_ATL,ATL,NE,8,2001,151,140,250,135,291,385,345.5,318.57142857142856,350.125,342.14285714285717,19,12,19,17
2001_08_NYJ_NO,NO,NYJ,8,2001,164,108,145,142,272,287,346.5,305.85714285714283,418.72222222222223,279.85714285714283,20,6,27,3
2001_08_PHI_ARI,ARI,PHI,8,2001,293,57,238,113,350,351,332.6666666666667,327,258.1666666666667,336.6666666666667,15,13,1,15
2001_08_SEA_WAS,WAS,SEA,8,2001,152,226,248,60,378,308,261.14285714285717,308.8333333333333,317,312.8333333333333,2,8,11,10
2001_08_TB_GB,GB,TB,8,2001,180,184,177,61,364,238,364.1666666666667,332,372.1666666666667,346.6388888888889,24,14,24,18
2001_09_BAL_TEN,TEN,BAL,9,2001,256,90,181,77,346,258,310.7142857142857,348,313.42857142857144,354.33333333333337,7,22,7,25
2001_09_BUF_NE,NE,BUF,9,2001,107,134,204,69,241,273,326.875,341,338.6875,412.7142857142857,12,21,18,30
2001_09_CAR_STL,LA,CAR,9,2001,156,337,126,31,493,157,416.85714285714283,282.625,346.80000000000007,316.97916666666663,30,3,23,8
2001_09_CIN_JAX,JAX,CIN,9,2001,189,97,303,73,286,376,313.42857142857144,309.14285714285717,310.7142857142857,359.3142857142857,8,6,6,26
2001_09_DAL_ATL,ATL,DAL,9,2001,55,155,114,207,210,321,337.7142857142857,271,328.06122448979596,325,18,1,13,10
2001_09_GB_CHI,CHI,GB,9,2001,219,47,268,100,266,368,327.85714285714283,364.14285714285717,277,318.57142857142856,14,26,2,9
2001_09_KC_NYJ,NYJ,KC,9,2001,179,174,143,100,353,243,303.5,372.875,337.1875,340,4,27,17,20
2001_09_MIA_IND,IND,MIA,9,2001,253,65,259,134,318,393,412.7142857142857,317.57142857142856,341,283.02040816326524,29,9,21,4
2001_09_MIN_PHI,PHI,MIN,9,2001,223,272,285,56,495,341,330.42857142857144,350.2857142857143,335.14285714285717,328.54285714285714,15,24,16,14
2001_09_NO_SF,SF,NO,9,2001,252,164,347,152,416,499,389.2857142857143,335.85714285714283,327.7142857142857,303.1632653061224,28,17,11,5
2001_09_NYG_ARI,ARI,NYG,9,2001,172,78,155,186,250,341,335.14285714285717,324,330.42857142857144,269.39583333333337,16,11,15,1
2001_09_OAK_SEA,SEA,LV,9,2001,181,319,257,88,500,345,308.7142857142857,339.42857142857144,277.8367346938776,348.97959183673476,5,19,3,24
2001_09_PIT_CLE,CLE,PIT,9,2001,160,74,188,247,234,435,277,354.42857142857144,327.85714285714283,344.9591836734694,2,25,12,22
2001_09_SD_DEN,DEN,LAC,9,2001,224,117,165,96,341,261,348.125,340,339.08333333333337,372.875,23,20,19,28
2001_09_TB_DET,DET,TB,9,2001,239,52,188,99,291,287,327.7142857142857,318.57142857142856,389.2857142857143,364.14285714285717,13,10,29,27
2001_10_ATL_GB,GB,ATL,10,2001,262,70,352,82,332,434,364.625,321.75,320.125,277.25,27,12,10,3
2001_10_CHI_TB,TB,CHI,10,2001,404,19,228,68,423,296,314.625,320.125,323.125,364.625,7,11,12,27
2001_10_CLE_BAL,BAL,CLE,10,2001,261,108,144,95,369,239,338,271.625,314.63492063492066,364.5,20,2,7,26
2001_10_DET_ARI,ARI,DET,10,2001,334,89,436,49,423,485,324.5,323.125,326.125,314.625,14,13,14,6
2001_10_IND_NO,NO,IND,10,2001,249,157,262,77,406,339,356.25,400.875,392.625,327,25,29,28,15
2001_10_JAX_PIT,PIT,JAX,10,2001,266,145,225,48,411,273,364.5,310,271.625,317.5,26,6,2,9
2001_10_NYG_MIN,MIN,NYG,10,2001,277,96,321,61,373,382,349.125,325.8888888888889,351,325.6825396825397,23,15,23,13
2001_10_NYJ_MIA,MIA,NYJ,10,2001,188,78,76,86,266,162,327,309,400.875,358.44444444444446,16,5,29,25
2001_10_PHI_DAL,DAL,PHI,10,2001,102,132,129,98,234,227,277.25,351,321.75,349.125,4,24,11,22
2001_10_SD_OAK,LV,LAC,10,2001,311,88,98,152,399,250,340.125,331.22222222222223,332.625,347.3333333333333,21,17,17,21
2001_10_SEA_BUF,BUF,SEA,10,2001,316,69,134,112,385,246,332.5,332.625,316.140625,340.125,18,19,8,20
2001_10_SF_CAR,CAR,SF,10,2001,177,103,305,121,280,426,268.6666666666667,392.625,425.3174603174603,356.25,1,28,30,24
2001_10_STL_NE,NE,LA,10,2001,185,51,401,86,236,487,317.3333333333333,426.375,333.44444444444446,266.921875,9,30,18,1
2001_10_TEN_CIN,CIN,TEN,10,2001,234,40,172,129,274,301,317.5,315.125,310,336.75,10,8,5,19
2001_10_WAS_DEN,DEN,WAS,10,2001,114,88,150,118,202,268,347.3333333333333,275.75,331.22222222222223,308.72916666666663,22,3,16,4
2001_11_ARI_SD,LAC,ARI,11,2001,308,84,241,71,392,312,323.1,335.44444444444446,346.0125,341.1111111111111,12,17,23,21
2001_11_ATL_CAR,CAR,ATL,11,2001,171,96,132,145,267,277,269.8,334.22222222222223,395.9625,361,2,16,29,25
2001_11_BAL_JAX,JAX,BAL,11,2001,259,75,259,115,334,374,305.8888888888889,341.1,369.6666666666667,268.3625,5,20,27,1
2001_11_CHI_MIN,MIN,CHI,11,2001,209,124,97,142,333,239,351.77777777777777,317.44444444444446,332.1234567901235,326.6666666666667,23,9,16,14
2001_11_CIN_CLE,CLE,CIN,11,2001,189,78,125,84,267,209,268,312.6666666666667,341.44444444444446,313.55555555555554,1,7,22,10
2001_11_DEN_DAL,DAL,DEN,11,2001,192,27,171,119,219,290,272.44444444444446,332.8,337.22222222222223,274.975,3,15,19,4
2001_11_GB_DET,DET,GB,11,2001,207,167,252,104,374,356,341.1111111111111,361,335.44444444444446,334.22222222222223,21,25,18,17
2001_11_MIA_BUF,BUF,MIA,11,2001,309,127,277,101,436,378,338.3333333333333,320.22222222222223,323,292.6666666666667,19,10,13,5
2001_11_NO_NE,NE,NO,11,2001,258,191,307,121,449,428,309.2,361.77777777777777,432.4375,394,6,26,30,28
2001_11_OAK_NYG,NYG,LV,11,2001,184,153,221,119,337,340,331.5,346.6666666666667,351.5125,322.1975308641975,14,22,24,12
2001_11_PIT_TEN,TEN,PIT,11,2001,334,81,254,130,415,384,313.55555555555554,369.6666666666667,312.6666666666667,305.8888888888889,8,27,9,6
2001_11_SEA_KC,KC,SEA,11,2001,256,188,162,65,444,227,358.44444444444446,323,309,338.3333333333333,24,11,8,20
2001_11_SF_IND,IND,SF,11,2001,370,127,179,171,497,350,394,396.3333333333333,361.77777777777777,269.9259259259259,28,29,26,2
2001_11_TB_STL,LA,TB,11,2001,291,76,185,91,367,276,433.1111111111111,326.6666666666667,308.2962962962963,317.44444444444446,30,13,7,11
2001_11_WAS_PHI,PHI,WAS,11,2001,92,94,96,155,186,251,337.22222222222223,274.8888888888889,272.44444444444446,331.18518518518516,18,4,3,15
2001_12_ARI_OAK,LV,ARI,12,2001,302,135,249,145,437,394,346,333.1,332.05,329.99,21,18,18,17
2001_12_BUF_SF,SF,BUF,12,2001,189,230,168,29,419,197,391.7,348.1,404.3,326,28,22,29,14
2001_12_CAR_NO,NO,CAR,12,2001,330,125,161,49,455,210,368.4,269.54545454545456,323.17999999999995,329.020202020202,26,3,12,16
2001_12_DAL_WAS,WAS,DAL,12,2001,216,81,130,215,297,345,272.5,267.1,322.1,328.52000000000004,4,1,11,15
2001_12_DEN_MIA,MIA,DEN,12,2001,176,42,135,147,218,282,326,328.90909090909093,348.1,267.5858585858586,14,16,22,1
2001_12_DET_CHI,CHI,DET,12,2001,124,108,256,67,232,323,309.6,344.4,349.9,360.5,8,20,23,24
2001_12_GB_JAX,JAX,GB,12,2001,311,62,362,37,373,399,308.7,360.5,344.39,344.4,7,24,20,21
2001_12_IND_BAL,BAL,IND,12,2001,268,130,310,51,398,361,344.09090909090907,404.3,308.44444444444446,391.7,19,29,6,28
2001_12_MIN_PIT,PIT,MIN,12,2001,157,207,340,45,364,385,371.1,349.9,323.7,309.6,27,23,13,7
2001_12_NE_NYJ,NYJ,NE,12,2001,172,131,213,73,303,286,294.3,321.90909090909093,320.9,367.7979797979798,5,11,9,26
2001_12_PHI_KC,KC,PHI,12,2001,213,83,269,127,296,396,367,322.1,313.4,272.5,25,12,8,4
2001_12_SD_SEA,SEA,LAC,12,2001,202,117,195,107,319,302,313.4,329.3636363636364,367,333.3131313131313,9,17,25,19
2001_12_STL_ATL,ATL,LA,12,2001,217,128,342,89,345,431,328.5,426.5,269.52000000000004,321.6,15,30,3,10
2001_12_TB_CIN,CIN,TB,12,2001,144,86,231,65,230,296,302.3,321.6,267.9,426.5,6,10,2,30
2001_12_TEN_CLE,CLE,TEN,12,2001,224,65,272,111,289,383,267.9,323.7,302.3,371.1,2,13,5,27
2001_13_CAR_BUF,BUF,CAR,13,2001,277,102,153,78,379,231,334.3636363636364,264.5833333333333,394.1818181818182,375.6166666666666,19,1,29,28
2001_13_CHI_GB,GB,CHI,13,2001,207,167,139,50,374,189,364,302.54545454545456,314.54545454545456,342.45454545454544,25,7,9,20
2001_13_CLE_NE,NE,CLE,13,2001,218,81,244,50,299,294,318.9166666666667,269.8181818181818,295.02500000000003,329.09090909090907,11,2,5,16
2001_13_DET_TB,TB,DET,13,2001,305,81,165,102,386,267,319.27272727272725,342.45454545454544,295.72727272727275,302.54545454545456,12,21,6,7
2001_13_IND_MIA,MIA,IND,13,2001,191,183,173,84,374,257,316.1818181818182,400.3636363636364,324.6446280991736,348.99173553719004,10,29,13,22
2001_13_JAX_CIN,CIN,JAX,13,2001,147,60,242,62,207,304,295.72727272727275,314.54545454545456,319.27272727272725,364,6,9,12,26
2001_13_KC_OAK,LV,KC,13,2001,195,79,253,204,274,457,354.27272727272725,360.54545454545456,338.6363636363636,328.8181818181818,23,24,19,15
2001_13_NO_ATL,ATL,NO,13,2001,233,50,291,114,283,405,330,376.27272727272725,426.90909090909093,264.1322314049587,17,27,30,1
2001_13_NYG_DAL,DAL,NYG,13,2001,194,104,122,125,298,247,274.1818181818182,332,274.72727272727275,346.06060606060606,3,18,4,21
2001_13_NYJ_PIT,PIT,NYJ,13,2001,214,134,159,61,348,220,370.45454545454544,295.09090909090907,353.09090909090907,318.6446280991736,26,5,23,11
2001_13_SD_PHI,PHI,LAC,13,2001,221,63,307,96,284,403,328.8181818181818,327.0833333333333,360.54545454545456,313.8666666666666,15,14,25,8
2001_13_SEA_DEN,DEN,SEA,13,2001,158,165,243,70,323,313,325.00000000000006,313.90909090909093,317,326.87603305785126,13,8,10,14
2001_13_SF_STL,LA,SF,13,2001,294,115,146,76,409,222,426.90909090909093,394.1818181818182,330,334.3636363636364,30,28,17,18
2001_13_TEN_MIN,MIN,TEN,13,2001,348,148,302,182,496,484,353.09090909090907,329.09090909090907,370.45454545454544,269.8181818181818,22,16,27,2
2001_13_WAS_ARI,ARI,WAS,13,2001,253,80,210,130,333,340,338.6363636363636,274.72727272727275,354.27272727272725,274.1818181818182,20,4,24,3
2001_14_ARI_NYG,NYG,ARI,14,2001,147,105,207,88,252,295,324.9166666666667,338.1666666666667,276.1666666666667,280.1666666666667,13,19,3,4
2001_14_ATL_IND,IND,ATL,14,2001,325,187,291,66,512,357,388.4166666666667,326.0833333333333,321,378.6666666666667,29,15,11,26
2001_14_CIN_NYJ,NYJ,CIN,14,2001,196,113,128,120,309,248,288.8333333333333,288.3333333333333,368.5833333333333,313.6666666666667,5,4,25,8
2001_14_DAL_SEA,SEA,DAL,14,2001,152,173,135,102,325,237,313.83333333333337,276.1666666666667,324.83333333333337,324.9166666666667,8,2,13,14
2001_14_DEN_KC,KC,DEN,14,2001,292,137,254,94,429,348,368.5833333333333,324.8461538461539,347.5833333333333,313.83916083916085,26,12,21,9
2001_14_GB_TEN,TEN,GB,14,2001,283,167,199,31,450,230,342,364.8333333333333,365,293.0833333333333,20,23,23,7
2001_14_JAX_CLE,CLE,JAX,14,2001,184,47,202,128,231,330,271.8333333333333,313.6666666666667,317.25694444444446,288.3333333333333,1,7,10,5
2001_14_MIA_SF,SF,MIA,14,2001,133,152,149,67,285,216,379.8333333333333,321,425.4166666666667,388.4166666666667,28,10,30,28
2001_14_MIN_DET,DET,MIN,14,2001,241,167,243,80,408,323,336.1666666666667,365,324.8333333333333,342,17,24,12,20
2001_14_NE_BUF,BUF,NE,14,2001,219,98,237,129,317,366,338.0833333333333,317.38461538461536,261.78472222222223,271.6783216783217,18,9,1,2
2001_14_OAK_SD,LAC,LV,14,2001,215,68,221,91,283,312,332.9230769230769,347.5833333333333,325.3706293706294,368.5833333333333,16,21,15,25
2001_14_PHI_WAS,WAS,PHI,14,2001,213,157,235,63,370,298,280.1666666666667,325.0833333333333,338.1666666666667,333.40972222222223,3,14,19,17
2001_14_PIT_BAL,BAL,PIT,14,2001,159,58,333,158,217,491,348.5833333333333,368.5833333333333,400.69166666666666,288.8333333333333,22,26,29,6
2001_14_STL_NO,NO,LA,14,2001,269,68,338,56,337,394,378.6666666666667,425.4166666666667,326.0833333333333,379.8333333333333,27,30,16,27
2001_14_TB_CHI,CHI,TB,14,2001,190,207,191,61,397,252,293.0833333333333,324.8333333333333,364.8333333333333,336.1666666666667,6,11,22,18
2001_15_BUF_ATL,ATL,BUF,15,2001,431,67,208,190,498,398,328.46153846153845,336.46153846153845,397.9230769230769,321.1242603550296,15,18,29,12
2001_15_CHI_WAS,WAS,CHI,15,2001,236,89,125,112,325,237,287.0769230769231,301.0769230769231,323,319.2307692307692,5,7,13,10
2001_15_CIN_BAL,BAL,CIN,15,2001,181,157,153,150,338,303,338.46153846153845,285.2307692307692,378,290.38461538461536,19,4,28,5
2001_15_CLE_GB,GB,CLE,15,2001,139,222,203,168,361,371,354.46153846153845,268.6923076923077,350.3076923076923,314.9230769230769,23,2,23,9
2001_15_DAL_ARI,ARI,DAL,15,2001,144,75,176,174,219,350,334.84615384615387,273.15384615384613,319.3076923076923,314.69230769230774,17,3,11,8
2001_15_DET_PIT,PIT,DET,15,2001,226,215,118,74,441,192,378,341.6923076923077,338.46153846153845,361.7692307692308,28,20,20,25
2001_15_JAX_MIN,MIN,JAX,15,2001,218,28,217,214,246,431,361.7692307692308,314.9230769230769,341.6923076923077,268.6923076923077,24,10,21,1
2001_15_MIA_NE,NE,MIA,15,2001,131,196,320,58,327,378,320.85714285714283,312.9230769230769,336.5773809523809,372.53846153846155,13,8,18,26
2001_15_NO_TB,TB,NO,15,2001,207,157,248,41,364,289,319.2307692307692,375.46153846153845,301.0769230769231,423,11,27,6,30
2001_15_NYJ_IND,IND,NYJ,15,2001,267,133,285,155,400,440,397.9230769230769,290.38461538461536,328.46153846153845,285.2307692307692,29,6,15,3
2001_15_PHI_SF,SF,PHI,15,2001,136,117,232,79,253,311,372.53846153846155,323,312.9230769230769,287.0769230769231,25,14,7,4
2001_15_SD_KC,KC,LAC,15,2001,203,120,175,165,323,340,373.2307692307692,329.35714285714283,326.62721893491135,345.04166666666663,26,16,14,22
2001_15_SEA_NYG,NYG,SEA,15,2001,338,88,185,98,426,283,319.3076923076923,314.69230769230774,334.84615384615387,273.15384615384613,12,9,17,2
2001_15_STL_CAR,CAR,LA,15,2001,312,97,217,215,409,432,262,423,337.7972027972028,375.46153846153845,1,30,19,27
2001_15_TEN_OAK,LV,TEN,15,2001,249,77,178,103,326,281,344.84615384615387,350.3076923076923,329.08284023668637,354.46153846153845,21,22,16,24
2001_16_ARI_CAR,CAR,ARI,16,2001,223,95,173,158,318,331,272.5,326.57142857142856,423.64285714285717,278.6428571428571,1,14,30,3
2001_16_ATL_MIA,MIA,ATL,16,2001,191,50,265,152,241,417,317.57142857142856,340.57142857142856,321.29591836734693,340.85714285714283,9,19,9,19
2001_16_BAL_TB,TB,BAL,16,2001,90,123,205,90,213,295,322.42857142857144,338.42857142857144,369.2857142857143,286.5,11,18,25,4
2001_16_BUF_NYJ,NYJ,BUF,16,2001,227,148,185,192,375,377,301.07142857142856,340.85714285714283,398.07142857142856,340.57142857142856,7,20,29,18
2001_16_CHI_DET,DET,CHI,16,2001,303,64,252,83,367,335,331,296.5,382.5,289.7857142857143,17,6,28,5
2001_16_CLE_TEN,TEN,CLE,16,2001,274,188,336,87,462,423,345.35714285714283,276,343.5,354.92857142857144,22,2,20,23
2001_16_IND_STL,LA,IND,16,2001,359,124,195,83,483,278,423.64285714285717,398.07142857142856,272.5,301.07142857142856,30,29,1,7
2001_16_KC_JAX,JAX,KC,16,2001,283,182,294,92,465,386,323.2142857142857,369.64285714285717,353.5,330.1173469387755,12,27,22,15
2001_16_MIN_GB,GB,MIN,16,2001,169,56,114,199,225,313,354.92857142857144,353.5,276,323.2142857142857,24,23,2,12
2001_16_NYG_PHI,PHI,NYG,16,2001,270,120,303,129,390,432,322.14285714285717,326.92857142857144,364,312.42857142857144,10,15,24,8
2001_16_OAK_DEN,DEN,LV,16,2001,142,106,313,51,248,364,326.50000000000006,343.5,372.8988095238095,345.35714285714283,13,21,27,21
2001_16_PIT_CIN,CIN,PIT,16,2001,411,141,251,73,552,324,286.5,382.5,338.42857142857144,331,4,28,17,16
2001_16_SEA_SD,LAC,SEA,16,2001,377,52,267,61,429,328,330.06666666666666,312.42857142857144,369.8820512820513,326.92857142857144,16,8,26,14
2001_16_SF_DAL,DAL,SF,16,2001,241,186,229,56,427,285,278.6428571428571,364,326.57142857142856,322.14285714285717,3,25,13,10
2001_16_WAS_NO,NO,WAS,16,2001,127,100,94,173,227,267,369.2857142857143,289.7857142857143,322.42857142857144,296.5,26,5,11,6
2001_17_ARI_WAS,WAS,ARI,17,2001,162,178,154,45,340,199,288.26666666666665,326.8666666666667,359.8,275.53333333333336,3,14,26,1
2001_17_ATL_STL,LA,ATL,17,2001,280,192,176,96,472,272,427.6,345.6666666666667,390.06666666666666,312.46666666666664,30,21,29,8
2001_17_BUF_MIA,MIA,BUF,17,2001,110,202,220,39,312,259,312.46666666666664,343.26666666666665,345.6666666666667,306,8,19,21,7
2001_17_CIN_TEN,TEN,CIN,17,2001,307,57,340,100,364,440,353.1333333333333,304.2,285.8,378.6,24,6,2,28
2001_17_CLE_PIT,PIT,CLE,17,2001,169,221,150,68,390,218,378.6,285.8,304.2,353.1333333333333,28,2,6,24
2001_17_DAL_DET,DET,DAL,17,2001,242,124,158,106,366,264,333.4,288.53333333333336,299.06666666666666,358.73333333333335,16,4,5,25
2001_17_DEN_IND,IND,DEN,17,2001,191,151,151,115,342,266,390.06666666666666,321.2666666666667,427.6,344.8666666666667,29,12,30,20
2001_17_GB_NYG,NYG,GB,17,2001,386,146,315,105,532,420,333.93333333333334,346.26666666666665,326.6666666666667,350.8,17,22,12,23
2001_17_JAX_CHI,CHI,JAX,17,2001,159,169,189,91,328,280,299.06666666666666,332.6666666666667,333.4,370.73333333333335,5,15,15,27
2001_17_KC_SEA,SEA,KC,17,2001,248,150,184,126,398,310,313.46666666666664,370.73333333333335,336.6622222222222,332.6666666666667,9,27,18,14
2001_17_MIN_BAL,BAL,MIN,17,2001,160,212,115,86,372,201,335.53333333333336,350.8,315.1333333333333,346.26666666666665,18,23,9,22
2001_17_NE_CAR,CAR,NE,17,2001,144,193,198,102,337,300,275.53333333333336,321.26666666666665,326.8666666666667,317.2615384615384,1,11,13,10
2001_17_NYJ_OAK,LV,NYJ,17,2001,224,119,230,94,343,324,344.8666666666667,306,321.2666666666667,343.26666666666665,20,7,11,19
2001_17_PHI_TB,TB,PHI,17,2001,194,71,194,111,265,305,315.1333333333333,326.6666666666667,335.53333333333336,333.93333333333334,10,13,17,16
2001_17_SF_NO,NO,SF,17,2001,119,40,284,138,159,422,359.8,358.73333333333335,288.26666666666665,288.53333333333336,26,25,3,4
2001_18_BAL_MIA,MIA,BAL,18,2001,122,46,133,226,168,359,312.4375,337.8125,338,341.4375,3,5,4,5
2001_18_NYJ_OAK,LV,NYJ,18,2001,294,215,268,145,509,413,344.75,307.125,307.125,344.75,6,1,1,6
2001_18_SF_GB,GB,SF,18,2001,269,106,233,71,375,304,350.875,362.6875,346.3125,347.25,7,8,7,8
2001_18_TB_PHI,PHI,TB,18,2001,194,148,202,63,342,265,325.3125,312,312,325.3125,4,2,2,3
2001_19_BAL_PIT,PIT,BAL,19,2001,154,154,153,22,308,175,379.3125,339.05882352941177,281.5625,303.94117647058823,7,4,2,3
2001_19_GB_STL,LA,GB,19,2001,216,91,281,118,307,399,430.375,352.29411764705884,341.0625,359.2352941176471,8,5,7,8
2001_19_OAK_NE,NE,LV,19,2001,312,68,159,77,380,236,319.9375,354.4117647058824,279.375,313.3529411764706,2,6,1,5
2001_19_PHI_CHI,CHI,PHI,19,2001,89,111,262,87,200,349,300.875,326.29411764705884,329.375,309.2352941176471,1,3,6,4
2001_20_NE_PIT,PIT,NE,20,2001,255,58,217,67,313,284,375.11764705882354,323.47058823529414,329.4083044982699,347.4463667820069,3,1,2,3
2001_20_PHI_STL,LA,PHI,20,2001,212,161,171,110,373,281,423.11764705882354,327.55555555555554,355.0415224913495,295.2708333333333,4,2,4,1
2001_21_STL_NE,NE,LA,21,2001,145,133,365,90,278,455,321.27777777777777,420.3333333333333,371.6666666666667,324.9691358024691,1,2,2,1
2002_01_ARI_WAS,WAS,ARI,1,2002,327,122,187,70,449,257,0,0,0,0,32,32,32,32
2002_01_ATL_GB,GB,ATL,1,2002,284,211,209,180,495,389,0,0,0,0,32,32,32,32
2002_01_BAL_CAR,CAR,BAL,1,2002,136,145,218,77,281,295,0,0,0,0,32,32,32,32
2002_01_DAL_HOU,HOU,DAL,1,2002,145,87,131,155,232,286,0,0,0,0,32,32,32,32
2002_01_DET_MIA,MIA,DET,1,2002,207,182,220,51,389,271,0,0,0,0,32,32,32,32
2002_01_IND_JAX,JAX,IND,1,2002,228,118,211,104,346,315,0,0,0,0,32,32,32,32
2002_01_KC_CLE,CLE,KC,1,2002,359,59,276,194,418,470,0,0,0,0,32,32,32,32
2002_01_MIN_CHI,CHI,MIN,1,2002,297,80,234,140,377,374,0,0,0,0,32,32,32,32
2002_01_NO_TB,TB,NO,1,2002,278,72,260,118,350,378,0,0,0,0,32,32,32,32
2002_01_NYJ_BUF,BUF,NYJ,1,2002,271,142,210,73,413,283,0,0,0,0,32,32,32,32
2002_01_PHI_TEN,TEN,PHI,1,2002,269,61,212,80,330,292,0,0,0,0,32,32,32,32
2002_01_PIT_NE,NE,PIT,1,2002,294,63,247,74,357,321,0,0,0,0,32,32,32,32
2002_01_SD_CIN,CIN,LAC,1,2002,198,36,160,241,234,401,0,0,0,0,32,32,32,32
2002_01_SEA_OAK,LV,SEA,1,2002,214,221,155,43,435,198,0,0,0,0,32,32,32,32
2002_01_SF_NYG,NYG,SF,1,2002,342,43,166,113,385,279,0,0,0,0,32,32,32,32
2002_01_STL_DEN,DEN,LA,1,2002,202,104,315,32,306,347,0,0,0,0,32,32,32,32
2002_02_ARI_SEA,SEA,ARI,2,2002,352,81,107,249,433,356,198,257,435,449,1,4,29,30
2002_02_BUF_MIN,MIN,BUF,2,2002,281,213,463,31,494,494,374,413,377,283,20,27,21,8
2002_02_CHI_ATL,ATL,CHI,2,2002,166,122,143,106,288,249,389,377,495,374,25,21,32,20
2002_02_CIN_CLE,CLE,CIN,2,2002,198,75,239,156,273,395,418,234,470,401,28,3,31,26
2002_02_DEN_SF,SF,DEN,2,2002,205,71,119,201,276,320,279,306,385,347,6,12,23,17
2002_02_DET_CAR,CAR,DET,2,2002,310,75,106,73,385,179,281,271,295,389,7,5,11,25
2002_02_GB_NO,NO,GB,2,2002,217,146,270,95,363,365,378,495,350,389,22,32,18,25
2002_02_HOU_SD,LAC,HOU,2,2002,163,124,87,89,287,176,401,232,234,286,26,2,3,9
2002_02_JAX_KC,KC,JAX,2,2002,199,140,320,130,339,450,470,346,418,315,31,16,28,13
2002_02_MIA_IND,IND,MIA,2,2002,289,143,187,163,432,350,315,389,346,271,13,25,16,5
2002_02_NE_NYJ,NYJ,NE,2,2002,189,32,269,163,221,432,283,357,413,321,8,19,27,14
2002_02_NYG_STL,LA,NYG,2,2002,266,92,307,103,358,410,347,385,306,279,17,23,12,6
2002_02_OAK_PIT,PIT,LV,2,2002,201,72,403,95,273,498,321,435,357,198,14,29,19,1
2002_02_PHI_WAS,WAS,PHI,2,2002,119,89,292,168,208,460,449,292,257,330,30,10,4,15
2002_02_TB_BAL,BAL,TB,2,2002,141,55,211,74,196,285,295,350,281,378,11,18,7,22
2002_02_TEN_DAL,DAL,TEN,2,2002,240,67,259,98,307,357,286,330,232,292,9,15,2,10
2002_03_BUF_DEN,DEN,BUF,3,2002,211,163,283,39,374,322,313,453.5,277.5,434,8,28,5,27
2002_03_CAR_MIN,MIN,CAR,3,2002,191,73,221,164,264,385,434,333,453.5,225,27,13,28,2
2002_03_CIN_ATL,ATL,CIN,3,2002,174,143,136,66,317,202,338.5,314.5,313,345.5,14,9,9,17
2002_03_CLE_TEN,TEN,CLE,3,2002,107,86,326,92,193,418,343.5,345.5,296.5,314.5,15,17,6,10
2002_03_DAL_PHI,PHI,DAL,3,2002,309,153,201,121,462,322,376,296.5,328.5,343.5,22,5,12,15
2002_03_GB_DET,DET,GB,3,2002,182,95,357,95,277,452,225,430,333,370.5,2,26,13,20
2002_03_IND_HOU,HOU,IND,3,2002,99,126,272,88,225,360,204,373.5,344,369.5,1,21,16,19
2002_03_KC_NE,NE,KC,3,2002,410,97,149,221,507,370,394.5,404.5,252,398,23,25,4,25
2002_03_NO_CHI,CHI,NO,3,2002,236,125,233,73,361,306,313,370.5,338.5,430,8,20,14,26
2002_03_NYJ_MIA,MIA,NYJ,3,2002,185,211,157,58,396,215,369.5,252,373.5,394.5,19,3,21,23
2002_03_SD_ARI,ARI,LAC,3,2002,229,97,181,125,326,306,306.5,344,315.5,204,6,16,11,1
2002_03_SEA_NYG,NYG,SEA,3,2002,282,94,118,40,376,158,397.5,315.5,352.5,306.5,24,10,18,7
2002_03_STL_TB,TB,LA,3,2002,199,63,301,89,262,390,317.5,352.5,245.5,397.5,11,18,3,24
2002_03_WAS_SF,SF,WAS,3,2002,125,252,183,57,377,240,277.5,328.5,313,376,4,12,9,22
2002_04_CAR_GB,GB,CAR,4,2002,231,99,202,139,330,341,437.3333333333333,350.3333333333333,242.33333333333334,377.3333333333333,27,16,2,19
2002_04_CHI_BUF,BUF,CHI,4,2002,328,103,188,52,431,240,409.6666666666667,329,333.3333333333333,349,25,12,13,14
2002_04_CLE_PIT,PIT,CLE,4,2002,265,93,144,123,358,267,297,369.6666666666667,466.5,293.3333333333333,8,18,28,4
2002_04_DAL_STL,LA,DAL,4,2002,279,93,204,122,372,326,365,305,299,404.6666666666667,17,10,6,24
2002_04_DEN_BAL,BAL,DEN,4,2002,152,84,328,97,236,425,245.5,333.3333333333333,317.5,409.6666666666667,4,14,9,25
2002_04_HOU_PHI,PHI,HOU,4,2002,316,102,188,91,418,279,404.6666666666667,211,305,369,24,1,7,17
2002_04_MIA_KC,KC,MIA,4,2002,328,122,310,105,450,415,393,378.3333333333333,432,239.66666666666666,22,20,26,1
2002_04_MIN_SEA,SEA,MIN,4,2002,222,159,273,194,381,467,263,377.3333333333333,390.3333333333333,350.3333333333333,5,19,21,15
2002_04_NE_SD,LAC,NE,4,2002,104,238,353,87,342,440,331.3333333333333,432,313,393,13,26,8,22
2002_04_NO_DET,DET,NO,4,2002,267,85,269,110,352,379,242.33333333333334,349,437.3333333333333,329,3,15,27,10
2002_04_NYG_ARI,ARI,NYG,4,2002,168,102,199,67,270,266,313,390.3333333333333,331.3333333333333,263,11,21,12,3
2002_04_NYJ_JAX,JAX,NYJ,4,2002,173,223,281,78,396,359,398,239.66666666666666,404.5,378.3333333333333,23,2,23,20
2002_04_TB_CIN,CIN,TB,4,2002,117,74,277,101,191,378,277,299,331.3333333333333,365,6,9,12,16
2002_04_TEN_OAK,LV,TEN,4,2002,381,90,398,43,471,441,466.5,293.3333333333333,297,369.6666666666667,28,7,5,18
2002_05_ARI_CAR,CAR,ARI,5,2002,196,58,221,91,254,312,348,302.25,410.5,359.25,15,5,25,19
2002_05_BAL_CLE,CLE,BAL,5,2002,396,62,208,201,458,409,344,242.33333333333334,312.25,363.88888888888886,14,1,13,20
2002_05_CIN_IND,IND,CIN,5,2002,224,87,244,173,311,417,369,255.5,211,318.75,20,2,1,14
2002_05_GB_CHI,CHI,GB,5,2002,353,45,359,124,398,483,306.75,410.5,415,348,6,25,26,18
2002_05_KC_NYJ,NYJ,KC,5,2002,237,147,296,215,384,511,269.5,407.25,397.5,387.5,3,23,23,22
2002_05_NE_MIA,MIA,NE,5,2002,190,137,240,37,327,277,387.5,434,407.25,334,21,27,24,15
2002_05_NYG_DAL,DAL,NYG,5,2002,262,95,228,104,357,332,310.25,359.25,366.75,302.25,7,18,21,9
2002_05_OAK_BUF,BUF,LV,5,2002,417,80,357,142,497,499,415,468,306.75,342.5555555555555,26,28,10,17
2002_05_PHI_JAX,JAX,PHI,5,2002,197,70,230,199,267,429,397.3333333333333,408,279.4444444444444,228,22,24,7,2
2002_05_PIT_NO,NO,PIT,5,2002,205,121,268,120,326,388,356.5,317.3333333333333,269.75,335.44444444444446,17,9,5,16
2002_05_SD_DEN,DEN,LAC,5,2002,316,117,235,79,433,314,356.25,334,243.125,434,16,13,3,27
2002_05_STL_SF,SF,LA,5,2002,214,179,232,88,393,320,310.6666666666667,366.75,299,310.25,8,19,8,11
2002_05_TB_ATL,ATL,TB,5,2002,187,70,261,74,257,335,331.3333333333333,318.75,277,255.5,12,10,6,4
2002_05_WAS_TEN,TEN,WAS,5,2002,245,59,293,156,304,449,330.25,299,467.625,310.6666666666667,11,4,28,12
2002_06_ATL_NYG,NYG,ATL,6,2002,204,113,257,67,317,324,353.8,312.75,319.6,322.8125,16,6,7,8
2002_06_BAL_IND,IND,BAL,6,2002,284,60,163,105,344,268,354.5,284,295.875,372.5,17,3,4,21
2002_06_BUF_HOU,HOU,BUF,6,2002,223,141,254,173,364,427,228,431.4,408,474.2,1,27,25,28
2002_06_CAR_DAL,DAL,CAR,6,2002,225,137,198,110,362,308,319.6,329.2,353.8,304.2,7,10,16,5
2002_06_CLE_TB,TB,CLE,6,2002,194,186,151,60,380,211,322,366.8,316.46666666666664,275.6666666666667,8,20,6,1
2002_06_DET_MIN,MIN,DET,6,2002,295,111,309,53,406,362,399.75,269.75,292.5,356.5,23,2,3,18
2002_06_GB_NE,NE,GB,6,2002,183,123,147,158,306,305,402.6,425,375.4,325,24,25,22,10
2002_06_JAX_TEN,TEN,JAX,6,2002,226,152,84,130,378,214,325,364.75,329,413.25,9,19,12,26
2002_06_KC_SD,LAC,KC,6,2002,319,153,236,88,472,324,330,428,371.6,292.4,11,26,20,2
2002_06_MIA_DEN,DEN,MIA,6,2002,335,111,210,58,446,268,371.6,375.4,330,402.6,21,22,13,24
2002_06_NO_WAS,WAS,NO,6,2002,320,54,205,119,374,324,336.5,350.4,323.6875,331.46666666666664,14,15,9,14
2002_06_OAK_STL,LA,LV,6,2002,186,158,332,65,344,397,357.4,475.75,327.1333333333333,435.5,18,28,11,27
2002_06_PIT_CIN,CIN,PIT,6,2002,222,78,216,211,300,427,287.8,335,357.4,348.875,4,13,19,15
2002_06_SF_SEA,SEA,SF,6,2002,212,123,202,161,335,363,292.5,331.25,399.75,355.0625,5,12,23,17
2002_07_BUF_MIA,MIA,BUF,7,2002,165,132,182,132,297,314,357.5,430.6666666666667,384,250.66666666666666,21,27,21,1
2002_07_CAR_ATL,ATL,CAR,7,2002,214,187,126,101,401,227,315,325.6666666666667,346.44,326.6666666666667,7,9,15,7
2002_07_CHI_DET,DET,CHI,7,2002,199,192,163,89,391,252,288.2,325,401,425,3,8,23,25
2002_07_DAL_ARI,ARI,DAL,7,2002,232,152,202,148,384,350,304.2,326.6666666666667,329.2,325.6666666666667,6,10,8,6
2002_07_DEN_KC,KC,DEN,7,2002,172,162,376,141,334,517,410.6666666666667,384,353.6666666666667,357.5,25,22,17,19
2002_07_HOU_CLE,CLE,HOU,7,2002,148,89,306,89,237,395,340.8333333333333,255.2,331.6666666666667,430.52,14,1,9,27
2002_07_IND_PIT,PIT,IND,7,2002,188,182,304,72,370,376,353.4,352.4,290.24,280.8,18,17,4,2
2002_07_JAX_BAL,BAL,JAX,7,2002,152,118,231,173,270,404,280.8,334.6,352.4,335.6,2,12,16,10
2002_07_MIN_NYJ,NYJ,MIN,7,2002,324,91,288,101,415,389,292.4,401,428,288.2,4,23,26,3
2002_07_SD_OAK,LV,LAC,7,2002,361,37,170,172,398,342,460,353.6666666666667,354.71999999999997,410.6666666666667,28,19,18,24
2002_07_SEA_STL,LA,SEA,7,2002,265,218,255,50,483,305,355.1666666666667,301,462.625,337.6,20,5,28,11
2002_07_SF_NO,NO,SF,7,2002,254,179,275,143,433,418,346,337.6,342.75,301,16,13,13,5
2002_07_TB_PHI,PHI,TB,7,2002,127,159,155,81,286,236,412.2,331.6666666666667,371.26666666666665,340.8333333333333,26,11,20,12
2002_07_WAS_GB,GB,WAS,7,2002,167,88,135,146,255,281,405,344,386.5,345.12,24,15,22,14
2002_08_ARI_SF,SF,ARI,8,2002,252,105,286,151,357,437,351,317.5,360.5,330.5555555555556,18,9,21,12
2002_08_ATL_NO,NO,ATL,8,2002,192,159,195,260,351,455,358.42857142857144,329.3333333333333,349.08571428571435,309.22222222222223,21,12,16,4
2002_08_CHI_MIN,MIN,CHI,8,2002,216,148,204,44,364,248,399,312.8333333333333,312.8333333333333,305.3333333333333,24,8,6,3
2002_08_CLE_NYJ,NYJ,CLE,8,2002,183,66,294,55,249,349,312.8333333333333,326,399,275.1714285714285,8,11,25,1
2002_08_DEN_NE,NE,DEN,8,2002,130,69,229,136,199,365,386.5,403,405,399.7142857142857,22,26,28,26
2002_08_DET_BUF,BUF,DET,8,2002,302,74,199,83,376,282,414,305.3333333333333,348.85714285714283,312.8333333333333,27,5,15,6
2002_08_HOU_JAX,JAX,HOU,8,2002,202,126,184,81,328,265,346.1666666666667,278.5,279,323.52777777777777,16,1,2,10
2002_08_IND_WAS,WAS,IND,8,2002,210,165,214,63,375,277,333.5,356.3333333333333,380,356.1666666666667,14,20,23,19
2002_08_NYG_PHI,PHI,NYG,8,2002,137,295,251,103,432,354,391.1666666666667,347.6666666666667,315.72222222222223,314.625,23,17,9,7
2002_08_OAK_KC,KC,LV,8,2002,208,133,334,83,341,417,399.7142857142857,449.6666666666667,403,351.72222222222223,25,28,27,18
2002_08_PIT_BAL,BAL,PIT,8,2002,298,67,179,104,365,283,279,356.1666666666667,346.1666666666667,356.3333333333333,2,19,14,20
2002_08_SEA_DAL,DAL,SEA,8,2002,145,105,177,97,250,274,330,301.6666666666667,315.59999999999997,376.47222222222223,13,4,8,22
2002_08_TB_CAR,CAR,TB,8,2002,46,110,186,71,156,257,311.57142857142856,318,327.2857142857143,394.1714285714285,6,10,11,24
2002_08_TEN_CIN,CIN,TEN,8,2002,193,191,215,134,384,349,289.8333333333333,333.8333333333333,350.3333333333333,339.625,3,15,17,13
2002_09_BAL_ATL,ATL,BAL,9,2002,136,126,229,153,262,382,347.2857142857143,291.2857142857143,357.3673469387755,345.7142857142857,17,2,21,18
2002_09_CIN_HOU,HOU,CIN,9,2002,199,82,263,127,281,390,276.57142857142856,303.2857142857143,343.57142857142856,336,1,5,16,14
2002_09_DAL_DET,DET,DAL,9,2002,104,52,208,71,156,279,302,320,408.57142857142856,298.20833333333337,4,9,26,4
2002_09_JAX_NYG,NYG,JAX,9,2002,228,177,230,126,405,356,348.57142857142856,343.57142857142856,397,276.57142857142856,18,14,24,1
2002_09_MIA_GB,GB,MIA,9,2002,188,104,198,143,292,341,383.57142857142856,348.85714285714283,335,414,24,19,13,27
2002_09_MIN_TB,TB,MIN,9,2002,313,133,225,173,446,398,310.375,394,292.125,303.57142857142856,8,25,3,8
2002_09_NE_BUF,BUF,NE,9,2002,302,65,265,159,367,424,409.25,359.7142857142857,302.41666666666663,397.57142857142856,27,22,6,25
2002_09_NYJ_SD,LAC,NYJ,9,2002,192,73,253,165,265,418,352,303.7142857142857,451.14285714285717,329.2857142857143,21,7,28,11
2002_09_PHI_CHI,CHI,PHI,9,2002,205,74,209,117,279,326,303.57142857142856,397,394,348.57142857142856,6,26,23,19
2002_09_PIT_CLE,CLE,PIT,9,2002,181,36,265,136,217,401,328.875,345.7142857142857,304.85416666666663,291.2857142857143,10,16,9,2
2002_09_SF_OAK,LV,SF,9,2002,164,81,282,152,245,434,445,351.85714285714283,391.3265306122449,334.57142857142856,28,20,22,12
2002_09_STL_ARI,ARI,LA,9,2002,193,64,245,192,257,437,334.57142857142856,373.42857142857144,351.85714285714283,301.57142857142856,11,23,20,5
2002_09_TEN_IND,IND,TEN,9,2002,327,80,82,121,407,203,345,336,339.42857142857144,303.2857142857143,15,12,15,7
2002_09_WAS_SEA,SEA,WAS,9,2002,264,84,114,146,348,260,297.7142857142857,339.42857142857144,318.57142857142856,345,3,13,10,17
2002_10_ATL_PIT,PIT,ATL,10,2002,473,182,294,168,655,462,352.625,336.625,314.890625,302.625,16,12,8,3
2002_10_CIN_BAL,BAL,CIN,10,2002,183,162,272,123,345,395,302.625,314.125,336.625,277.125,5,7,14,1
2002_10_DET_GB,GB,DET,10,2002,363,150,236,126,513,362,372.125,283.75,347.875,314.875,22,2,18,7
2002_10_HOU_TEN,TEN,HOU,10,2002,109,142,182,62,251,244,319.375,277.125,352.75,314.125,9,1,19,6
2002_10_IND_PHI,PHI,IND,10,2002,281,105,319,127,386,446,388.125,352.75,300.5,319.375,24,17,2,10
2002_10_KC_SF,SF,KC,10,2002,175,155,193,80,330,273,362.125,392.375,420,445.58333333333337,20,25,27,28
2002_10_MIA_NYJ,NYJ,MIA,10,2002,167,97,227,69,264,296,318,347.875,341.125,372.125,8,15,15,23
2002_10_NE_CHI,CHI,NE,10,2002,183,125,328,82,308,410,300.5,367.75,388.125,403.96875,4,21,25,26
2002_10_NO_CAR,CAR,NO,10,2002,310,100,259,97,410,356,292.125,357.5,310.375,345.04166666666663,3,19,5,16
2002_10_NYG_MIN,MIN,NYG,10,2002,176,224,300,169,400,469,394.5,355.625,327.328125,345.125,26,18,12,17
2002_10_OAK_DEN,DEN,LV,10,2002,293,77,352,27,370,379,398.25,420,363.0625,362.125,27,28,22,21
2002_10_SD_STL,LA,LAC,10,2002,453,71,139,126,524,265,381.375,341.125,324.875,318,23,13,11,9
2002_10_SEA_ARI,ARI,SEA,10,2002,226,111,260,151,337,411,324.875,304,381.375,329.5,10,6,24,13
2002_10_WAS_JAX,JAX,WAS,10,2002,194,142,256,68,336,324,345.125,329.5,355.625,304,14,11,20,4
2002_11_ARI_PHI,PHI,ARI,11,2002,255,212,163,124,467,287,387.8888888888889,326.22222222222223,363.1111111111111,315.8888888888889,27,13,20,9
2002_11_BAL_MIA,MIA,BAL,11,2002,221,116,127,66,337,193,342.1111111111111,307.3333333333333,312,323.1111111111111,16,5,8,10
2002_11_BUF_KC,KC,BUF,11,2002,197,128,225,133,325,358,379.1111111111111,404.55555555555554,358.55555555555554,366.8571428571429,24,31,19,21
2002_11_CAR_TB,TB,CAR,11,2002,253,67,205,63,320,268,325.44444444444446,305.22222222222223,394.44444444444446,357.3333333333333,12,4,28,18
2002_11_CHI_STL,LA,CHI,11,2002,360,61,157,103,421,260,397.22222222222223,301.3333333333333,332.6666666666667,372.44444444444446,30,3,13,23
2002_11_CLE_CIN,CIN,CLE,11,2002,258,102,242,140,360,382,323.1111111111111,316.44444444444446,307.3333333333333,351.8571428571429,11,10,6,17
2002_11_DAL_IND,IND,DAL,11,2002,252,110,131,84,362,215,363.1111111111111,315.44444444444446,387.8888888888889,285.77777777777777,21,8,27,2
2002_11_DEN_SEA,SEA,DEN,11,2002,180,51,209,202,231,411,315.8888888888889,395.1111111111111,326.22222222222223,415.44444444444446,9,29,11,32
2002_11_GB_MIN,MIN,GB,11,2002,217,218,296,71,435,367,395.1111111111111,387.77777777777777,368.22222222222223,292.44444444444446,29,26,22,3
2002_11_JAX_HOU,HOU,JAX,11,2002,228,78,224,122,306,346,273.44444444444446,344.1111111111111,311.77777777777777,328.8888888888889,1,17,7,12
2002_11_NE_OAK,LV,NE,11,2002,297,97,172,48,394,220,415.44444444444446,372.44444444444446,395.1111111111111,301.3333333333333,32,23,30,4
2002_11_NO_ATL,ATL,NO,11,2002,160,155,279,80,315,359,350.55555555555554,357.3333333333333,386.22222222222223,305.22222222222223,18,19,25,5
2002_11_NYJ_DET,DET,NYJ,11,2002,171,108,229,189,279,418,292.44444444444446,312,387.77777777777777,342.1111111111111,2,7,26,14
2002_11_PIT_TEN,TEN,PIT,11,2002,257,121,318,45,378,363,311.77777777777777,386.22222222222223,273.44444444444446,350.55555555555554,6,25,1,16
2002_11_SF_SD,LAC,SF,11,2002,336,105,337,136,441,473,332.6666666666667,358.55555555555554,397.22222222222223,379.1111111111111,15,20,31,24
2002_11_WAS_NYG,NYG,WAS,11,2002,211,88,113,60,299,173,368.22222222222223,328.8888888888889,395.1111111111111,344.1111111111111,22,14,30,15
2002_12_ATL_CAR,CAR,ATL,12,2002,115,71,277,149,186,426,301.5,347,324.9,357.5,5,18,13,20
2002_12_BUF_NYJ,NYJ,BUF,12,2002,178,155,186,88,333,274,322.6,399.9,291.1,373.7,11,31,2,24
2002_12_CIN_PIT,PIT,CIN,12,2002,236,156,298,54,392,352,383.9,326.8,318.4,323,25,14,9,12
2002_12_CLE_NO,NO,CLE,12,2002,318,74,182,163,392,345,357.5,323,347,326.8,20,12,18,14
2002_12_DET_CHI,CHI,DET,12,2002,361,75,213,102,436,315,297.2,291.1,399.6,322.6,4,2,30,11
2002_12_GB_TB,TB,GB,12,2002,167,93,196,96,260,292,324.9,385.7,301.5,399.1,13,26,5,29
2002_12_IND_DEN,DEN,IND,12,2002,185,113,229,128,298,357,396.7,363,307.4,305.4,28,22,7,6
2002_12_JAX_DAL,DAL,JAX,12,2002,301,118,202,132,419,334,305.4,344.3,363,276.7,6,17,22,1
2002_12_KC_SEA,SEA,KC,12,2002,362,180,343,217,542,560,307.4,373.7,396.7,399.9,7,24,28,31
2002_12_MIN_NE,NE,MIN,12,2002,239,80,272,153,319,425,357.2,399.1,413.3,385.7,19,29,32,26
2002_12_NYG_HOU,HOU,NYG,12,2002,103,123,214,168,226,382,276.7,361.3,344.3,313.3,1,21,17,8
2002_12_OAK_ARI,ARI,LV,12,2002,145,132,340,187,277,527,322.3,413.3,395.8,357.2,10,32,27,19
2002_12_PHI_SF,SF,PHI,12,2002,337,104,244,107,441,351,370,395.8,343.5,322.3,23,27,16,10
2002_12_SD_MIA,MIA,LAC,12,2002,194,222,107,64,416,171,341.6,343.5,295.9,370,15,16,3,23
2002_12_STL_WAS,WAS,LA,12,2002,235,127,301,84,362,385,313.3,399.6,361.3,297.2,8,30,21,4
2002_12_TEN_BAL,BAL,TEN,12,2002,109,112,296,121,221,417,295.9,318.4,341.6,383.9,3,9,15,25
2002_13_ARI_KC,KC,ARI,13,2002,266,216,133,26,482,159,390.6363636363636,318.1818181818182,328.72727272727275,423.6363636363636,28,8,14,32
2002_13_ATL_MIN,MIN,ATL,13,2002,266,139,173,227,405,400,401.45454545454544,354.1818181818182,353.72727272727275,291,31,19,18,3
2002_13_BAL_CIN,CIN,BAL,13,2002,308,78,115,148,386,263,329.09090909090907,289.09090909090907,384.6363636363636,327.3636363636364,15,2,25,12
2002_13_CAR_CLE,CLE,CAR,13,2002,130,140,89,145,270,234,325,291,360.6363636363636,354.1818181818182,11,3,20,19
2002_13_CHI_GB,GB,CHI,13,2002,221,181,248,74,402,322,377.1818181818182,309.8181818181818,319,293.27272727272725,24,5,9,4
2002_13_DEN_SD,LAC,DEN,13,2002,217,220,288,156,437,444,327.8181818181818,387.72727272727275,348.3636363636364,362.45454545454544,13,26,17,21
2002_13_HOU_IND,IND,HOU,13,2002,190,88,137,65,278,202,362.45454545454544,272.09090909090907,387.72727272727275,363.1818181818182,21,1,26,22
2002_13_MIA_BUF,BUF,MIA,13,2002,306,161,55,270,467,325,388.45454545454544,348.3636363636364,323.54545454545456,327.8181818181818,27,17,10,13
2002_13_NE_DET,DET,NE,13,2002,210,82,210,139,292,349,293.27272727272725,353.72727272727275,309.8181818181818,401.45454545454544,4,18,5,31
2002_13_NYJ_OAK,LV,NYJ,13,2002,342,98,265,32,440,297,423.6363636363636,323.54545454545456,318.1818181818182,388.45454545454544,32,10,8,27
2002_13_PIT_JAX,JAX,PIT,13,2002,146,102,201,219,248,420,343.3636363636364,384.6363636363636,315.72727272727275,329.09090909090907,16,25,6,15
2002_13_SEA_SF,SF,SEA,13,2002,164,142,427,80,306,507,376.45454545454544,328.72727272727275,391.72727272727275,390.6363636363636,23,14,29,28
2002_13_STL_PHI,PHI,LA,13,2002,181,108,218,76,289,294,391.72727272727275,398.27272727272725,376.45454545454544,317.72727272727275,29,30,23,7
2002_13_TB_NO,NO,TB,13,2002,165,102,276,34,267,310,360.6363636363636,319,325,377.1818181818182,20,9,11,24
2002_13_TEN_NYG,NYG,TEN,13,2002,283,62,334,142,345,476,363.1818181818182,327.3636363636364,272.09090909090907,289.09090909090907,22,12,1,2
2002_13_WAS_DAL,DAL,WAS,13,2002,145,211,243,83,356,326,315.72727272727275,317.72727272727275,343.3636363636364,398.27272727272725,6,7,16,30
2002_14_ATL_TB,TB,ATL,14,2002,276,150,125,62,426,187,318.25,358,352.8333333333333,401.75,7,21,18,31
2002_14_BUF_NE,NE,BUF,14,2002,183,92,328,78,275,406,353.3333333333333,395,293.1666666666667,346.4166666666667,19,29,4,17
2002_14_CHI_MIA,MIA,CHI,14,2002,196,248,101,107,444,208,346.4166666666667,310.8333333333333,395,379.25,17,6,29,24
2002_14_CIN_CAR,CAR,CIN,14,2002,319,82,295,83,401,378,286.25,333.8333333333333,320.4166666666667,286.91666666666663,2,12,10,3
2002_14_CLE_JAX,JAX,CLE,14,2002,73,157,264,173,230,437,335.4166666666667,320.4166666666667,387.5833333333333,286.25,13,10,26,2
2002_14_DEN_NYJ,NYJ,DEN,14,2002,244,64,266,111,308,377,321.3333333333333,392.4166666666667,425,336.9166666666667,11,28,32,14
2002_14_DET_ARI,ARI,DET,14,2002,228,133,152,51,361,203,304.9166666666667,293.1666666666667,398.25,353.3333333333333,5,4,30,19
2002_14_HOU_PIT,PIT,HOU,14,2002,326,128,33,37,454,70,387.5833333333333,266.24999999999994,335.4166666666667,355.4166666666667,26,1,13,20
2002_14_IND_TEN,TEN,IND,14,2002,237,119,297,92,356,389,339.75,355.4166666666667,361.6666666666667,266.24999999999994,15,20,22,1
2002_14_MIN_GB,GB,MIN,14,2002,214,124,136,191,338,327,379.25,401.75,310.8333333333333,358,24,31,6,21
2002_14_NO_BAL,BAL,NO,14,2002,316,114,226,150,430,376,286.91666666666663,352.8333333333333,333.8333333333333,318.25,3,18,12,7
2002_14_NYG_WAS,WAS,NYG,14,2002,363,132,212,111,495,323,318.4166666666667,361.6666666666667,319.0833333333333,339.75,8,22,9,15
2002_14_OAK_SD,LAC,LV,14,2002,239,65,328,67,304,395,336.9166666666667,425,392.4166666666667,321.3333333333333,14,32,28,11
2002_14_PHI_SEA,SEA,PHI,14,2002,223,172,190,126,395,316,343.5833333333333,383.1666666666667,370.5833333333333,389.5833333333333,16,25,23,27
2002_14_SF_DAL,DAL,SF,14,2002,147,110,276,125,257,401,319.0833333333333,370.5833333333333,318.4166666666667,343.5833333333333,9,23,8,16
2002_14_STL_KC,KC,LA,14,2002,116,180,218,33,296,251,398.25,389.5833333333333,304.9166666666667,383.1666666666667,30,27,5,25
2002_15_ARI_STL,LA,ARI,15,2002,319,66,258,129,385,387,378.9230769230769,309.2307692307692,390.38461538461536,286.2307692307692,26,6,27,2
2002_15_BAL_HOU,HOU,BAL,15,2002,196,95,228,70,291,298,251.15384615384608,297.9230769230769,392.6923076923077,354.61538461538464,1,4,29,20
2002_15_CAR_PIT,PIT,CAR,15,2002,215,129,126,50,344,176,392.6923076923077,295.0769230769231,251.15384615384608,337.2307692307692,29,3,1,14
2002_15_DAL_NYG,NYG,DAL,15,2002,220,157,161,104,377,265,358.6923076923077,314.3076923076923,332,372.9230769230769,22,7,12,23
2002_15_GB_SF,SF,GB,15,2002,156,107,201,104,263,305,372.9230769230769,376.0769230769231,314.3076923076923,396,23,24,7,31
2002_15_IND_CLE,CLE,IND,15,2002,287,96,277,143,383,420,329.38461538461536,358,327.3076923076923,341,11,21,10,15
2002_15_JAX_CIN,CIN,JAX,15,2002,258,65,223,109,323,332,337.2307692307692,327.3076923076923,295.0769230769231,329.38461538461536,14,10,3,11
2002_15_KC_DEN,DEN,KC,15,2002,297,197,310,185,494,495,391.2307692307692,390.38461538461536,320.3076923076923,378.9230769230769,28,27,8,26
2002_15_MIN_NO,NO,MIN,15,2002,255,78,312,146,333,458,354.61538461538464,396,297.9230769230769,376.0769230769231,20,31,4,24
2002_15_NE_TEN,TEN,NE,15,2002,136,238,137,56,374,193,341,347.3076923076923,358,395.84615384615387,15,17,21,30
2002_15_NYJ_CHI,CHI,NYJ,15,2002,177,105,207,134,282,341,302.9230769230769,320.3076923076923,353.9230769230769,391.2307692307692,5,8,19,28
2002_15_OAK_MIA,MIA,LV,15,2002,237,121,204,56,358,260,353.9230769230769,422.6923076923077,302.9230769230769,334.38461538461536,19,32,5,13
2002_15_SD_BUF,BUF,LAC,15,2002,107,155,212,116,262,328,395.84615384615387,334.38461538461536,347.3076923076923,422.6923076923077,30,13,17,32
2002_15_SEA_ATL,ATL,SEA,15,2002,240,150,298,166,390,464,344.84615384615387,347.53846153846155,326.53846153846155,378,16,18,9,25
2002_15_TB_DET,DET,TB,15,2002,158,144,253,123,302,376,286.2307692307692,326.53846153846155,309.2307692307692,344.84615384615387,2,9,6,16
2002_15_WAS_PHI,PHI,WAS,15,2002,220,110,213,86,330,299,378,332,347.53846153846155,358.6923076923077,25,12,18,22
2002_16_BUF_GB,GB,BUF,16,2002,114,119,179,43,233,222,371,386.2857142857143,365.07142857142856,333.92857142857144,24,27,23,13
2002_16_CHI_CAR,CAR,CHI,16,2002,179,88,163,55,267,218,286.57142857142856,301.42857142857144,389.2142857142857,321.7857142857143,2,5,28,8
2002_16_CLE_BAL,BAL,CLE,16,2002,143,146,209,63,289,272,297.92857142857144,333.2142857142857,253.99999999999994,362.42857142857144,4,12,1,22
2002_16_DEN_OAK,LV,DEN,16,2002,201,136,282,81,337,363,411.07142857142856,398.57142857142856,354.2142857142857,397.85714285714283,32,30,19,29
2002_16_DET_ATL,ATL,DET,16,2002,337,197,149,87,534,236,348.07142857142856,287.35714285714283,355.85714285714283,330.07142857142856,17,3,20,11
2002_16_HOU_WAS,WAS,HOU,16,2002,190,247,112,67,437,179,329.64285714285717,253.99999999999994,374.57142857142856,297.92857142857144,10,1,25,4
2002_16_MIA_MIN,MIN,MIA,16,2002,257,129,177,69,386,246,400.42857142857144,354.2142857142857,353.07142857142856,411.07142857142856,31,19,18,32
2002_16_NO_CIN,CIN,NO,16,2002,190,240,203,33,430,236,336.2142857142857,353.07142857142856,327.64285714285717,400.42857142857144,14,18,9,31
2002_16_NYG_IND,IND,NYG,16,2002,365,50,366,103,415,469,362.42857142857144,360,333.2142857142857,310.7857142857143,22,21,12,6
2002_16_NYJ_NE,NE,NYJ,16,2002,133,97,285,108,230,393,336.2857142857143,321.7857142857143,343.35714285714283,301.42857142857144,15,8,16,5
2002_16_PHI_DAL,DAL,PHI,16,2002,128,68,253,114,196,367,310.7857142857143,374.57142857142856,360,329.64285714285717,6,25,21,10
2002_16_PIT_TB,TB,PIT,16,2002,232,74,244,94,306,338,330.07142857142856,389.2142857142857,287.35714285714283,286.57142857142856,11,28,3,2
2002_16_SD_KC,KC,LAC,16,2002,337,53,242,148,390,390,397.85714285714283,333.92857142857144,398.57142857142856,386.2857142857143,29,13,30,27
2002_16_SF_ARI,ARI,SF,16,2002,109,108,256,106,217,362,314.7857142857143,365.07142857142856,379.35714285714283,371,7,23,26,24
2002_16_STL_SEA,SEA,LA,16,2002,303,100,270,17,403,287,355.85714285714283,379.35714285714283,348.07142857142856,314.7857142857143,20,26,17,7
2002_16_TEN_JAX,JAX,TEN,16,2002,157,75,123,175,232,298,327.64285714285717,343.35714285714283,336.2142857142857,336.2857142857143,9,16,14,15
2002_17_ARI_DEN,DEN,ARI,17,2002,203,259,153,84,462,237,396.2,308.26666666666665,406.1333333333333,364.8666666666667,29,7,32,22
2002_17_ATL_CLE,CLE,ATL,17,2002,154,189,240,105,343,345,329.1333333333333,360.46666666666664,297.3333333333333,283.93333333333334,11,20,5,2
2002_17_BAL_PIT,PIT,BAL,17,2002,194,175,336,114,369,450,385.8,297.3333333333333,328.46666666666664,329.1333333333333,28,5,10,11
2002_17_CAR_NO,NO,CAR,17,2002,145,125,203,85,270,288,345.26666666666665,285.26666666666665,342.46666666666664,295.8666666666667,17,3,16,4
2002_17_CIN_BUF,BUF,CIN,17,2002,231,99,241,84,330,325,375.3333333333333,342.46666666666664,361.8,345.26666666666665,27,16,21,17
2002_17_DAL_WAS,WAS,DAL,17,2002,209,151,189,38,360,227,336.8,303.1333333333333,248.99999999999994,374.06666666666666,13,6,1,26
2002_17_GB_NYJ,NYJ,GB,17,2002,210,129,215,114,339,329,326.53333333333336,361.8,329.2,375.3333333333333,9,21,12,27
2002_17_JAX_IND,IND,JAX,17,2002,146,126,135,154,272,289,365.93333333333334,321.26666666666665,367.26666666666665,340.3333333333333,23,8,24,15
2002_17_KC_OAK,LV,KC,17,2002,79,280,137,44,359,181,406.1333333333333,397.3333333333333,396.2,337.6666666666667,32,30,29,14
2002_17_MIA_NE,NE,MIA,17,2002,221,116,110,256,337,366,329.2,347,326.53333333333336,399.46666666666664,12,18,9,31
2002_17_MIN_DET,DET,MIN,17,2002,293,93,312,154,386,466,283.93333333333334,399.46666666666664,360.46666666666664,347,2,31,20,18
2002_17_PHI_NYG,NYG,PHI,17,2002,256,213,150,65,469,215,367.26666666666665,374.06666666666666,365.93333333333334,303.1333333333333,24,26,23,6
2002_17_SEA_SD,LAC,SEA,17,2002,352,88,449,163,440,612,337.6666666666667,359,397.3333333333333,373.2,14,19,30,25
2002_17_SF_STL,LA,SF,17,2002,252,35,154,193,287,347,373.2,364.8666666666667,359,308.26666666666665,25,22,19,7
2002_17_TB_CHI,CHI,TB,17,2002,137,85,134,161,222,295,295.8666666666667,328.46666666666664,285.26666666666665,385.8,4,10,3,28
2002_17_TEN_HOU,HOU,TEN,17,2002,214,28,148,140,242,288,248.99999999999994,340.3333333333333,336.8,321.26666666666665,1,15,13,8
2002_18_ATL_GB,GB,ATL,18,2002,247,56,117,192,303,309,359.75,359.5,327.3125,330,4,3,3,4
2002_18_CLE_PIT,PIT,CLE,18,2002,367,89,429,38,456,467,384.75,330,306.875,359.5,8,2,1,5
2002_18_IND_NYJ,NYJ,IND,18,2002,222,180,137,52,402,189,327.3125,360.0625,359.75,319.25,1,5,6,2
2002_18_NYG_SF,SF,NYG,18,2002,356,90,342,119,446,461,363.75,373.625,367.8125,364.125,6,7,8,7
2002_19_ATL_PHI,PHI,ATL,19,2002,247,91,288,93,338,381,364.125,356.52941176470586,373.625,356.4117647058824,5,4,6,5
2002_19_NYJ_OAK,LV,NYJ,19,2002,283,127,183,120,410,303,403.1875,331.70588235294116,383.8125,350,8,2,8,4
2002_19_PIT_TEN,TEN,PIT,19,2002,338,99,266,67,437,333,337.0625,388.94117647058823,248.56249999999994,338.05882352941177,3,7,1,3
2002_19_SF_TB,TB,SF,19,2002,217,121,193,62,338,255,326.375,368.5882352941176,291.25,378.7647058823529,1,6,2,7
2002_20_TB_PHI,PHI,TB,20,2002,243,80,259,49,323,308,362.5882352941176,327.05882352941177,357.9688581314879,361.90657439446363,3,1,2,3
2002_20_TEN_OAK,LV,TEN,20,2002,286,89,194,138,375,332,403.5882352941176,342.94117647058823,330.01730103806227,385.65051903114187,4,2,1,4
2002_21_OAK_TB,TB,LV,21,2002,215,150,272,19,365,291,326,402,360.3888888888889,342.3333333333333,1,2,2,1
2003_01_ARI_DET,DET,ARI,1,2003,195,66,358,95,261,453,0,0,0,0,32,32,32,32
2003_01_ATL_DAL,DAL,ATL,1,2003,268,149,228,98,417,326,0,0,0,0,32,32,32,32
2003_01_BAL_PIT,PIT,BAL,1,2003,260,88,152,88,348,240,0,0,0,0,32,32,32,32
2003_01_CHI_SF,SF,CHI,1,2003,229,162,95,55,391,150,0,0,0,0,32,32,32,32
2003_01_DEN_CIN,CIN,DEN,1,2003,264,51,115,184,315,299,0,0,0,0,32,32,32,32
2003_01_HOU_MIA,MIA,HOU,1,2003,227,86,266,127,313,393,0,0,0,0,32,32,32,32
2003_01_IND_CLE,CLE,IND,1,2003,182,98,211,67,280,278,0,0,0,0,32,32,32,32
2003_01_JAX_CAR,CAR,JAX,1,2003,141,122,272,75,263,347,0,0,0,0,32,32,32,32
2003_01_MIN_GB,GB,MIN,1,2003,248,62,195,154,310,349,0,0,0,0,32,32,32,32
2003_01_NE_BUF,BUF,NE,1,2003,230,107,154,105,337,259,0,0,0,0,32,32,32,32
2003_01_NO_SEA,SEA,NO,1,2003,137,151,274,96,288,370,0,0,0,0,32,32,32,32
2003_01_NYJ_WAS,WAS,NYJ,1,2003,185,160,105,57,345,162,0,0,0,0,32,32,32,32
2003_01_OAK_TEN,TEN,LV,1,2003,269,76,264,34,345,298,0,0,0,0,32,32,32,32
2003_01_SD_KC,KC,LAC,1,2003,282,131,202,64,413,266,0,0,0,0,32,32,32,32
2003_01_STL_NYG,NYG,LA,1,2003,202,149,353,40,351,393,0,0,0,0,32,32,32,32
2003_01_TB_PHI,PHI,TB,1,2003,148,121,238,90,269,328,0,0,0,0,32,32,32,32
2003_02_BUF_JAX,JAX,BUF,2,2003,214,95,328,43,309,371,347,337,263,259,22,19,6,4
2003_02_CAR_TB,TB,CAR,2,2003,339,60,96,171,399,267,328,263,269,347,18,6,8,22
2003_02_CHI_MIN,MIN,CHI,2,2003,214,202,145,80,416,225,349,150,310,391,24,1,14,27
2003_02_CIN_OAK,LV,CIN,2,2003,103,134,303,129,237,432,298,315,345,299,12,16,21,13
2003_02_CLE_BAL,BAL,CLE,2,2003,78,343,147,60,421,207,240,280,348,278,3,10,23,9
2003_02_DAL_NYG,NYG,DAL,2,2003,265,53,321,107,318,428,351,417,393,326,25,31,29,17
2003_02_DEN_SD,LAC,DEN,2,2003,182,121,192,197,303,389,266,299,413,315,7,13,30,16
2003_02_DET_GB,GB,DET,2,2003,132,200,241,56,332,297,310,261,349,453,14,5,24,32
2003_02_HOU_NO,NO,HOU,2,2003,189,110,213,75,299,288,370,393,288,313,26,29,11,15
2003_02_MIA_NYJ,NYJ,MIA,2,2003,373,21,190,187,394,377,162,313,345,393,2,15,21,29
2003_02_NE_PHI,PHI,NE,2,2003,211,100,255,62,311,317,269,259,328,337,8,4,18,19
2003_02_PIT_KC,KC,PIT,2,2003,124,159,336,60,283,396,413,348,266,240,30,23,7,3
2003_02_SEA_ARI,ARI,SEA,2,2003,205,93,195,130,298,325,453,288,261,370,32,11,5,26
2003_02_SF_STL,LA,SF,2,2003,236,88,243,148,324,391,393,391,351,150,29,27,25,1
2003_02_TEN_IND,IND,TEN,2,2003,173,127,209,53,300,262,278,345,280,298,9,21,10,12
2003_02_WAS_ATL,ATL,WAS,2,2003,197,99,356,125,296,481,326,345,417,162,17,21,31,2
2003_03_BAL_SD,LAC,BAL,3,2003,270,132,98,152,402,250,284.5,330.5,344,243.5,5,13,18,2
2003_03_BUF_MIA,MIA,BUF,3,2003,154,166,98,41,320,139,345,354,278,328,18,20,5,14
2003_03_CLE_SF,SF,CLE,3,2003,198,75,222,51,273,273,391,243.5,358.5,330.5,27,1,22,15
2003_03_GB_ARI,ARI,GB,3,2003,273,81,245,66,354,311,375.5,321,306.5,279,25,11,11,6
2003_03_JAX_IND,IND,JAX,3,2003,216,73,122,152,289,274,289,328,303.5,354,7,12,10,21
2003_03_KC_HOU,HOU,KC,3,2003,218,107,262,168,325,430,340.5,348,334.5,372,16,19,16,23
2003_03_MIN_DET,DET,MIN,3,2003,235,77,289,127,312,416,279,382.5,321,187.5,4,26,13,1
2003_03_NO_TEN,TEN,NO,3,2003,281,105,185,23,386,208,303.5,334.5,289,340.5,8,15,8,17
2003_03_NYG_WAS,WAS,NYG,3,2003,348,124,276,129,472,405,413,334.5,311,422.5,28,15,12,28
2003_03_NYJ_NE,NE,NYJ,3,2003,181,147,264,65,328,329,288,278,290,345,6,3,9,19
2003_03_OAK_DEN,DEN,LV,3,2003,197,190,184,39,387,223,344,267.5,284.5,373.5,17,2,7,24
2003_03_PIT_CIN,CIN,PIT,3,2003,157,57,240,138,214,378,373.5,372,267.5,348,24,23,4,20
2003_03_STL_SEA,SEA,LA,3,2003,256,96,226,82,352,308,306.5,358.5,375.5,391,9,21,25,26
2003_03_TB_ATL,ATL,TB,3,2003,127,29,192,132,156,324,311,363.5,413,265,10,22,27,3
2003_04_ARI_STL,LA,ARI,4,2003,272,133,135,36,405,171,341.6666666666667,368.3333333333333,321.6666666666667,317.6666666666667,20,23,13,11
2003_04_ATL_CAR,CAR,ATL,4,2003,168,193,152,144,361,296,265,259.3333333333333,363.5,350.3333333333333,5,4,23,19
2003_04_CIN_CLE,CLE,CIN,4,2003,280,69,215,80,349,295,253.33333333333334,320.3333333333333,351.6666666666667,374,3,16,20,25
2003_04_DAL_NYJ,NYJ,DAL,4,2003,219,66,165,202,285,367,295,422.5,301.3333333333333,334.5,11,27,8,16
2003_04_DET_DEN,DEN,DET,4,2003,277,79,149,144,356,293,358.3333333333333,290,252.66666666666666,393.6666666666667,22,9,1,28
2003_04_GB_CHI,CHI,GB,4,2003,201,181,193,187,382,380,187.5,317.6666666666667,382.5,368.3333333333333,1,15,27,24
2003_04_IND_NO,NO,IND,4,2003,228,155,327,100,383,427,292.3333333333333,289,331,310,10,7,15,10
2003_04_JAX_HOU,HOU,JAX,4,2003,234,110,263,79,344,342,335.3333333333333,310,375.3333333333333,289,19,14,26,4
2003_04_KC_BAL,BAL,KC,4,2003,140,202,159,129,342,288,303.6666666666667,375.3333333333333,323.6666666666667,335.3333333333333,13,25,14,17
2003_04_NE_WAS,WAS,NE,4,2003,147,119,289,106,266,395,432.6666666666667,301.3333333333333,358,295,28,12,21,7
2003_04_PHI_BUF,BUF,PHI,4,2003,296,21,173,176,317,349,282.3333333333333,290,336.6666666666667,288,6,9,18,3
2003_04_SD_OAK,LV,LAC,4,2003,348,120,208,222,468,430,252.66666666666666,323.6666666666667,358.3333333333333,303.6666666666667,2,17,22,9
2003_04_SF_MIN,MIN,SF,4,2003,267,102,254,145,369,399,393.6666666666667,351.6666666666667,290,253.33333333333334,26,21,5,2
2003_04_TEN_PIT,PIT,TEN,4,2003,332,69,161,40,401,201,374,331,320.3333333333333,292.3333333333333,24,18,12,6
2003_05_ARI_DAL,DAL,ARI,5,2003,277,97,121,32,374,153,404,319,291.6666666666667,357.5,28,13,8,22
2003_05_CIN_BUF,BUF,CIN,5,2003,211,80,225,67,291,292,291,314,304.75,277.25,5,10,11,4
2003_05_CLE_PIT,PIT,CLE,5,2003,161,60,208,124,221,332,380.75,277.25,298.5,314,25,3,10,14
2003_05_DEN_KC,KC,DEN,5,2003,129,133,292,176,262,468,353.5,357.75,313.25,290.75,21,22,13,7
2003_05_DET_SF,SF,DET,5,2003,192,142,221,84,334,305,363.5,290.75,387.5,357.75,24,4,26,23
2003_05_IND_TB,TB,IND,5,2003,318,139,386,74,457,460,350.3333333333333,323.5,259.3333333333333,315,20,15,2,15
2003_05_MIA_NYG,NYG,MIA,5,2003,276,77,167,134,353,301,358,336.6666666666667,432.6666666666667,282.3333333333333,23,18,28,5
2003_05_MIN_ATL,ATL,MIN,5,2003,352,104,239,166,456,405,268.5,387.5,289,363.5,2,26,6,24
2003_05_NO_CAR,CAR,NO,5,2003,124,185,189,155,309,344,297,315,271.55555555555554,323.5,6,11,3,16
2003_05_OAK_CHI,CHI,LV,5,2003,160,200,187,119,360,306,252.33333333333334,306.5,338.44444444444446,350.25,1,8,19,21
2003_05_SD_JAX,JAX,LAC,5,2003,336,123,296,69,459,365,318,350.25,337.5,306.5,12,19,18,12
2003_05_SEA_GB,GB,SEA,5,2003,185,159,225,128,344,353,333.25,321.6666666666667,236.125,341.6666666666667,17,14,1,20
2003_05_TEN_NE,NE,TEN,5,2003,219,161,360,70,380,430,324.75,298.5,391,380.75,16,7,27,25
2003_05_WAS_PHI,PHI,WAS,5,2003,157,127,271,49,284,320,309.6666666666667,391,293.88888888888886,324.75,9,27,9,17
2003_06_ATL_STL,LA,ATL,6,2003,377,119,155,73,496,228,357.5,306,319,391,23,8,10,26
2003_06_BAL_ARI,ARI,BAL,6,2003,247,90,75,213,337,288,285.8,313.25,398,353.5,2,10,27,20
2003_06_BUF_NYJ,NYJ,BUF,6,2003,130,118,202,53,248,255,292.5,291,408.625,309.6,5,4,28,8
2003_06_CAR_IND,IND,CAR,6,2003,293,76,181,189,369,370,350.8,300,371.66666666666663,322.25,21,6,23,11
2003_06_CHI_NO,NO,CHI,6,2003,153,130,152,140,283,292,320.8,279.25,299.4,306.375,11,1,5,7
2003_06_HOU_TEN,TEN,HOU,6,2003,421,114,371,91,535,462,324.8,337.5,335.8,318,12,18,16,9
2003_06_KC_GB,GB,KC,6,2003,272,183,400,82,455,482,335.4,335.2,327.93333333333334,379.8,16,15,14,25
2003_06_MIA_JAX,JAX,MIA,6,2003,256,88,147,91,344,238,346.2,327.75,353.2,356.75,19,13,19,21
2003_06_NYG_NE,NE,NYG,6,2003,112,129,314,76,241,390,335.8,356.75,324.8,327.75,17,22,12,13
2003_06_OAK_CLE,CLE,LV,6,2003,127,171,165,90,298,255,288.2,306.4,348.8,273.8666666666667,3,9,18,1
2003_06_PHI_DAL,DAL,PHI,6,2003,183,119,126,117,302,243,396.5,303.25,277.5,373.25,28,7,2,24
2003_06_PIT_DEN,DEN,PIT,6,2003,172,77,186,85,249,271,379.8,348.8,335.2,288.2,27,20,15,3
2003_06_SF_SEA,SEA,SF,6,2003,207,147,168,111,354,279,329.5,357.6,335.9375,293.6,14,24,17,4
2003_06_TB_WAS,WAS,TB,6,2003,246,68,268,111,314,379,376.8,377,304.53333333333336,357.625,25,26,6,22
2003_07_BAL_CIN,CIN,BAL,7,2003,274,59,302,120,333,422,309.6,308.2,291,296.04,10,9,6,8
2003_07_CHI_SEA,SEA,CHI,7,2003,215,124,149,87,339,236,334.4,281.8,341.88,313.24,15,1,15,11
2003_07_DAL_DET,DET,DAL,7,2003,81,83,198,134,164,332,293.6,377.6,357.6,291.2,7,26,20,7
2003_07_DEN_MIN,MIN,DEN,7,2003,277,72,223,138,349,361,391,358,306,335.8333333333333,28,19,10,14
2003_07_GB_STL,LA,GB,7,2003,247,131,268,116,378,384,385.2,355.3333333333333,290.4,359.6666666666667,27,18,5,22
2003_07_KC_OAK,LV,KC,7,2003,282,100,206,125,382,331,297.8333333333333,359.6666666666667,289.8333333333333,355.3333333333333,8,20,4,19
2003_07_NE_MIA,MIA,NE,7,2003,230,97,283,59,327,342,309.8,320,345.76,362.2916666666667,11,14,16,23
2003_07_NO_ATL,ATL,NO,7,2003,115,130,352,164,245,516,293,314.5,380.5833333333333,281.375,6,13,28,1
2003_07_NYJ_HOU,HOU,NYJ,7,2003,170,169,182,140,339,322,362.4,283.6,366.84000000000003,283.8,22,2,25,2
2003_07_PHI_NYG,NYG,PHI,7,2003,174,180,64,87,354,151,363.4,291.2,316.84000000000003,377.6,23,5,12,27
2003_07_SD_CLE,CLE,LAC,7,2003,192,101,74,228,293,302,289.8333333333333,353.2,297.8333333333333,346.2,4,17,9,17
2003_07_TB_SF,SF,TB,7,2003,253,212,265,68,465,333,344.5,377.4,333.5833333333333,364.24,16,25,13,24
2003_07_TEN_CAR,CAR,TEN,7,2003,362,44,240,134,406,374,314,359.8333333333333,354.44,358.25,12,21,18,21
2003_07_WAS_BUF,BUF,WAS,7,2003,244,196,116,59,440,175,285,366.3333333333333,285.0833333333333,377.3333333333333,3,24,3,26
2003_08_BUF_KC,KC,BUF,8,2003,275,100,165,133,375,298,355.57142857142856,307.14285714285717,309.85714285714283,339,19,7,8,17
2003_08_CAR_NO,NO,CAR,8,2003,201,104,148,223,305,371,343.2857142857143,329.3333333333333,286.14285714285717,362.1944444444444,15,12,4,24
2003_08_CLE_NE,NE,CLE,8,2003,259,94,155,84,353,239,323.14285714285717,290.2857142857143,312.25714285714287,345.88571428571424,10,5,10,18
2003_08_DAL_TB,TB,DAL,8,2003,151,128,140,60,279,200,370,370,364.5833333333333,272,26,26,25,2
2003_08_DEN_BAL,BAL,DEN,8,2003,137,151,114,104,288,218,327.1666666666667,358.42857142857144,313.5,385,11,20,12,28
2003_08_DET_CHI,CHI,DET,8,2003,207,68,180,80,275,260,274.1666666666667,272,335.1666666666667,370,3,2,16,26
2003_08_HOU_IND,IND,HOU,8,2003,269,122,150,131,391,281,353.8333333333333,358.5,311.6666666666667,290,18,21,9,5
2003_08_MIA_SD,LAC,MIA,8,2003,190,104,192,81,294,273,344.6666666666667,312.6666666666667,290.3611111111111,323.6666666666667,16,8,6,13
2003_08_NYG_MIN,MIN,NYG,8,2003,241,137,375,83,378,458,384,361.8333333333333,358.5,267.8333333333333,28,23,21,1
2003_08_NYJ_PHI,PHI,NYJ,8,2003,141,194,266,125,335,391,267.8333333333333,290,361.8333333333333,358.5,1,4,23,21
2003_08_SEA_CIN,CIN,SEA,8,2003,226,194,344,121,420,465,313.5,335.1666666666667,327.1666666666667,274.1666666666667,9,13,15,3
2003_08_SF_ARI,ARI,SF,8,2003,97,221,155,106,318,261,294.3333333333333,361.7142857142857,309.0416666666667,371.0571428571428,6,22,7,27
2003_08_STL_PIT,PIT,LA,8,2003,159,94,375,89,253,464,335.8333333333333,384,358,360.1111111111111,14,28,19,22
2003_08_TEN_JAX,JAX,TEN,8,2003,244,54,187,133,298,320,345.8333333333333,361.85714285714283,312.7916666666667,327.14285714285717,17,24,11,14
2003_09_CAR_HOU,HOU,CAR,9,2003,154,118,193,174,272,367,347.42857142857144,335.2857142857143,359.14285714285717,337.81632653061223,20,13,24,14
2003_09_CIN_ARI,ARI,CIN,9,2003,166,161,218,48,327,266,297.7142857142857,328.7142857142857,347.3265306122449,353.7142857142857,5,12,18,20
2003_09_GB_MIN,MIN,GB,9,2003,202,125,194,261,327,455,383.14285714285717,359.42857142857144,375.57142857142856,384.1714285714285,27,25,25,27
2003_09_IND_MIA,MIA,IND,9,2003,231,47,266,115,278,381,307,359.14285714285717,337.42857142857144,347.42857142857144,7,24,13,19
2003_09_JAX_BAL,BAL,JAX,9,2003,156,103,208,134,259,342,321.57142857142856,339,338.3673469387755,355.87755102040813,9,17,15,22
2003_09_NE_DEN,DEN,NE,9,2003,163,114,350,69,277,419,340.875,326.875,322.27083333333337,283.875,18,11,9,4
2003_09_NO_TB,TB,NO,9,2003,323,56,142,124,379,266,357,338.5,345.7142857142857,334.54166666666663,23,15,17,12
2003_09_NYG_NYJ,NYJ,NYG,9,2003,281,132,303,115,413,418,304.42857142857144,375.57142857142856,277.42857142857144,383.14285714285717,6,26,3,26
2003_09_OAK_DET,DET,LV,9,2003,117,112,190,94,229,284,270.2857142857143,309.85714285714283,274.2857142857143,355.57142857142856,1,8,2,21
2003_09_PHI_ATL,ATL,PHI,9,2003,164,131,312,128,295,440,286.14285714285717,277.42857142857144,343.2857142857143,304.42857142857144,4,3,16,6
2003_09_PIT_SEA,SEA,PIT,9,2003,215,98,226,105,313,331,353.7142857142857,324,328.7142857142857,395.42857142857144,22,10,11,28
2003_09_SD_CHI,CHI,LAC,9,2003,224,125,119,80,349,199,274.2857142857143,337.42857142857144,270.2857142857143,307,2,14,1,7
2003_09_STL_SF,SF,LA,9,2003,236,165,378,9,401,387,349.125,395.42857142857144,297.29166666666663,324,21,28,5,10
2003_09_WAS_DAL,DAL,WAS,9,2003,196,208,167,89,404,256,345.7142857142857,339,357,307.14285714285717,19,17,23,8
2003_10_ARI_PIT,PIT,ARI,10,2003,159,87,307,96,246,403,324.875,301.375,348.625,320.875,14,6,21,12
2003_10_ATL_NYG,NYG,ATL,10,2003,211,124,65,216,335,281,380.875,287.25,318,297.75,27,4,10,4
2003_10_BAL_STL,LA,BAL,10,2003,110,47,170,145,157,315,394.375,313.75,355.609375,339.375,28,10,23,19
2003_10_BUF_DAL,DAL,BUF,10,2003,116,122,104,100,238,204,353,306,328.625,358,20,8,15,24
2003_10_CHI_DET,DET,CHI,10,2003,238,17,149,66,255,215,265.125,283.625,306.625,320.125,1,2,8,11
2003_10_CLE_KC,KC,CLE,10,2003,368,95,149,80,463,229,358,283.875,306,326.875,22,3,7,14
2003_10_HOU_CIN,CIN,HOU,10,2003,182,240,146,140,422,286,320.875,338,301.375,339.25,13,16,5,18
2003_10_IND_JAX,JAX,IND,10,2003,179,174,347,47,353,394,339.375,361.875,313.75,303.375,18,24,9,6
2003_10_MIA_TEN,TEN,MIA,10,2003,223,101,181,59,324,240,356.625,303.375,339.85416666666663,361.875,21,7,20,25
2003_10_MIN_SD,LAC,MIN,10,2003,248,211,370,110,459,480,320.125,376.125,283.625,371.375,12,26,2,26
2003_10_NYJ_OAK,LV,NYJ,10,2003,186,169,269,155,355,424,306.625,318,265.125,380.875,9,11,1,28
2003_10_PHI_GB,GB,PHI,10,2003,109,241,198,92,350,290,371.375,297.75,376.125,287.25,25,5,27,3
2003_10_SEA_WAS,WAS,SEA,10,2003,242,137,241,125,379,366,328.625,348.625,353,324.875,15,19,22,13
2003_10_TB_CAR,CAR,TB,10,2003,277,78,275,89,355,364,339.25,359.75,338,329.4375,17,23,17,16
2003_11_ARI_CLE,CLE,ARI,11,2003,392,89,152,41,481,193,277.77777777777777,312.6666666666667,369.6666666666667,316.1111111111111,3,9,29,11
2003_11_ATL_NO,NO,ATL,11,2003,228,210,80,168,438,248,330.44444444444446,286.55555555555554,359.44444444444446,375.77777777777777,13,4,24,30
2003_11_BAL_MIA,MIA,BAL,11,2003,126,141,112,114,267,226,296.3333333333333,313.8888888888889,353,368,6,10,23,27
2003_11_DAL_NE,NE,DAL,11,2003,212,65,210,84,277,294,337.1111111111111,340.22222222222223,333.77777777777777,294.6666666666667,19,20,15,5
2003_11_DET_SEA,SEA,DET,11,2003,207,159,285,81,366,366,350.55555555555554,264,334.22222222222223,276,23,1,16,2
2003_11_GB_TB,TB,GB,11,2003,149,154,92,190,303,282,360.22222222222223,369,341,296.8888888888889,26,29,21,7
2003_11_HOU_BUF,BUF,HOU,11,2003,184,182,219,34,366,253,294.6666666666667,332.22222222222223,340.22222222222223,332.1111111111111,5,15,19,13
2003_11_JAX_TEN,TEN,JAX,11,2003,166,96,151,126,262,277,353,340.8888888888889,296.3333333333333,365.44444444444446,24,21,6,26
2003_11_KC_CIN,CIN,KC,11,2003,233,200,313,67,433,380,332.1111111111111,369.6666666666667,332.22222222222223,277.77777777777777,14,30,14,3
2003_11_MIN_OAK,LV,MIN,11,2003,195,191,396,94,386,490,312,387.6666666666667,329.77777777777777,335.55555555555554,8,32,12,17
2003_11_NYG_PHI,PHI,NYG,11,2003,314,62,268,109,376,377,296.8888888888889,375.77777777777777,369,286.55555555555554,7,31,28,4
2003_11_NYJ_IND,IND,NYJ,11,2003,401,145,219,132,546,351,365.44444444444446,329.77777777777777,340.8888888888889,312,27,12,20,8
2003_11_PIT_SF,SF,PIT,11,2003,254,169,320,44,423,364,354.8888888888889,316.1111111111111,394.4920634920635,312.6666666666667,25,11,32,9
2003_11_SD_DEN,DEN,LAC,11,2003,253,201,70,40,454,110,333.77777777777777,335.55555555555554,337.1111111111111,387.6666666666667,16,18,18,31
2003_11_STL_CHI,CHI,LA,11,2003,153,95,240,112,248,352,276,368,264,313.8888888888889,2,28,1,10
2003_11_WAS_CAR,CAR,WAS,11,2003,317,110,150,54,427,204,341,334.22222222222223,360.22222222222223,350.55555555555554,22,17,25,22
2003_12_CAR_DAL,DAL,CAR,12,2003,254,65,175,75,319,250,335.6,349.6,331.1,321.2,18,23,15,13
2003_12_CHI_DEN,DEN,CHI,12,2003,176,200,126,106,376,232,345.8,273.2,313,366.4,22,1,10,28
2003_12_CIN_SD,LAC,CIN,12,2003,210,118,243,210,328,453,313,342.2,345.8,370.7,10,20,22,29
2003_12_DET_MIN,MIN,DET,12,2003,196,121,167,74,317,241,397.9,274.2,319.4,352.1,32,2,11,24
2003_12_IND_BUF,BUF,IND,12,2003,135,110,229,103,245,332,301.8,383.5,324.3,331.9,7,31,14,16
2003_12_JAX_NYJ,NYJ,JAX,12,2003,236,61,172,158,297,330,331.9,334.5,383.5,343.9,16,17,31,21
2003_12_NE_HOU,HOU,NE,12,2003,93,89,368,128,182,496,324.3,331.1,301.8,335.6,14,15,7,18
2003_12_NO_PHI,PHI,NO,12,2003,259,201,287,199,460,486,304.8,341.2,375.9,282.7,8,19,30,3
2003_12_NYG_TB,TB,NYG,12,2003,269,93,160,79,362,239,354.5,375.9,360.3,304.8,25,30,26,8
2003_12_OAK_KC,KC,LV,12,2003,244,142,219,166,386,385,370.7,319.4,342.2,397.9,29,11,20,32
2003_12_PIT_CLE,CLE,PIT,12,2003,234,90,73,109,324,182,298.1,320.9,300.7,361.7,5,12,6,27
2003_12_SEA_BAL,BAL,SEA,12,2003,319,150,333,133,469,466,305.1,352.1,293.4,274.2,9,24,4,2
2003_12_SF_GB,GB,SF,12,2003,138,243,142,73,381,215,360.3,361.7,354.5,320.9,26,27,25,12
2003_12_STL_ARI,ARI,LA,12,2003,192,166,329,117,358,446,300.7,366.4,298.1,273.2,6,28,5,1
2003_12_TEN_ATL,ATL,TEN,12,2003,276,25,212,144,301,356,282.7,343.9,341.2,334.5,3,21,19,17
2003_12_WAS_MIA,MIA,WAS,12,2003,192,144,157,129,336,286,293.4,321.2,305.1,349.6,4,13,9,23
2003_13_ARI_CHI,CHI,ARI,13,2003,284,154,163,46,438,209,269.45454545454544,305.90909090909093,348.54545454545456,373.6363636363636,1,7,22,30
2003_13_ATL_HOU,HOU,ATL,13,2003,125,135,176,69,260,245,311.3636363636364,284.3636363636364,346.09090909090907,345,9,3,20,19
2003_13_BUF_NYG,NYG,BUF,13,2003,233,24,275,151,257,426,363.45454545454544,296.6363636363636,355.1818181818182,378.8181818181818,28,4,25,31
2003_13_CIN_PIT,PIT,CIN,13,2003,335,85,271,113,420,384,308.27272727272725,352.27272727272725,300.45454545454544,314.3636363636364,8,23,6,10
2003_13_CLE_SEA,SEA,CLE,13,2003,328,157,191,47,485,238,362.45454545454544,300.45454545454544,320,308.27272727272725,27,6,13,8
2003_13_DEN_OAK,LV,DEN,13,2003,153,120,105,193,273,298,325.3636363636364,348.54545454545456,372.09090909090907,269.45454545454544,14,22,29,1
2003_13_GB_DET,DET,GB,13,2003,183,94,296,52,277,348,271.1818181818182,362.1818181818182,390.54545454545456,348.3636363636364,2,26,32,21
2003_13_KC_SD,LAC,KC,13,2003,213,159,155,194,372,349,314.3636363636364,372.09090909090907,352.27272727272725,325.3636363636364,10,29,23,14
2003_13_MIA_DAL,DAL,MIA,13,2003,288,91,239,126,379,365,334.09090909090907,297.27272727272725,340.54545454545456,318,17,5,18,11
2003_13_MIN_STL,LA,MIN,13,2003,263,141,330,189,404,519,373.6363636363636,390.54545454545456,305.90909090909093,271.1818181818182,30,32,7,2
2003_13_NE_IND,IND,NE,13,2003,278,98,236,56,376,292,378.8181818181818,346.09090909090907,296.6363636363636,311.3636363636364,31,20,4,9
2003_13_NO_WAS,WAS,NO,13,2003,231,161,121,189,392,310,318,354.3636363636364,297.27272727272725,318.90909090909093,11,24,5,12
2003_13_PHI_CAR,CAR,PHI,13,2003,216,136,182,124,352,306,340.54545454545456,318.90909090909093,334.09090909090907,354.3636363636364,18,12,17,24
2003_13_SF_BAL,BAL,SF,13,2003,177,117,158,106,294,264,320,348.3636363636364,362.45454545454544,362.1818181818182,13,21,27,26
2003_13_TB_JAX,JAX,TB,13,2003,224,135,156,77,359,233,334.09090909090907,355.1818181818182,328.72727272727275,363.45454545454544,17,25,15,28
2003_13_TEN_NYJ,NYJ,TEN,13,2003,231,97,272,84,328,356,328.72727272727275,345,334.09090909090907,284.3636363636364,15,19,17,3
2003_14_ARI_SF,SF,ARI,14,2003,267,232,179,59,499,238,341.3333333333333,297.83333333333337,317.8333333333333,283.5,18,5,10,3
2003_14_CAR_ATL,ATL,CAR,14,2003,179,224,153,90,403,243,281.0833333333333,341.5,307.0833333333333,317.83333333333337,2,19,7,11
2003_14_CHI_GB,GB,CHI,14,2003,210,97,256,44,307,300,361,283.5,271.6666666666667,297.83333333333337,27,3,1,5
2003_14_CIN_BAL,BAL,CIN,14,2003,145,223,214,100,368,314,317.8333333333333,354.9166666666667,341.3333333333333,317.5833333333333,10,26,18,9
2003_14_DAL_PHI,PHI,DAL,14,2003,240,175,93,150,415,243,317.83333333333337,337.8333333333333,341.5,302.9166666666667,11,17,19,6
2003_14_HOU_JAX,JAX,HOU,14,2003,194,208,71,70,402,141,336.16666666666663,307.0833333333333,345,281.0833333333333,16,7,22,2
2003_14_IND_TEN,TEN,IND,14,2003,235,93,228,116,328,344,345.9166666666667,378.5833333333333,328.6666666666667,341.5833333333333,23,31,15,20
2003_14_KC_DEN,DEN,KC,14,2003,238,270,397,63,508,460,344.3333333333333,370.1666666666667,321,319.1666666666667,21,28,13,12
2003_14_MIA_NE,NE,MIA,14,2003,163,78,111,68,241,179,341.5833333333333,302.9166666666667,378.5833333333333,337.8333333333333,20,6,31,17
2003_14_NYJ_BUF,BUF,NYJ,14,2003,72,203,155,88,275,243,307.4166666666667,328.6666666666667,354.5833333333333,345.9166666666667,8,15,25,23
2003_14_OAK_PIT,PIT,LV,14,2003,266,133,68,122,399,190,317.5833333333333,321,354.9166666666667,344.3333333333333,9,13,26,21
2003_14_SD_DET,DET,LAC,14,2003,208,68,244,131,276,375,271.6666666666667,319.1666666666667,361,370.1666666666667,1,12,27,28
2003_14_SEA_MIN,MIN,SEA,14,2003,274,193,218,56,467,274,401.25,372.6666666666667,376.1666666666667,295.25,32,29,30,4
2003_14_STL_CLE,CLE,LA,14,2003,178,162,223,118,340,341,295.25,376.1666666666667,372.6666666666667,401.25,4,30,29,32
2003_14_TB_NO,NO,TB,14,2003,238,90,213,107,328,320,350.6666666666667,345,324.1666666666667,336.16666666666663,24,22,14,16
2003_14_WAS_NYG,NYG,WAS,14,2003,145,120,154,150,265,304,354.5833333333333,324.1666666666667,307.4166666666667,350.6666666666667,25,14,8,24
2003_15_ATL_IND,IND,ATL,15,2003,299,178,66,125,477,191,375.9230769230769,290.46153846153845,344.53846153846155,333.9230769230769,30,3,21,18
2003_15_BAL_OAK,LV,BAL,15,2003,186,79,193,149,265,342,310.9230769230769,321.6923076923077,323.84615384615387,351.7692307692308,9,10,14,24
2003_15_BUF_TEN,TEN,BUF,15,2003,295,86,168,89,381,257,344.53846153846155,304.9230769230769,375.9230769230769,322.0769230769231,21,8,30,11
2003_15_CAR_ARI,ARI,CAR,15,2003,172,171,236,67,343,303,293.2307692307693,333.9230769230769,353.46153846153845,290.46153846153845,4,18,25,3
2003_15_CLE_DEN,DEN,CLE,15,2003,269,165,181,102,434,283,356.9230769230769,298.6923076923077,377.0769230769231,373.46153846153845,27,7,31,29
2003_15_DAL_WAS,WAS,DAL,15,2003,59,106,108,222,165,330,322.61538461538464,330.53846153846155,347.6923076923077,325.3076923076923,12,16,22,15
2003_15_DET_KC,KC,DET,15,2003,372,149,197,137,521,334,377.0769230769231,272,356.9230769230769,323.46153846153845,31,1,27,13
2003_15_GB_SD,LAC,GB,15,2003,363,88,278,83,451,361,323.46153846153845,356.84615384615387,272,284.7692307692308,13,26,1,2
2003_15_HOU_TB,TB,HOU,15,2003,237,161,64,65,398,129,343.0769230769231,294.3076923076923,348.9230769230769,341.2307692307692,20,6,23,19
2003_15_JAX_NE,NE,JAX,15,2003,228,84,288,72,312,360,333.84615384615387,341.2307692307692,293.38461538461536,294.3076923076923,17,19,5,6
2003_15_MIN_CHI,CHI,MIN,15,2003,157,87,222,178,244,400,284.7692307692308,406.3076923076923,356.84615384615387,365.0769230769231,2,32,26,28
2003_15_NYG_NO,NO,NYG,15,2003,315,132,140,111,447,251,348.9230769230769,347.6923076923077,343.0769230769231,322.61538461538464,23,22,20,12
2003_15_PHI_MIA,MIA,PHI,15,2003,240,177,261,140,417,401,293.38461538461536,325.3076923076923,333.84615384615387,330.53846153846155,5,15,17,16
2003_15_PIT_NYJ,NYJ,PIT,15,2003,144,175,137,94,319,231,322.0769230769231,323.84615384615387,304.9230769230769,310.9230769230769,11,14,8,9
2003_15_SEA_STL,LA,SEA,15,2003,236,86,246,135,322,381,373.46153846153845,365.0769230769231,298.6923076923077,406.3076923076923,29,28,7,32
2003_15_SF_CIN,CIN,SF,15,2003,189,225,344,171,414,515,351.7692307692308,353.46153846153845,321.6923076923077,293.2307692307693,24,25,10,4
2003_16_ARI_SEA,SEA,ARI,16,2003,190,160,274,79,350,353,366.2142857142857,296.78571428571433,369.7857142857143,331.7142857142857,28,5,29,16
2003_16_ATL_TB,TB,ATL,16,2003,346,94,119,148,440,267,347,283.35714285714283,282.5,383.14285714285717,21,4,3,30
2003_16_BAL_CLE,CLE,BAL,16,2003,163,78,100,276,241,376,297.57142857142856,323.14285714285717,362.42857142857144,307.64285714285717,6,13,26,9
2003_16_CIN_STL,LA,CIN,16,2003,229,143,202,99,372,301,369.7857142857143,356.2142857142857,366.2142857142857,365,29,24,28,27
2003_16_DEN_IND,IND,DEN,16,2003,146,47,238,227,193,465,383.14285714285717,362.42857142857144,283.35714285714283,297.57142857142856,30,26,4,6
2003_16_DET_CAR,CAR,DET,16,2003,260,124,53,53,384,106,331.7142857142857,276.42857142857144,296.78571428571433,387.35714285714283,16,1,5,31
2003_16_GB_OAK,LV,GB,16,2003,223,104,399,156,327,555,307.64285714285717,357.14285714285717,323.14285714285717,332.57142857142856,9,25,13,18
2003_16_KC_MIN,MIN,KC,16,2003,260,223,224,105,483,329,405.85714285714283,387.35714285714283,281.85714285714283,276.42857142857144,32,31,2,1
2003_16_MIA_BUF,BUF,MIA,16,2003,155,73,46,132,228,178,301.5,302.2142857142857,347.14285714285717,330.7142857142857,7,8,22,15
2003_16_NE_NYJ,NYJ,NE,16,2003,229,109,138,133,338,271,321.85714285714283,332.2857142857143,317.2142857142857,342.57142857142856,12,17,11,20
2003_16_NO_JAX,JAX,NO,16,2003,131,243,296,61,374,357,342.57142857142856,355.92857142857144,332.2857142857143,340.7857142857143,20,23,17,19
2003_16_NYG_DAL,DAL,NYG,16,2003,240,104,190,54,344,244,330.5,340.7857142857143,311.35714285714283,355.92857142857144,14,19,10,23
2003_16_SD_PIT,PIT,LAC,16,2003,169,181,240,116,350,356,317.2142857142857,332.57142857142856,321.85714285714283,357.14285714285717,11,18,12,25
2003_16_SF_PHI,PHI,SF,16,2003,238,88,225,203,326,428,330.7142857142857,365,302.2142857142857,356.2142857142857,15,27,8,24
2003_16_TEN_HOU,HOU,TEN,16,2003,242,91,268,182,333,450,282.5,347.14285714285717,347,301.5,3,22,21,7
2003_16_WAS_CHI,CHI,WAS,16,2003,249,191,245,44,440,289,281.85714285714283,311.35714285714283,405.85714285714283,330.5,2,10,32,14
2003_17_BUF_NE,NE,BUF,17,2003,204,131,202,82,335,284,328.2,296.6,322.93333333333334,293.93333333333334,14,7,12,6
2003_17_CAR_NYG,NYG,CAR,17,2003,110,76,191,110,186,301,334.3333333333333,335.2,331.4,265.06666666666666,18,19,16,1
2003_17_CHI_KC,KC,CHI,17,2003,203,87,198,84,290,282,383.46666666666664,292.4,411,309.8666666666667,31,4,32,10
2003_17_CLE_CIN,CIN,CLE,17,2003,175,115,115,264,290,379,352.53333333333336,293.8,369.93333333333334,326.6666666666667,21,5,28,13
2003_17_DAL_NO,NO,DAL,17,2003,243,58,290,85,301,375,356,331.4,344.6666666666667,334.3333333333333,24,16,20,18
2003_17_DEN_GB,GB,DEN,17,2003,118,262,102,114,380,216,370.3333333333333,369.26666666666665,308.93333333333334,370.46666666666664,29,27,9,30
2003_17_IND_HOU,HOU,IND,17,2003,105,99,220,207,204,427,285.8666666666667,370.46666666666664,354,369.26666666666665,3,30,23,27
2003_17_JAX_ATL,ATL,JAX,17,2003,180,166,167,157,346,324,282.26666666666665,344.6666666666667,353.2,356,2,20,22,24
2003_17_MIN_ARI,ARI,MIN,17,2003,224,64,197,150,288,347,300.5333333333334,411,365.1333333333333,383.46666666666664,8,32,25,31
2003_17_NYJ_MIA,MIA,NYJ,17,2003,328,81,221,94,409,315,293.93333333333334,322.93333333333334,296.6,328.2,6,12,7,14
2003_17_OAK_SD,LAC,LV,17,2003,97,263,35,141,360,176,334.1333333333333,308.93333333333334,319.4,370.3333333333333,17,9,11,29
2003_17_PHI_WAS,WAS,PHI,17,2003,199,79,249,83,278,332,309.8666666666667,330.4,292.4,369.2,10,15,4,26
2003_17_PIT_BAL,BAL,PIT,17,2003,163,128,189,56,291,245,326.6666666666667,319.4,293.8,334.1333333333333,13,11,5,17
2003_17_SEA_SF,SF,SEA,17,2003,248,59,315,89,307,404,369.2,365.1333333333333,330.4,300.5333333333334,26,25,15,8
2003_17_STL_DET,DET,LA,17,2003,238,112,193,41,350,234,265.06666666666666,369.93333333333334,335.2,352.53333333333336,1,28,19,21
2003_17_TB_TEN,TEN,TB,17,2003,232,112,202,89,344,291,354,353.2,285.8666666666667,282.26666666666665,23,22,3,2
2003_18_DAL_CAR,CAR,DAL,18,2003,273,107,154,72,380,226,333.0625,334.125,325.0625,352.5625,2,3,3,5
2003_18_DEN_IND,IND,DEN,18,2003,394,85,181,146,479,327,374,359.6875,280.75,370.9375,8,5,1,8
2003_18_SEA_GB,GB,SEA,18,2003,319,78,305,49,397,354,370.9375,367.5625,359.6875,365.3125,7,6,6,7
2003_18_TEN_BAL,BAL,TEN,18,2003,214,54,159,165,268,324,324.4375,353.375,314.75,349.3125,1,4,2,4
2003_19_CAR_STL,LA,CAR,19,2003,332,64,290,216,396,506,361.4375,335.8235294117647,270.375,327.7647058823529,5,3,1,6
2003_19_GB_PHI,PHI,GB,19,2003,248,164,180,210,412,390,330.5,372.47058823529414,307.875,366.7647058823529,2,6,4,8
2003_19_IND_KC,KC,IND,19,2003,212,196,304,142,408,446,377.625,380.1764705882353,291.75,357.7647058823529,7,8,2,7
2003_19_TEN_NE,NE,TEN,19,2003,201,96,210,94,297,304,328.625,351.6470588235294,295.8125,321.11764705882354,1,4,3,5
2003_20_CAR_PHI,PHI,CAR,20,2003,188,137,101,155,325,256,335.29411764705884,345.27777777777777,373.50173010380627,363.3576388888889,2,3,3,2
2003_20_IND_NE,NE,IND,20,2003,237,112,237,98,349,335,326.7647058823529,383.8333333333333,348.84429065743944,379.3125,1,4,1,4
2003_21_CAR_NE,NE,CAR,21,2003,354,127,323,92,481,415,328,340.57894736842104,381.1203703703703,334.7523219814242,1,2,2,1
2004_01_ARI_STL,LA,ARI,1,2004,272,176,181,103,448,284,0,0,0,0,32,32,32,32
2004_01_ATL_SF,SF,ATL,1,2004,286,93,163,95,379,258,0,0,0,0,32,32,32,32
2004_01_BAL_CLE,CLE,BAL,1,2004,180,85,191,88,265,279,0,0,0,0,32,32,32,32
2004_01_CIN_NYJ,NYJ,CIN,1,2004,224,219,248,113,443,361,0,0,0,0,32,32,32,32
2004_01_DAL_MIN,MIN,DAL,1,2004,279,136,355,71,415,426,0,0,0,0,32,32,32,32
2004_01_DET_CHI,CHI,DET,1,2004,227,128,187,77,355,264,0,0,0,0,32,32,32,32
2004_01_GB_CAR,CAR,GB,1,2004,284,38,143,152,322,295,0,0,0,0,32,32,32,32
2004_01_IND_NE,NE,IND,1,2004,335,82,256,202,417,458,0,0,0,0,32,32,32,32
2004_01_JAX_BUF,BUF,JAX,1,2004,153,95,147,83,248,230,0,0,0,0,32,32,32,32
2004_01_KC_DEN,DEN,KC,1,2004,230,192,174,167,422,341,0,0,0,0,32,32,32,32
2004_01_NYG_PHI,PHI,NYG,1,2004,330,141,269,170,471,439,0,0,0,0,32,32,32,32
2004_01_OAK_PIT,PIT,LV,1,2004,142,107,305,61,249,366,0,0,0,0,32,32,32,32
2004_01_SD_HOU,HOU,LAC,1,2004,229,110,209,122,339,331,0,0,0,0,32,32,32,32
2004_01_SEA_NO,NO,SEA,1,2004,223,74,246,169,297,415,0,0,0,0,32,32,32,32
2004_01_TB_WAS,WAS,TB,1,2004,125,166,169,30,291,199,0,0,0,0,32,32,32,32
2004_01_TEN_MIA,MIA,TEN,1,2004,210,65,73,182,275,255,0,0,0,0,32,32,32,32
2004_02_BUF_OAK,LV,BUF,2,2004,209,73,222,67,282,289,366,248,249,230,21,3,4,2
2004_02_CAR_KC,KC,CAR,2,2004,187,109,180,183,296,363,341,322,422,295,18,15,26,13
2004_02_CHI_GB,GB,CHI,2,2004,252,152,132,182,404,314,295,355,322,264,13,19,15,7
2004_02_CLE_DAL,DAL,CLE,2,2004,322,126,71,136,448,207,426,265,415,279,27,8,24,10
2004_02_DEN_JAX,JAX,DEN,2,2004,120,67,250,106,187,356,230,422,248,341,2,26,3,18
2004_02_HOU_DET,DET,HOU,2,2004,176,94,313,112,270,425,264,339,355,331,7,17,19,16
2004_02_IND_TEN,TEN,IND,2,2004,277,153,254,129,430,383,255,458,275,417,5,31,9,25
2004_02_MIA_CIN,CIN,MIA,2,2004,147,94,218,25,241,243,361,275,443,255,20,9,29,5
2004_02_MIN_PHI,PHI,MIN,2,2004,245,91,343,78,336,421,471,415,439,426,32,24,28,27
2004_02_NE_ARI,ARI,NE,2,2004,160,50,219,172,210,391,284,417,448,458,11,25,30,31
2004_02_NYJ_SD,LAC,NYJ,2,2004,223,111,258,122,334,380,331,443,339,361,16,29,17,20
2004_02_PIT_BAL,BAL,PIT,2,2004,98,172,243,93,270,336,279,249,265,366,10,4,8,21
2004_02_SEA_TB,TB,SEA,2,2004,209,92,147,58,301,205,199,415,291,297,1,24,12,14
2004_02_SF_NO,NO,SF,2,2004,279,46,205,180,325,385,297,379,415,258,14,22,24,6
2004_02_STL_ATL,ATL,LA,2,2004,179,242,285,30,421,315,258,448,379,284,6,30,22,11
2004_02_WAS_NYG,NYG,WAS,2,2004,232,62,234,108,294,342,439,291,471,199,28,12,32,1
2004_03_ARI_ATL,ATL,ARI,3,2004,115,194,238,61,309,299,339.5,247,381.5,404,17,3,19,24
2004_03_BAL_CIN,CIN,BAL,3,2004,316,109,126,254,425,380,301,274.5,259,292.5,9,7,4,8
2004_03_CHI_MIN,MIN,CHI,3,2004,360,93,248,146,453,394,418,334.5,403.5,349.5,26,16,23,17
2004_03_CLE_NYG,NYG,CLE,3,2004,286,116,180,124,402,304,366.5,236,316.5,437,20,2,12,28
2004_03_DAL_WAS,WAS,DAL,3,2004,325,94,240,50,419,290,316.5,437,366.5,236,12,28,18,2
2004_03_GB_IND,IND,GB,3,2004,393,60,394,74,453,468,420.5,349.5,342.5,334.5,27,19,16,13
2004_03_HOU_KC,KC,HOU,3,2004,226,168,233,76,394,309,318.5,382,342.5,267,13,23,16,5
2004_03_JAX_TEN,TEN,JAX,3,2004,143,119,124,136,262,260,342.5,208.5,420.5,389,18,1,27,22
2004_03_NO_STL,LA,NO,3,2004,358,78,316,146,436,462,381.5,311,339.5,382,21,11,14,21
2004_03_PHI_DET,DET,PHI,3,2004,199,77,356,59,276,415,267,403.5,382,418,6,25,21,26
2004_03_PIT_MIA,MIA,PIT,3,2004,137,52,163,153,189,316,259,292.5,301,274.5,5,8,9,7
2004_03_SD_DEN,DEN,LAC,3,2004,294,37,159,85,331,244,389,332.5,208.5,411.5,24,15,1,25
2004_03_SF_SEA,SEA,SF,3,2004,263,117,153,48,380,201,310,382,250,311,10,23,3,11
2004_03_TB_OAK,LV,TB,3,2004,238,173,309,92,411,401,324,250,268.5,310,14,4,6,10
2004_04_ATL_CAR,CAR,ATL,4,2004,308,67,148,165,375,313,342.5,329.3333333333333,318.5,264.3333333333333,14,12,12,5
2004_04_CIN_PIT,PIT,CIN,4,2004,174,165,164,137,339,301,300.3333333333333,342.3333333333333,235.66666666666666,309.6666666666667,7,13,2,10
2004_04_DEN_TB,TB,DEN,4,2004,162,110,138,111,272,249,300.3333333333333,369.6666666666667,353,303,7,21,19,9
2004_04_IND_JAX,JAX,IND,4,2004,318,97,220,117,415,337,225.66666666666666,431.3333333333333,315.6666666666667,389,1,28,11,25
2004_04_KC_BAL,BAL,KC,4,2004,154,80,223,178,234,401,309.6666666666667,343.6666666666667,342.3333333333333,357.6666666666667,9,15,17,20
2004_04_NE_BUF,BUF,NE,4,2004,247,123,298,99,370,397,268.5,404,324,247,5,25,13,3
2004_04_NO_ARI,ARI,NO,4,2004,178,211,242,41,389,283,264.3333333333333,361.3333333333333,329.3333333333333,399.6666666666667,4,20,14,26
2004_04_NYG_GB,GB,NYG,4,2004,220,81,187,245,301,432,389,378.3333333333333,431.3333333333333,258.6666666666667,23,22,28,4
2004_04_NYJ_MIA,MIA,NYJ,4,2004,206,97,143,110,303,253,235.66666666666666,411.5,300.3333333333333,332.5,2,27,8,15
2004_04_OAK_HOU,HOU,LV,4,2004,228,158,237,151,386,388,357.6666666666667,353,343.6666666666667,300.3333333333333,19,17,18,8
2004_04_PHI_CHI,CHI,PHI,4,2004,215,32,237,158,247,395,354.3333333333333,407.3333333333333,429.6666666666667,270,18,26,27,6
2004_04_STL_SF,SF,LA,4,2004,299,58,186,174,357,360,321.6666666666667,399.6666666666667,333.3333333333333,361.3333333333333,11,24,16,21
2004_04_TEN_SD,LAC,TEN,4,2004,206,195,279,72,401,351,303,315.6666666666667,369.6666666666667,225.66666666666666,8,10,22,1
2004_04_WAS_CLE,CLE,WAS,4,2004,195,96,192,73,291,265,258.6666666666667,350.6666666666667,378.3333333333333,388,3,16,23,24
2004_05_ARI_SF,SF,ARI,5,2004,417,57,231,103,474,334,330.5,295.5,389.75,341.75,14,7,24,15
2004_05_BAL_WAS,WAS,BAL,5,2004,83,52,81,156,135,237,329.25,290.75,266.75,358,13,5,2,19
2004_05_BUF_NYJ,NYJ,BUF,5,2004,304,85,197,80,389,277,358.6666666666667,302.3333333333333,258.1111111111111,401.6666666666667,19,8,1,26
2004_05_CAR_DEN,DEN,CAR,5,2004,226,210,173,64,436,237,339.5,353.3333333333333,293.25,323.88888888888886,16,18,4,8
2004_05_CLE_PIT,PIT,CLE,5,2004,231,170,210,98,401,308,310,266.75,332,329.25,9,2,13,11
2004_05_DET_ATL,ATL,DET,5,2004,220,94,146,101,314,247,325.25,270,350.625,407.3333333333333,11,3,16,27
2004_05_JAX_SD,LAC,JAX,5,2004,211,176,357,80,387,437,327.5,273,324.5,407.75,12,4,9,28
2004_05_MIA_NE,NE,MIA,5,2004,76,135,257,67,211,324,401.6666666666667,252.5,302.3333333333333,371.875,26,1,6,23
2004_05_MIN_HOU,HOU,MIN,5,2004,372,52,396,122,424,518,364.75,429.6666666666667,361.75,354.3333333333333,21,28,20,18
2004_05_NYG_DAL,DAL,NYG,5,2004,126,166,217,125,292,342,388,391.75,350.6666666666667,367,23,25,17,22
2004_05_OAK_IND,IND,LV,5,2004,198,150,245,53,348,298,407.75,361.75,273,364.75,27,20,3,21
2004_05_STL_SEA,SEA,LA,5,2004,216,187,325,124,403,449,333.3333333333333,389.75,321.6666666666667,330.5,15,24,7,12
2004_05_TB_NO,NO,TB,5,2004,106,145,262,81,251,343,341.75,293.25,295.5,339.5,17,6,5,14
2004_05_TEN_GB,GB,TEN,5,2004,402,35,232,224,437,456,367,324.5,391.75,327.5,22,10,25,10
2004_06_CAR_PHI,PHI,CAR,6,2004,209,81,205,158,290,363,404.25,324.25,327.5,363.625,27,10,13,20
2004_06_CIN_CLE,CLE,CIN,6,2004,310,139,148,58,449,206,275,332,328.2,310,3,13,14,10
2004_06_DEN_OAK,LV,DEN,6,2004,136,31,190,254,167,444,349,358.8,395.8,330.06666666666666,15,20,25,15
2004_06_GB_DET,DET,GB,6,2004,101,33,277,157,134,434,264.25,381,322.4375,350.8,1,25,11,18
2004_06_HOU_TEN,TEN,HOU,6,2004,210,101,266,98,311,364,350.8,376.6,381,447.33333333333337,17,24,24,28
2004_06_KC_JAX,JAX,KC,6,2004,298,101,315,77,399,392,305.8,358,339.4,290.75,7,19,16,5
2004_06_MIA_BUF,BUF,MIA,6,2004,212,137,136,111,349,247,296,266.8,366.25,363.53333333333336,5,2,21,19
2004_06_MIN_NO,NO,MIN,6,2004,249,159,425,188,408,613,323.6,451.75,303.2,379.5625,9,28,8,23
2004_06_PIT_DAL,DAL,PIT,6,2004,284,100,193,125,384,318,364,328.2,379.3125,275,22,12,22,3
2004_06_SD_ATL,ATL,LAC,6,2004,218,93,227,95,311,322,323,339.4,265.4,305.8,8,14,1,9
2004_06_SEA_NE,NE,SEA,6,2004,231,138,349,102,369,451,354,350.75,270.375,404.5625,18,16,2,27
2004_06_SF_NYJ,NYJ,SF,6,2004,222,152,286,99,374,385,366.25,359.2,296,303.2,23,21,6,8
2004_06_TB_STL,LA,TB,6,2004,264,94,286,55,358,341,401.6,303.2,347.26666666666665,323.6,26,6,17,12
2004_06_WAS_CHI,CHI,WAS,6,2004,65,126,95,218,191,313,327.5,290.4,404.25,280,11,4,26,4
2004_07_ATL_KC,KC,ATL,7,2004,269,271,128,119,540,247,364.8,321,324.44,336.5,18,11,11,14
2004_07_BUF_BAL,BAL,BUF,7,2004,86,100,203,85,186,288,280,306.6,290.4,262.84000000000003,3,7,3,2
2004_07_CHI_TB,TB,CHI,7,2004,163,138,116,76,301,192,309.5,300.2,394.3333333333333,294.91999999999996,9,4,27,4
2004_07_DAL_GB,GB,DAL,7,2004,266,220,308,66,486,374,389.8333333333333,368,242.54166666666666,326.15999999999997,25,20,1,12
2004_07_DEN_CIN,CIN,DEN,7,2004,198,133,221,123,331,344,306.8,373,309.8,318.6666666666667,8,22,7,9
2004_07_DET_NYG,NYG,DET,7,2004,270,75,230,115,345,345,381.8,238.2,368.8,391.6,24,1,21,26
2004_07_JAX_IND,IND,JAX,7,2004,368,87,300,128,455,428,395.8,321.3333333333333,349,363.6666666666667,27,12,16,19
2004_07_NO_OAK,LV,NO,7,2004,350,82,282,42,432,324,318.6666666666667,337.6666666666667,373,478.625,10,15,23,28
2004_07_NYJ_NE,NE,NYJ,7,2004,230,133,162,106,363,268,357,367.8,370.8,364.36,17,19,22,20
2004_07_PHI_CLE,CLE,PHI,7,2004,236,165,376,121,401,497,304,381.4,311,332,6,23,8,13
2004_07_SD_CAR,CAR,LAC,7,2004,155,116,196,114,271,310,332,336.5,381.4,321,13,14,25,10
2004_07_SEA_ARI,ARI,SEA,7,2004,212,127,187,77,339,264,303.2,370.8,359.2,357,5,21,18,17
2004_07_STL_MIA,MIA,LA,7,2004,251,117,295,103,368,398,263.5,394.3333333333333,304.8333333333333,309.5,2,26,5,6
2004_07_TEN_MIN,MIN,TEN,7,2004,183,152,198,55,335,253,484,344.1666666666667,340.48,374.5,28,16,15,24
2004_08_ARI_BUF,BUF,ARI,8,2004,81,128,101,128,209,229,303.5,309.1666666666667,264.3333333333333,353,6,7,2,17
2004_08_ATL_DEN,DEN,ATL,8,2004,499,68,277,195,567,472,368.85714285714283,310.42857142857144,310.25714285714287,389.8285714285715,20,8,8,24
2004_08_BAL_PHI,PHI,BAL,8,2004,219,98,223,113,317,336,400.6666666666667,264.3333333333333,320.1666666666667,303.5,25,2,9,3
2004_08_CAR_SEA,SEA,CAR,8,2004,201,237,248,94,438,342,353,321.8333333333333,309.1666666666667,332.0833333333333,17,10,7,12
2004_08_CIN_TEN,TEN,CIN,8,2004,210,163,247,57,373,304,331.14285714285717,310.8333333333333,462.7142857142857,368.1666666666667,12,9,28,21
2004_08_DET_DAL,DAL,DET,8,2004,235,127,255,39,362,294,369,256,405.8611111111111,375.6666666666667,21,1,27,23
2004_08_GB_WAS,WAS,GB,8,2004,218,81,289,88,299,377,294.1666666666667,403.57142857142856,304.75,368.85714285714283,5,26,4,22
2004_08_IND_KC,KC,IND,8,2004,389,203,472,33,592,505,394,405.6666666666667,308.6666666666667,339.1111111111111,24,27,6,14
2004_08_JAX_HOU,HOU,JAX,8,2004,276,93,255,39,369,294,374.5,336.57142857142856,344.1666666666667,404.25714285714287,22,15,15,26
2004_08_MIA_NYJ,NYJ,MIA,8,2004,197,275,218,78,472,296,351.1666666666667,278.42857142857144,358,394.85714285714283,16,3,18,25
2004_08_NE_PIT,PIT,NE,8,2004,196,221,271,5,417,276,326.5,358,367.3333333333333,351.1666666666667,11,18,19,16
2004_08_NYG_MIN,MIN,NYG,8,2004,231,93,144,168,324,312,459.1666666666667,375.6666666666667,328.97222222222223,256,28,23,11,1
2004_08_OAK_SD,LAC,LV,8,2004,281,175,263,22,456,285,332.7142857142857,334.85714285714283,323.2857142857143,335.7142857142857,13,14,10,13
2004_08_SF_CHI,CHI,SF,8,2004,168,120,122,62,288,184,282.1666666666667,363.5,308.0833333333333,367.5416666666667,4,19,5,20
2004_09_ARI_MIA,MIA,ARI,9,2004,258,168,162,121,426,283,280.625,297.7142857142857,366.27083333333337,290,3,7,20,7
2004_09_CHI_NYG,NYG,CHI,9,2004,195,91,144,122,286,266,366.57142857142856,283,439.85714285714283,337.85714285714283,19,4,28,15
2004_09_CLE_BAL,BAL,CLE,9,2004,142,106,146,91,248,237,274.57142857142856,317.85714285714283,388.7142857142857,397.91428571428565,2,10,23,24
2004_09_DAL_CIN,CIN,DAL,9,2004,212,116,207,109,328,316,309.85714285714283,368,337.12244897959187,261.42857142857144,9,20,14,1
2004_09_HOU_DEN,DEN,HOU,9,2004,234,139,245,103,373,348,393.625,373.7142857142857,330.625,330.48979591836735,24,22,12,11
2004_09_KC_TB,TB,KC,9,2004,296,130,369,105,426,474,308.2857142857143,422.2857142857143,284.74285714285713,419.85714285714283,8,27,6,26
2004_09_MIN_IND,IND,MIN,9,2004,268,144,169,138,412,307,419.85714285714283,439.85714285714283,422.2857142857143,366.57142857142856,26,28,27,21
2004_09_NE_STL,LA,NE,9,2004,285,81,238,147,366,385,394.85714285714283,346.2857142857143,278.42857142857144,339.42857142857144,25,16,3,16
2004_09_NO_SD,LAC,NO,9,2004,257,152,173,55,409,228,348.125,335.7142857142857,328.625,334.85714285714283,17,13,10,13
2004_09_NYJ_BUF,BUF,NYJ,9,2004,184,157,207,88,341,295,290,368.42857142857144,297.7142857142857,280.9387755102041,5,21,8,4
2004_09_OAK_CAR,CAR,LV,9,2004,299,37,231,69,336,300,324.7142857142857,328.625,365.14285714285717,348.125,11,12,19,18
2004_09_PHI_PIT,PIT,PHI,9,2004,183,252,109,23,435,132,339.42857142857144,388.7142857142857,346.2857142857143,274.57142857142856,15,23,17,2
2004_09_SEA_SF,SF,SEA,9,2004,259,74,285,184,333,469,337.85714285714283,365.14285714285717,283,324.7142857142857,14,18,5,9
2004_09_WAS_DET,DET,WAS,9,2004,269,64,73,156,333,229,261.42857142857144,294.85714285714283,368,399.7755102040816,1,6,22,25
2004_10_BAL_NYJ,NYJ,BAL,10,2004,175,156,213,76,331,289,359.25,271.25,296.375,307.75,20,2,6,8
2004_10_BUF_NE,NE,BUF,10,2004,233,208,81,50,441,131,351.125,296.375,391.25,359.25,16,6,24,19
2004_10_CAR_SF,SF,CAR,10,2004,284,110,303,57,394,360,337.25,326.125,378.125,325.046875,15,11,22,12
2004_10_CHI_TEN,TEN,CHI,10,2004,334,72,116,101,406,217,336.375,280.875,309.97916666666663,356.5,14,3,9,17
2004_10_CIN_WAS,WAS,CIN,10,2004,216,87,217,99,303,316,286.625,312.125,270.375,361.5,4,8,1,20
2004_10_DET_JAX,JAX,DET,10,2004,198,239,121,81,437,202,331.25,270.375,373.8125,286.625,13,1,21,4
2004_10_HOU_IND,IND,HOU,10,2004,320,86,215,132,406,347,418.875,370.5,423.25,391.046875,26,22,27,23
2004_10_KC_NO,NO,KC,10,2004,259,134,311,200,393,511,322.25,428.75,355.734375,323,9,28,16,11
2004_10_MIN_GB,GB,MIN,10,2004,236,206,363,71,442,434,400.25,423.25,294.77083333333337,418.875,25,27,5,26
2004_10_NYG_ARI,ARI,NYG,10,2004,90,104,193,147,194,340,295.875,356.5,298.796875,280.875,5,18,7,3
2004_10_PHI_DAL,DAL,PHI,10,2004,254,71,345,149,325,494,361.5,356.625,312.125,351.375,21,19,10,15
2004_10_PIT_CLE,CLE,PIT,10,2004,174,68,134,180,242,314,307.75,351.375,271.25,356.625,7,17,2,18
2004_10_SEA_STL,LA,SEA,10,2004,262,202,172,200,464,372,391.25,378.125,351.125,337.25,24,23,14,13
2004_10_TB_ATL,ATL,TB,10,2004,147,205,174,68,352,242,330.625,323,393.625,428.75,12,10,25,28
2004_11_ARI_CAR,CAR,ARI,11,2004,160,157,343,85,317,428,329.8888888888889,284.55555555555554,343.55555555555554,354.6666666666667,12,5,17,20
2004_11_ATL_NYG,NYG,ATL,11,2004,162,119,115,201,281,316,354.6666666666667,333,284.55555555555554,314,19,14,5,10
2004_11_DAL_BAL,BAL,DAL,11,2004,232,59,156,94,291,250,273.22222222222223,357.44444444444446,356.1111111111111,371.8888888888889,2,22,21,26
2004_11_DEN_NO,NO,DEN,11,2004,377,49,224,165,426,389,330.1111111111111,391.3333333333333,437.8888888888889,370.8571428571429,13,27,32,25
2004_11_DET_MIN,MIN,DET,11,2004,233,107,91,146,340,237,424.44444444444446,262.77777777777777,404.8888888888889,343,31,1,29,16
2004_11_GB_HOU,HOU,GB,11,2004,164,107,383,90,271,473,367.8888888888889,404.8888888888889,417.44444444444446,424.44444444444446,24,29,30,31
2004_11_IND_CHI,CHI,IND,11,2004,175,79,211,275,254,486,273.77777777777777,417.44444444444446,344.1111111111111,367.8888888888889,3,30,18,24
2004_11_MIA_SEA,SEA,MIA,11,2004,196,116,230,69,312,299,377.44444444444446,296.77777777777777,399.3333333333333,296.07936507936506,26,7,28,7
2004_11_NE_KC,KC,NE,11,2004,381,64,315,98,445,413,437.8888888888889,361.1111111111111,330.1111111111111,278,32,23,14,4
2004_11_NYJ_CLE,CLE,NYJ,11,2004,120,99,116,157,219,273,300.44444444444446,356.1111111111111,347.22222222222223,273.22222222222223,8,21,19,2
2004_11_PIT_CIN,CIN,PIT,11,2004,165,62,138,151,227,289,312.55555555555554,347.22222222222223,288.44444444444446,300.44444444444446,9,18,6,8
2004_11_SD_OAK,LV,LAC,11,2004,227,53,226,176,280,402,325.44444444444446,354.8888888888889,325.968253968254,323.74603174603175,11,20,12,11
2004_11_SF_TB,TB,SF,11,2004,210,159,147,72,369,219,314,343.55555555555554,333,329.8888888888889,10,16,15,13
2004_11_STL_BUF,BUF,LA,11,2004,185,119,287,35,304,322,278,399.3333333333333,361.1111111111111,377.44444444444446,4,28,23,27
2004_11_TEN_JAX,JAX,TEN,11,2004,129,151,209,103,280,312,343,344.1111111111111,262.77777777777777,273.77777777777777,15,17,1,3
2004_11_WAS_PHI,PHI,WAS,11,2004,222,125,162,51,347,213,371.8888888888889,288.44444444444446,357.44444444444446,312.55555555555554,25,6,22,9
2004_12_BAL_NE,NE,BAL,12,2004,172,144,93,77,316,170,366.3,275,438.6,346.7,24,3,32,19
2004_12_BUF_SEA,SEA,BUF,12,2004,185,55,292,148,240,440,370.9,280.6,297,391.6,26,4,7,28
2004_12_CHI_DAL,DAL,CHI,12,2004,123,154,132,49,277,181,346.7,271.8,275,424.3,19,2,3,31
2004_12_CLE_CIN,CIN,CLE,12,2004,251,253,413,76,504,489,304,292.3,341.4,347.8,9,6,18,21
2004_12_IND_DET,DET,IND,12,2004,233,168,243,113,401,356,260.2,424.3,416,271.8,1,31,30,2
2004_12_JAX_MIN,MIN,JAX,12,2004,235,112,235,154,347,389,416,336.7,260.2,340.9,30,15,1,17
2004_12_MIA_SF,SF,MIA,12,2004,181,77,159,49,258,208,331.1,297,319.5,370.9,13,7,10,26
2004_12_NO_ATL,ATL,NO,12,2004,212,186,189,141,398,330,331.3,339.7,347.3,391.1,14,16,20,27
2004_12_NYJ_ARI,ARI,NYJ,12,2004,181,71,193,146,252,339,298.9,347.8,328.6,292.3,8,21,12,6
2004_12_OAK_DEN,DEN,LV,12,2004,245,122,339,61,367,400,391.1,320.9,339.7,359.6,27,11,16,23
2004_12_PHI_NYG,NYG,PHI,12,2004,148,161,244,152,309,396,347.3,369.4,331.3,280.9,20,25,14,5
2004_12_SD_KC,KC,LAC,12,2004,208,110,378,127,318,505,438.6,359.6,366.3,320.9,32,23,24,11
2004_12_STL_GB,GB,LA,12,2004,215,231,448,47,446,495,411.7,391.6,358.2,280.6,29,28,22,4
2004_12_TB_CAR,CAR,TB,12,2004,213,112,347,62,325,409,328.6,319.5,298.9,331.1,12,10,8,13
2004_12_TEN_HOU,HOU,TEN,12,2004,201,149,227,134,350,361,358.2,340.9,411.7,336.7,22,17,29,15
2004_12_WAS_PIT,PIT,WAS,12,2004,131,107,138,51,238,189,341.4,280.9,304,369.4,18,5,9,25
2004_13_ARI_DET,DET,ARI,13,2004,196,215,168,94,411,262,273,294.6363636363636,418.09090909090907,347,4,6,31,21
2004_13_ATL_TB,TB,ATL,13,2004,131,132,115,163,263,278,327.6363636363636,337.3636363636364,328.27272727272725,338.8181818181818,11,15,13,16
2004_13_BUF_MIA,MIA,BUF,13,2004,303,106,277,105,409,382,288.90909090909093,295.09090909090907,324.45454545454544,359,5,7,10,23
2004_13_CAR_NO,NO,CAR,13,2004,251,30,294,132,281,426,338.8181818181818,328.27272727272725,337.3636363636364,327.6363636363636,16,13,15,11
2004_13_CIN_BAL,BAL,CIN,13,2004,172,192,382,98,364,480,265.45454545454544,322.1818181818182,361.72727272727275,310.1818181818182,2,9,24,8
2004_13_DAL_SEA,SEA,DAL,13,2004,414,109,225,198,523,423,359,340.3636363636364,295.09090909090907,263.54545454545456,23,17,7,1
2004_13_DEN_SD,LAC,DEN,13,2004,106,122,278,74,228,352,372.8181818181818,388.90909090909093,427.6363636363636,328.09090909090907,26,27,32,12
2004_13_GB_PHI,PHI,GB,13,2004,464,93,226,50,557,276,371.8181818181818,414.8181818181818,343.8181818181818,401,25,30,20,28
2004_13_HOU_NYJ,NYJ,HOU,13,2004,155,210,157,83,365,240,347,357.45454545454544,294.6363636363636,342.72727272727275,21,22,6,19
2004_13_KC_OAK,LV,KC,13,2004,343,31,340,160,374,500,328.09090909090907,427.6363636363636,388.90909090909093,372.8181818181818,12,32,27,26
2004_13_MIN_CHI,CHI,MIN,13,2004,213,144,279,146,357,425,263.54545454545456,409.72727272727275,340.3636363636364,341.45454545454544,1,29,17,18
2004_13_NE_CLE,CLE,NE,13,2004,277,46,201,225,323,426,310.1818181818182,361.72727272727275,322.1818181818182,265.45454545454544,8,24,9,2
2004_13_NYG_WAS,WAS,NYG,13,2004,174,211,113,38,385,151,272.54545454545456,343.8181818181818,332,371.8181818181818,3,20,14,25
2004_13_PIT_JAX,JAX,PIT,13,2004,268,100,221,120,368,341,341.45454545454544,332,409.72727272727275,272.54545454545456,18,14,29,3
2004_13_SF_STL,LA,SF,13,2004,238,136,121,63,374,184,401,324.45454545454544,414.8181818181818,288.90909090909093,28,10,30,5
2004_13_TEN_IND,IND,TEN,13,2004,425,150,269,115,575,384,418.09090909090907,342.72727272727275,273,357.45454545454544,31,19,4,22
2004_14_CHI_JAX,JAX,CHI,14,2004,242,90,212,31,332,243,343.6666666666667,271.3333333333333,332.75,411,18,1,14,30
2004_14_CIN_NE,NE,CIN,14,2004,260,94,328,150,354,478,367.0833333333333,335.3333333333333,311.25,273.6666666666667,24,16,8,2
2004_14_CLE_BUF,BUF,CLE,14,2004,110,215,67,29,325,96,302.3333333333333,311.25,298.9166666666667,367.0833333333333,7,8,6,24
2004_14_DET_GB,GB,DET,14,2004,188,116,47,193,304,240,403.25,284.5,387.25,291.9166666666667,29,4,27,5
2004_14_IND_HOU,HOU,IND,14,2004,167,148,298,101,315,399,347.6666666666667,431.1666666666667,348.5,346.1666666666667,21,31,22,19
2004_14_KC_TEN,TEN,KC,14,2004,426,163,244,146,589,390,346.1666666666667,433.6666666666667,431.1666666666667,331.91666666666663,19,32,31,12
2004_14_MIA_DEN,DEN,MIA,14,2004,219,196,170,70,415,240,385.8333333333333,298.9166666666667,360.75,302.3333333333333,26,6,23,7
2004_14_NO_DAL,DAL,NO,14,2004,160,121,252,105,281,357,347.25,334,372.6666666666667,336.4166666666667,20,15,25,17
2004_14_NYG_BAL,BAL,NYG,14,2004,219,169,154,51,388,205,273.6666666666667,327.75,335.3333333333333,281.9166666666667,2,11,16,3
2004_14_NYJ_PIT,PIT,NYJ,14,2004,154,120,189,107,274,296,332.75,348.5,343.6666666666667,347.6666666666667,14,22,18,21
2004_14_OAK_ATL,ATL,LV,14,2004,145,219,166,131,364,297,332.4166666666667,331.91666666666663,322.25,433.6666666666667,13,12,10,32
2004_14_PHI_WAS,WAS,PHI,14,2004,251,88,260,67,339,327,281.9166666666667,387.25,327.75,403.25,3,27,11,29
2004_14_SEA_MIN,MIN,SEA,14,2004,270,113,334,138,383,472,411,372.6666666666667,271.3333333333333,347.25,30,25,1,20
2004_14_SF_ARI,ARI,SF,14,2004,307,75,191,168,382,359,291.9166666666667,312.75,284.5,398.75,5,9,4,28
2004_14_STL_CAR,CAR,LA,14,2004,206,119,246,66,325,312,336.4166666666667,398.75,334,312.75,17,28,15,9
2004_14_TB_SD,LAC,TB,14,2004,220,130,392,63,350,455,360.75,322.25,385.8333333333333,332.4166666666667,23,10,26,13
2004_15_BAL_IND,IND,BAL,15,2004,249,67,210,160,316,370,428.6923076923077,282.46153846153845,345.15384615384613,318.3076923076923,31,3,20,10
2004_15_BUF_CIN,CIN,BUF,15,2004,151,149,183,43,300,226,346.3076923076923,304.0769230769231,366.0769230769231,294.6923076923077,21,8,24,6
2004_15_CAR_ATL,ATL,CAR,15,2004,154,204,340,61,358,401,334.84615384615387,335.53846153846155,329.2307692307692,392.0769230769231,14,15,12,28
2004_15_DAL_PHI,PHI,DAL,15,2004,223,120,176,80,343,256,382.61538461538464,342.15384615384613,286.3076923076923,335.7692307692308,26,17,4,16
2004_15_DEN_KC,KC,DEN,15,2004,266,162,292,129,428,421,430.3076923076923,388.0769230769231,364.84615384615387,294.38461538461536,32,27,23,5
2004_15_HOU_CHI,CHI,HOU,15,2004,168,54,220,106,222,326,269.15384615384613,345.15384615384613,342.7692307692308,428.6923076923077,1,20,18,31
2004_15_JAX_GB,GB,JAX,15,2004,367,94,121,197,461,318,395.61538461538464,342.7692307692308,281.0769230769231,269.15384615384613,29,18,2,1
2004_15_MIN_DET,DET,MIN,15,2004,361,113,404,91,474,495,281.0769230769231,408.84615384615387,395.61538461538464,380.3076923076923,2,30,29,25
2004_15_NE_MIA,MIA,NE,15,2004,198,52,171,166,250,337,294.38461538461536,366.0769230769231,388.0769230769231,346.3076923076923,5,24,27,21
2004_15_NO_TB,TB,NO,15,2004,118,169,169,115,287,284,332.46153846153845,335.7692307692308,359.9230769230769,342.15384615384613,13,16,22,17
2004_15_PIT_NYG,NYG,PIT,15,2004,182,96,326,160,278,486,318.3076923076923,328.2307692307692,282.46153846153845,344.46153846153845,10,11,3,19
2004_15_SD_CLE,CLE,LAC,15,2004,108,126,85,174,234,259,294.6923076923077,359.9230769230769,304.0769230769231,332.46153846153845,6,22,8,13
2004_15_SEA_NYJ,NYJ,SEA,15,2004,253,229,201,88,482,289,344.46153846153845,380.3076923076923,328.2307692307692,408.84615384615387,19,25,11,30
2004_15_STL_ARI,ARI,LA,15,2004,287,131,189,22,418,211,298.84615384615387,392.0769230769231,316.3076923076923,335.53846153846155,7,28,9,15
2004_15_TEN_OAK,LV,TEN,15,2004,371,57,492,61,428,553,329.2307692307692,364.84615384615387,334.84615384615387,430.3076923076923,12,23,14,32
2004_15_WAS_SF,SF,WAS,15,2004,206,55,214,128,261,342,316.3076923076923,286.3076923076923,298.84615384615387,382.61538461538464,9,4,7,26
2004_16_ARI_SEA,SEA,ARI,16,2004,128,175,248,97,303,345,373.7857142857143,307.35714285714283,354.2857142857143,379.14285714285717,24,8,22,26
2004_16_ATL_NO,NO,ATL,16,2004,227,160,188,93,387,281,332.07142857142856,336.5,329.2142857142857,340.2142857142857,12,15,11,17
2004_16_BAL_PIT,PIT,BAL,16,2004,221,183,177,71,404,248,339.5,288.7142857142857,315.42857142857144,420.64285714285717,16,2,10,31
2004_16_BUF_SF,SF,BUF,16,2004,109,98,216,226,207,442,312.35714285714283,298.5,290.2857142857143,343,9,7,3,19
2004_16_CAR_TB,TB,CAR,16,2004,321,46,214,141,367,355,329.2142857142857,340.2142857142857,332.07142857142856,336.5,11,17,12,15
2004_16_CHI_DET,DET,CHI,16,2004,166,158,114,124,324,238,294.85714285714283,265.7857142857143,415,343.7857142857143,6,1,30,20
2004_16_CLE_MIA,MIA,CLE,16,2004,176,116,161,142,292,303,291.21428571428567,290.35714285714283,364,352.7142857142857,5,4,23,21
2004_16_DEN_TEN,TEN,DEN,16,2004,137,59,303,193,196,496,378.2857142857143,390.42857142857144,336.2857142857143,430.14285714285717,25,28,14,32
2004_16_GB_MIN,MIN,GB,16,2004,285,131,365,102,416,467,415,400.2857142857143,294.85714285714283,341,30,29,6,18
2004_16_HOU_JAX,JAX,HOU,16,2004,54,95,131,219,149,350,341,343.7857142857143,400.2857142857143,265.7857142857143,18,20,29,1
2004_16_NE_NYJ,NYJ,NE,16,2004,252,46,264,114,298,378,354.2857142857143,364,373.7857142857143,291.21428571428567,22,23,24,5
2004_16_NYG_CIN,CIN,NYG,16,2004,186,63,201,142,249,343,343,315.42857142857144,298.5,339.5,19,10,7,16
2004_16_OAK_KC,KC,LV,16,2004,358,99,217,100,457,317,430.14285714285717,336.2857142857143,390.42857142857144,378.2857142857143,32,14,28,25
2004_16_PHI_STL,LA,PHI,16,2004,225,209,82,81,434,163,379.14285714285717,379.7857142857143,307.35714285714283,336,26,27,8,13
2004_16_SD_IND,IND,LAC,16,2004,383,104,290,93,487,383,420.64285714285717,352.7142857142857,288.7142857142857,290.35714285714283,31,21,2,4
2004_16_WAS_DAL,DAL,WAS,16,2004,234,89,158,84,323,242,336,290.2857142857143,379.7857142857143,312.35714285714283,13,3,27,9
2004_17_ATL_SEA,SEA,ATL,17,2004,191,83,168,204,274,372,369.06666666666666,332.8,309.8666666666667,335.73333333333335,26,13,9,16
2004_17_CIN_PHI,PHI,CIN,17,2004,287,80,160,148,367,308,365.3333333333333,336.73333333333335,382.8,317.26666666666665,24,17,27,10
2004_17_CLE_HOU,HOU,CLE,17,2004,130,136,228,137,266,365,344.2,291.2,328.2,291.2666666666666,20,4,11,5
2004_17_DAL_NYG,NYG,DAL,17,2004,144,98,231,147,242,378,317.26666666666665,335.1333333333333,336.73333333333335,287.06666666666666,10,15,17,3
2004_17_DET_TEN,TEN,DET,17,2004,217,95,346,103,312,449,366.1333333333333,296.8,397.46666666666664,263.93333333333334,25,6,28,1
2004_17_GB_CHI,CHI,GB,17,2004,196,110,327,60,306,387,263.93333333333334,404.73333333333335,296.8,415.06666666666666,1,29,6,30
2004_17_IND_DEN,DEN,IND,17,2004,246,214,174,34,460,208,397.46666666666664,425.06666666666666,366.1333333333333,354.73333333333335,28,31,25,22
2004_17_JAX_OAK,LV,JAX,17,2004,142,147,149,93,289,242,335,328.2,431.93333333333334,344.2,14,11,32,20
2004_17_KC_SD,LAC,KC,17,2004,232,138,373,70,370,443,354.73333333333335,431.93333333333334,425.06666666666666,335,22,32,31,14
2004_17_MIA_BAL,BAL,MIA,17,2004,142,190,264,97,332,361,286,291.2666666666666,343.8,291.2,2,5,19,4
2004_17_MIN_WAS,WAS,MIN,17,2004,216,117,299,52,333,351,287.06666666666666,415.06666666666666,335.1333333333333,404.73333333333335,3,30,15,29
2004_17_NO_CAR,CAR,NO,17,2004,307,46,216,164,353,380,341.2,335.73333333333335,331.73333333333335,332.8,18,16,12,13
2004_17_NYJ_STL,LA,NYJ,17,2004,450,47,181,180,497,361,382.8,350.53333333333336,365.3333333333333,364.93333333333334,27,21,24,23
2004_17_PIT_BUF,BUF,PIT,17,2004,189,96,120,157,285,277,308.06666666666666,343.8,305.3333333333333,286,8,19,7,2
2004_17_SF_NE,NE,SF,17,2004,236,174,189,135,410,324,364.93333333333334,305.3333333333333,350.53333333333336,308.06666666666666,23,7,21,8
2004_17_TB_ARI,ARI,TB,17,2004,115,107,224,62,222,286,309.8666666666667,331.73333333333335,369.06666666666666,341.2,9,12,26,18
2004_18_DEN_IND,IND,DEN,18,2004,458,76,284,78,534,362,411.5,401.375,401.375,411.5,8,5,6,7
2004_18_MIN_GB,GB,MIN,18,2004,216,105,284,116,321,400,403.625,411.0625,266.5625,289.9375,6,7,1,2
2004_18_NYJ_SD,LAC,NYJ,18,2004,319,100,279,126,419,405,355.6875,351.1875,432.625,389.9375,2,1,8,5
2004_18_STL_SEA,SEA,LA,18,2004,341,81,313,102,422,415,363.125,389.9375,335.25,351.1875,3,4,3,4
2004_19_IND_NE,NE,IND,19,2004,144,210,238,46,354,284,367.75,418.70588235294116,306.5,399.05882352941177,5,8,1,8
2004_19_MIN_PHI,PHI,MIN,19,2004,286,109,316,97,395,413,365.4375,410.4117647058824,334.9375,398.7647058823529,4,7,3,7
2004_19_NYJ_PIT,PIT,NYJ,19,2004,181,193,182,110,374,292,339.625,354.3529411764706,306.625,359.4117647058824,2,3,2,4
2004_19_STL_ATL,ATL,LA,19,2004,84,327,299,77,411,376,335.25,391.4117647058824,363.125,366.5882352941176,1,6,5,6
2004_20_ATL_PHI,PHI,ATL,20,2004,183,156,136,99,339,235,367.1764705882353,339.70588235294116,410.56401384083046,390.5051903114187,4,1,3,2
2004_20_NE_PIT,PIT,NE,20,2004,226,163,207,126,389,333,341.6470588235294,366.94117647058823,350.68512110726647,410.7820069204152,2,3,1,4
2004_21_NE_PHI,PHI,NE,21,2004,357,45,236,112,402,348,365.6111111111111,365.05555555555554,333.8888888888889,344.27777777777777,2,1,1,2
2005_01_ARI_NYG,NYG,ARI,1,2005,172,121,316,31,293,347,0,0,0,0,32,32,32,32
2005_01_CHI_WAS,WAS,CHI,1,2005,175,164,141,41,339,182,0,0,0,0,32,32,32,32
2005_01_CIN_CLE,CLE,CIN,1,2005,278,95,280,148,373,428,0,0,0,0,32,32,32,32
2005_01_DAL_SD,LAC,DAL,1,2005,209,103,226,109,312,335,0,0,0,0,32,32,32,32
2005_01_DEN_MIA,MIA,DEN,1,2005,275,151,251,70,426,321,0,0,0,0,32,32,32,32
2005_01_GB_DET,DET,GB,1,2005,167,102,201,46,269,247,0,0,0,0,32,32,32,32
2005_01_HOU_BUF,BUF,HOU,1,2005,170,152,70,95,322,165,0,0,0,0,32,32,32,32
2005_01_IND_BAL,BAL,IND,1,2005,355,77,254,86,432,340,0,0,0,0,32,32,32,32
2005_01_NO_CAR,CAR,NO,1,2005,212,141,192,101,353,293,0,0,0,0,32,32,32,32
2005_01_NYJ_KC,KC,NYJ,1,2005,200,198,352,57,398,409,0,0,0,0,32,32,32,32
2005_01_OAK_NE,NE,LV,1,2005,306,73,265,92,379,357,0,0,0,0,32,32,32,32
2005_01_PHI_ATL,ATL,PHI,1,2005,156,200,257,51,356,308,0,0,0,0,32,32,32,32
2005_01_SEA_JAX,JAX,SEA,1,2005,258,119,246,97,377,343,0,0,0,0,32,32,32,32
2005_01_STL_SF,SF,LA,1,2005,192,34,362,89,226,451,0,0,0,0,32,32,32,32
2005_01_TB_MIN,MIN,TB,1,2005,233,26,213,146,259,359,0,0,0,0,32,32,32,32
2005_01_TEN_PIT,PIT,TEN,1,2005,218,206,219,97,424,316,0,0,0,0,32,32,32,32
2005_02_ATL_SEA,SEA,ATL,2,2005,281,163,123,115,444,238,343,356,377,308,17,20,24,9
2005_02_BAL_TEN,TEN,BAL,2,2005,195,97,212,14,292,226,316,432,424,340,11,31,28,16
2005_02_BUF_TB,TB,BUF,2,2005,136,191,112,47,327,159,359,322,259,165,22,13,5,1
2005_02_CLE_GB,GB,CLE,2,2005,342,116,336,55,458,391,247,373,269,428,4,23,6,30
2005_02_DET_CHI,CHI,DET,2,2005,161,187,216,29,348,245,182,269,339,247,2,6,15,4
2005_02_JAX_IND,IND,JAX,2,2005,122,146,198,128,268,326,340,377,432,343,16,24,31,17
2005_02_KC_OAK,LV,KC,2,2005,263,71,237,125,334,362,357,398,379,409,21,26,25,27
2005_02_MIA_NYJ,NYJ,MIA,2,2005,190,98,177,66,288,243,409,426,398,321,27,29,26,12
2005_02_MIN_CIN,CIN,MIN,2,2005,337,167,236,77,504,313,428,259,373,359,30,5,23,22
2005_02_NE_CAR,CAR,NE,2,2005,154,104,270,39,258,309,353,379,293,357,19,25,8,21
2005_02_NYG_NO,NO,NYG,2,2005,375,72,165,92,447,257,293,293,353,347,8,8,19,18
2005_02_PIT_HOU,HOU,PIT,2,2005,167,113,254,135,280,389,165,424,322,316,1,28,13,11
2005_02_SD_DEN,DEN,LAC,2,2005,248,98,175,79,346,254,321,312,426,335,12,10,29,14
2005_02_SF_PHI,PHI,SF,2,2005,458,140,107,58,598,165,308,226,356,451,9,3,20,32
2005_02_STL_ARI,ARI,LA,2,2005,327,82,216,108,409,324,347,451,293,226,18,32,8,3
2005_02_WAS_DAL,DAL,WAS,2,2005,261,90,291,104,351,395,335,339,312,182,14,15,10,2
2005_03_ARI_SEA,SEA,ARI,3,2005,284,163,202,90,447,292,393.5,378,297,387.5,25,21,8,25
2005_03_ATL_BUF,BUF,ATL,3,2005,75,172,167,236,247,403,240.5,297,343,393.5,2,7,14,26
2005_03_CAR_MIA,MIA,CAR,3,2005,171,144,285,61,315,346,334.5,305.5,348.5,344,12,10,17,15
2005_03_CIN_CHI,CHI,CIN,3,2005,149,106,169,83,255,252,265,466,257,286,3,28,4,7
2005_03_CLE_IND,IND,CLE,3,2005,228,111,208,75,339,283,304,382,351.5,352.5,9,23,18,19
2005_03_DAL_SF,SF,DAL,3,2005,269,124,363,95,393,458,195.5,343,453,367,1,14,27,20
2005_03_JAX_NYJ,NYJ,JAX,3,2005,95,89,177,139,184,316,348.5,351.5,334.5,304,17,18,13,9
2005_03_KC_DEN,DEN,KC,3,2005,152,221,221,74,373,295,333.5,380,283,345.5,11,22,6,16
2005_03_NE_PIT,PIT,NE,3,2005,216,79,372,79,295,451,406.5,344,222.5,305.5,26,15,2,10
2005_03_NO_MIN,MIN,NO,3,2005,300,147,199,114,447,313,286,370,466,275,6,20,28,5
2005_03_NYG_SD,LAC,NYG,3,2005,217,268,352,86,485,438,283,275,333.5,370,5,4,12,21
2005_03_OAK_PHI,PHI,LV,3,2005,365,83,345,21,448,366,453,345.5,195.5,380,27,16,1,23
2005_03_TB_GB,GB,TB,3,2005,195,75,139,161,270,300,352.5,343,382,240.5,19,14,24,3
2005_03_TEN_STL,LA,TEN,3,2005,292,101,261,87,393,348,387.5,304,378,329,24,9,22,11
2005_04_BUF_NO,NO,BUF,4,2005,172,167,103,141,339,244,351,242.66666666666666,339.6666666666667,332.3333333333333,19,2,14,12
2005_04_DAL_OAK,LV,DAL,4,2005,218,129,212,116,347,328,352.3333333333333,381.3333333333333,451.3333333333333,261.3333333333333,21,24,28,2
2005_04_DEN_JAX,JAX,DEN,4,2005,240,12,136,188,252,324,339.6666666666667,346.6666666666667,293.6666666666667,351.6666666666667,15,16,5,21
2005_04_DET_TB,TB,DET,4,2005,302,69,137,91,371,228,328.6666666666667,257,325,265,10,3,8,4
2005_04_GB_CAR,CAR,GB,4,2005,206,90,303,58,296,361,319,325,328,328.6666666666667,8,9,9,10
2005_04_HOU_CIN,CIN,HOU,4,2005,276,98,174,126,374,300,394.6666666666667,222.5,261.6666666666667,406.5,26,1,3,26
2005_04_IND_TEN,TEN,IND,4,2005,220,109,264,100,329,364,318.6666666666667,315.6666666666667,389.3333333333333,349,7,6,25,17
2005_04_MIN_ATL,ATL,MIN,4,2005,88,285,250,63,373,313,332.3333333333333,339.6666666666667,242.66666666666666,351,13,15,1,20
2005_04_NYJ_BAL,BAL,NYJ,4,2005,144,115,149,28,259,177,329,293.6666666666667,304,339.6666666666667,11,5,6,14
2005_04_PHI_KC,KC,PHI,4,2005,221,144,369,28,365,397,351.6666666666667,451.3333333333333,346.6666666666667,352.3333333333333,20,28,16,22
2005_04_SD_NE,NE,LAC,4,2005,239,73,248,183,312,431,379.6666666666667,350.3333333333333,369.3333333333333,329.3333333333333,23,18,23,11
2005_04_SEA_WAS,WAS,SEA,4,2005,226,141,242,119,367,361,367,411.3333333333333,343,349.3333333333333,22,27,15,18
2005_04_SF_ARI,ARI,SF,4,2005,385,97,160,51,482,211,349.3333333333333,261.3333333333333,411.3333333333333,381.3333333333333,17,4,27,24
2005_04_STL_NYG,NYG,LA,4,2005,296,164,442,42,460,484,329.3333333333333,389.3333333333333,350.3333333333333,318.6666666666667,12,25,19,7
2005_05_BAL_DET,DET,BAL,5,2005,97,169,230,159,266,389,247.33333333333334,305.6666666666667,342.77777777777783,254.7777777777778,2,7,16,5
2005_05_CAR_ARI,ARI,CAR,5,2005,394,72,243,87,466,330,382.5,313.25,248.75,334,24,8,3,14
2005_05_CHI_CLE,CLE,CHI,5,2005,218,76,117,176,294,293,349,261.6666666666667,315.6666666666667,394.6666666666667,18,5,8,28
2005_05_CIN_JAX,JAX,CIN,5,2005,161,181,239,132,342,371,317.75,389.5,341,241.875,9,25,15,1
2005_05_IND_SF,SF,IND,5,2005,74,133,255,120,207,375,248.75,327.75,382.5,321.25,4,11,25,11
2005_05_MIA_BUF,BUF,MIA,5,2005,169,99,226,113,268,339,243,328,348,319,1,12,17,10
2005_05_NE_ATL,ATL,NE,5,2005,298,116,350,141,414,491,342.5,362.75,333,370.5,16,19,13,23
2005_05_NO_GB,GB,NO,5,2005,215,94,177,95,309,272,334,348,313.25,243,13,17,7,2
2005_05_PHI_DAL,DAL,PHI,5,2005,289,167,145,19,456,164,368,437.75,351,355,21,28,18,19
2005_05_PIT_SD,LAC,PIT,5,2005,219,66,225,104,285,329,370.5,369.3333333333333,362.75,379.6666666666667,23,22,21,24
2005_05_SEA_STL,LA,SEA,5,2005,336,77,316,134,413,450,413,398.75,362,367,27,26,20,22
2005_05_TB_NYJ,NYJ,TB,5,2005,163,62,226,84,225,310,264.5,339.25,311.5,249.75,6,14,6,4
2005_05_TEN_HOU,HOU,TEN,5,2005,131,161,220,90,292,310,248.33333333333334,321.25,387.77777777777783,327.75,3,10,26,12
2005_05_WAS_DEN,DEN,WAS,5,2005,92,165,322,125,257,447,341,367,317.75,394.5555555555555,15,20,9,27
2005_06_ATL_NO,NO,ATL,6,2005,259,211,112,160,470,272,332.8,356.8,329,388.4,12,20,11,23
2005_06_CAR_DET,DET,CAR,6,2005,201,52,283,54,253,337,252,316.6,326.5,399.2,2,6,10,24
2005_06_CIN_TEN,TEN,CIN,6,2005,259,118,272,119,377,391,319,385.8,257.0666666666667,322.6,7,24,5,9
2005_06_CLE_BAL,BAL,CLE,6,2005,213,150,147,70,363,217,326.5,335.25,252,269.5,10,15,3,6
2005_06_HOU_SEA,SEA,HOU,6,2005,168,320,179,67,488,246,409,259.25,413,318.4375,27,4,27,7
2005_06_JAX_PIT,PIT,JAX,6,2005,154,73,177,93,227,270,359.25,322.6,349.125,385.8,21,8,16,22
2005_06_MIA_TB,TB,MIA,6,2005,189,180,267,64,369,331,333.4,330.75,256.6,249.25,14,11,4,2
2005_06_MIN_CHI,CHI,MIN,6,2005,117,95,237,80,212,317,269.5,333,335.25,342.5,5,13,14,15
2005_06_NE_DEN,DEN,NE,6,2005,262,178,299,89,440,388,324.2,388.4,383,356.8,9,26,21,17
2005_06_NYG_DAL,DAL,NYG,6,2005,312,92,215,91,404,306,385.6,362,383,413,23,22,21,27
2005_06_NYJ_BUF,BUF,NYJ,6,2005,172,177,161,149,349,310,248,256.6,330.2,333.4,1,3,12,13
2005_06_SD_OAK,LV,LAC,6,2005,292,39,168,190,331,358,351,353.4,368,361.26666666666665,17,18,19,18
2005_06_STL_IND,IND,LA,6,2005,191,176,255,105,367,360,337.2,413,240.4,409,16,28,1,25
2005_06_WAS_KC,KC,WAS,6,2005,181,96,331,101,277,432,355,387,437.75,320,19,25,28,8
2005_07_BAL_CHI,CHI,BAL,7,2005,145,143,164,66,288,230,258,333.8,329.8,311.6,4,13,10,5
2005_07_BUF_OAK,LV,BUF,7,2005,261,162,159,84,423,243,347,264.8333333333333,354.32,265.5,18,5,20,4
2005_07_DAL_SEA,SEA,DAL,7,2005,224,72,136,164,296,300,422.1666666666667,388.6666666666667,257.0416666666667,352.6666666666667,28,24,1,19
2005_07_DEN_NYG,NYG,DEN,7,2005,214,97,194,191,311,385,350.8,343.5,389.28000000000003,388.3333333333333,19,17,25,24
2005_07_DET_CLE,CLE,DET,7,2005,73,118,210,119,191,329,311.6,252.2,333.8,320.68,7,2,12,8
2005_07_GB_MIN,MIN,GB,7,2005,280,108,329,45,388,374,329.8,329,258,332.8,10,9,2,11
2005_07_IND_HOU,HOU,IND,7,2005,48,133,237,205,181,442,256.6,342.1666666666667,424.8,404.1666666666667,3,15,28,27
2005_07_KC_MIA,MIA,KC,7,2005,202,94,289,185,296,474,330.8,339.4,340.52,396,11,14,15,26
2005_07_NO_STL,LA,NO,7,2005,198,109,230,119,307,349,404.1666666666667,355.6666666666667,342.1666666666667,342.6666666666667,27,21,16,17
2005_07_NYJ_ATL,ATL,NYJ,7,2005,116,205,234,37,321,271,342.6666666666667,265.5,355.6666666666667,264.8333333333333,16,6,21,3
2005_07_PIT_CIN,CIN,PIT,7,2005,227,91,93,221,318,314,386.6666666666667,332.8,328.6666666666667,312.08000000000004,23,12,9,6
2005_07_SD_PHI,PHI,LAC,7,2005,287,24,299,21,311,320,383,354.1666666666667,385.6,347.6666666666667,22,20,22,18
2005_07_SF_WAS,WAS,SF,7,2005,260,204,92,140,464,232,396,240.4,339.4,337.2,25,1,14,13
2005_07_TEN_ARI,ARI,TEN,7,2005,140,55,269,90,195,359,399.2,328.6666666666667,316.6,386.6666666666667,26,8,7,23
2005_08_ARI_DAL,DAL,ARI,8,2005,220,146,161,71,366,232,376,365.1666666666667,404.14285714285717,333.72222222222223,24,22,27,11
2005_08_BAL_PIT,PIT,BAL,8,2005,177,101,252,72,278,324,329.6666666666667,316.5,375.22222222222223,263,11,8,25,4
2005_08_BUF_NE,NE,BUF,8,2005,199,93,263,147,292,410,388.3333333333333,261.7142857142857,343.5,357.85714285714283,26,3,15,20
2005_08_CHI_DET,DET,CHI,8,2005,197,93,230,115,290,345,265,263,291.5,316.5,5,4,6,7
2005_08_CLE_HOU,HOU,CLE,8,2005,138,117,185,156,255,341,244,291.5,358.8055555555556,265,2,6,21,5
2005_08_GB_CIN,CIN,GB,8,2005,237,95,279,76,332,355,376.85714285714283,336.5,330.11428571428576,339.5,25,13,9,14
2005_08_JAX_STL,LA,JAX,8,2005,200,200,213,221,400,434,390.2857142857143,313.8333333333333,354.7142857142857,337.2083333333333,27,7,19,13
2005_08_KC_SD,LAC,KC,8,2005,341,83,347,95,424,442,349.2857142857143,361.8333333333333,372.7142857142857,325,17,21,24,8
2005_08_MIA_NO,NO,MIA,8,2005,181,90,168,188,271,356,354.7142857142857,325,390.2857142857143,361.8333333333333,19,10,26,22
2005_08_MIN_CAR,CAR,MIN,8,2005,341,111,190,82,452,272,320,339.5,252.16666666666666,336.5,9,15,2,12
2005_08_OAK_TEN,TEN,LV,8,2005,229,140,238,92,369,330,333,359.6666666666667,370.0285714285714,261.1944444444444,12,20,23,3
2005_08_PHI_DEN,DEN,PHI,8,2005,309,255,283,79,564,362,349.42857142857144,371,345.11428571428576,348.47222222222223,18,23,16,17
2005_08_TB_SF,SF,TB,8,2005,50,158,264,43,208,307,239,339.3333333333333,407.3333333333333,330.7916666666667,1,14,28,10
2005_08_WAS_NYG,NYG,WAS,8,2005,146,262,127,38,408,165,344.1666666666667,407.3333333333333,350.4166666666667,239,16,28,18,1
2005_09_ATL_MIA,MIA,ATL,9,2005,103,105,228,162,208,390,329.42857142857144,339.57142857142856,342.7551020408163,266.2857142857143,9,16,18,4
2005_09_CAR_TB,TB,CAR,9,2005,259,44,216,77,303,293,334.7142857142857,338.85714285714283,234.57142857142858,329.85714285714283,12,14,1,12
2005_09_CHI_NO,NO,CHI,9,2005,170,133,137,183,303,320,344.25,274.7142857142857,328.875,268.57142857142856,17,5,11,5
2005_09_CIN_BAL,BAL,CIN,9,2005,153,124,248,98,277,346,317.57142857142856,371.25,322.2857142857143,338.8125,7,24,10,15
2005_09_DET_MIN,MIN,DET,9,2005,136,164,263,58,300,321,329.85714285714283,268.57142857142856,338.85714285714283,274.7142857142857,10,4,16,6
2005_09_HOU_JAX,JAX,HOU,9,2005,218,98,219,88,316,307,331,245.57142857142858,391.6734693877551,298.57142857142856,11,2,28,8
2005_09_IND_NE,NE,IND,9,2005,285,34,321,132,319,453,374.57142857142856,356.42857142857144,282.89795918367344,245.8,27,21,7,3
2005_09_NYG_SF,SF,NYG,9,2005,102,52,251,93,154,344,234.57142857142858,353.2857142857143,334.7142857142857,372.7142857142857,1,19,13,24
2005_09_OAK_KC,KC,LV,9,2005,235,114,175,101,349,276,373.2857142857143,355.42857142857144,359.9591836734694,338.14285714285717,26,20,21,14
2005_09_PHI_WAS,WAS,PHI,9,2005,224,78,304,45,302,349,372.7142857142857,369.7142857142857,353.2857142857143,380.0816326530612,25,23,19,27
2005_09_PIT_GB,GB,PIT,9,2005,214,65,65,154,279,219,339.14285714285717,322.2857142857143,370.4489795918367,317.57142857142856,15,8,22,9
2005_09_SD_NYJ,NYJ,LAC,9,2005,204,89,270,133,293,403,266.2857142857143,358.625,339.57142857142856,371.85416666666663,3,22,17,23
2005_09_SEA_ARI,ARI,SEA,9,2005,334,71,158,208,405,366,346.14285714285717,404.14285714285717,374.57142857142856,376,18,28,25,26
2005_09_TEN_CLE,CLE,TEN,9,2005,272,169,235,98,441,333,298.57142857142856,337.5,245.57142857142858,355.95833333333337,6,13,2,20
2005_10_ARI_DET,DET,ARI,10,2005,231,157,359,38,388,397,275.125,353.5,326.125,399.375,4,19,6,28
2005_10_BAL_JAX,JAX,BAL,10,2005,211,133,142,53,344,195,329.125,312.5,253.25,368.09375,12,8,2,23
2005_10_CLE_PIT,PIT,CLE,10,2005,223,159,253,61,382,314,309.375,316.375,331.625,336.9375,7,10,10,12
2005_10_DAL_PHI,PHI,DAL,10,2005,183,181,196,58,364,254,367.125,374.75,363.875,348.52083333333337,21,25,19,16
2005_10_DEN_OAK,LV,DEN,10,2005,310,60,205,121,370,326,345.5,376.25,370.25,369.875,16,26,26,25
2005_10_GB_ATL,ATL,GB,10,2005,209,133,256,107,342,363,345.875,331.625,314.25,309.375,17,14,5,4
2005_10_HOU_IND,IND,HOU,10,2005,297,126,138,83,423,221,368.5,253.25,367.625,329.125,23,2,22,8
2005_10_KC_BUF,BUF,KC,10,2005,162,61,220,150,223,370,280.25,370.25,376.29166666666663,345.5,5,24,27,14
2005_10_MIN_NYG,NYG,MIN,10,2005,291,124,144,12,415,156,352.125,326.125,224.5,275.125,18,11,1,3
2005_10_NE_MIA,MIA,NE,10,2005,360,77,275,91,437,366,314.25,367.625,345.875,368.5,9,22,15,24
2005_10_NYJ_CAR,CAR,NYJ,10,2005,119,101,98,137,220,235,333.125,269.625,330.75,364.171875,15,3,9,20
2005_10_SF_CHI,CHI,SF,10,2005,67,172,28,133,239,161,280.375,224.5,339.09375,352.125,6,1,13,17
2005_10_STL_SEA,SEA,LA,10,2005,243,174,304,75,417,379,399.375,391.5,353.5,328.85416666666663,28,27,18,7
2005_10_WAS_TB,TB,WAS,10,2005,279,61,226,185,340,411,330.75,363.875,333.125,367.125,13,20,11,21
2005_11_ARI_STL,LA,ARI,11,2005,385,6,285,94,391,379,390.1111111111111,358.3333333333333,401.3333333333333,287.6666666666667,31,20,32,8
2005_11_BUF_SD,LAC,BUF,11,2005,339,141,168,65,480,233,363.55555555555554,273.8888888888889,269.25396825396825,370.22222222222223,23,4,4,28
2005_11_CAR_CHI,CHI,CAR,11,2005,136,122,235,55,258,290,275.77777777777777,320.55555555555554,217.44444444444446,265.77777777777777,5,11,1,3
2005_11_DET_DAL,DAL,DET,11,2005,110,149,169,57,259,226,361.3333333333333,287.6666666666667,366.77777777777777,358.3333333333333,22,6,25,22
2005_11_IND_CIN,CIN,IND,11,2005,335,164,365,92,499,457,368.44444444444446,374.55555555555554,313.06349206349205,249.66666666666666,26,30,11,2
2005_11_JAX_TEN,TEN,JAX,11,2005,208,63,258,49,271,307,337,330.77777777777777,314.39682539682536,299.44444444444446,16,13,12,9
2005_11_KC_HOU,HOU,KC,11,2005,182,78,220,226,260,446,249.66666666666666,370.22222222222223,374.55555555555554,273.8888888888889,2,28,30,5
2005_11_MIA_CLE,CLE,MIA,11,2005,195,181,67,139,376,206,316.1111111111111,327.8888888888889,317.44444444444446,367.44444444444446,9,12,14,26
2005_11_MIN_GB,GB,MIN,11,2005,227,21,196,160,248,356,335.1111111111111,307.22222222222223,345.44444444444446,359.1111111111111,15,8,20,23
2005_11_NO_NE,NE,NO,11,2005,222,132,343,87,354,430,367.44444444444446,339.6666666666667,327.8888888888889,279.74603174603175,25,17,16,7
2005_11_NYJ_DEN,DEN,NYJ,11,2005,225,196,195,22,421,217,370.6666666666667,265.77777777777777,348.22222222222223,320.55555555555554,29,3,21,15
2005_11_OAK_WAS,WAS,LV,11,2005,155,108,289,50,263,339,369.1111111111111,348.22222222222223,331.77777777777777,370.6666666666667,27,19,18,29
2005_11_PHI_NYG,NYG,PHI,11,2005,218,115,298,106,333,404,359.1111111111111,366.77777777777777,307.22222222222223,361.3333333333333,21,24,10,24
2005_11_PIT_BAL,BAL,PIT,11,2005,163,104,246,70,267,316,299.44444444444446,317.44444444444446,330.77777777777777,316.1111111111111,7,10,17,13
2005_11_SEA_SF,SF,SEA,11,2005,249,110,233,145,359,378,217.44444444444446,401.3333333333333,275.77777777777777,390.1111111111111,1,32,6,31
2005_11_TB_ATL,ATL,TB,11,2005,306,150,118,140,456,258,345.44444444444446,331.77777777777777,335.1111111111111,369.1111111111111,18,14,19,27
2005_12_ATL_DET,DET,ATL,12,2005,258,75,146,256,333,402,281.5,356.5,351.1,324.4,6,21,19,13
2005_12_BAL_CIN,CIN,BAL,12,2005,302,135,211,133,437,344,381.5,296.2,382.8,317.3,29,7,30,10
2005_12_CAR_BUF,BUF,CAR,12,2005,197,53,191,113,250,304,269.8,317.5,375.2,274,4,11,26,5
2005_12_CHI_TB,TB,CHI,12,2005,202,107,134,118,309,252,324.4,274,356.5,317.5,13,5,21,11
2005_12_CLE_MIN,MIN,CLE,12,2005,207,81,214,78,288,292,312.1,322.1,326.4,315.7,8,12,14,9
2005_12_DEN_DAL,DAL,DEN,12,2005,232,85,162,144,317,306,351.1,375.7,281.5,260.9,19,27,6,3
2005_12_GB_PHI,PHI,GB,12,2005,91,180,171,128,271,299,370.5,326.4,356.5,312.1,25,14,21,8
2005_12_JAX_ARI,ARI,JAX,12,2005,315,67,133,162,382,295,360.4,328.4,390.2,330.4,23,15,31,16
2005_12_MIA_OAK,LV,MIA,12,2005,226,120,261,145,346,406,347.3,315.7,358.5,322.1,17,9,22,12
2005_12_NE_KC,KC,NE,12,2005,323,112,248,74,435,322,377.8,366.1,250.7,348.7,28,24,2,18
2005_12_NO_NYJ,NYJ,NO,12,2005,251,118,181,97,369,278,260.9,348.7,375.7,366.1,3,18,27,24
2005_12_NYG_SEA,SEA,NYG,12,2005,249,127,344,166,376,510,399,356.5,231.6,370.5,32,21,1,25
2005_12_PIT_IND,IND,PIT,12,2005,245,127,133,86,372,219,382.8,317.3,381.5,296.2,30,10,29,7
2005_12_SD_WAS,WAS,LAC,12,2005,194,91,215,202,285,417,358.5,375.2,347.3,269.8,22,26,17,4
2005_12_SF_TEN,TEN,SF,12,2005,343,118,192,74,461,266,330.4,231.6,328.4,399,16,1,15,32
2005_12_STL_HOU,HOU,LA,12,2005,293,124,324,138,417,462,250.7,390.2,377.8,360.4,2,31,28,23
2005_13_ARI_SF,SF,ARI,13,2005,185,51,354,65,236,419,234.72727272727272,362.3636363636364,342.27272727272725,325.3636363636364,1,24,17,15
2005_13_ATL_CAR,CAR,ATL,13,2005,164,142,171,120,306,291,316.27272727272725,360.6363636363636,268,286.1818181818182,10,21,3,6
2005_13_BUF_MIA,MIA,BUF,13,2005,387,73,227,92,460,319,323.90909090909093,268,347.1818181818182,316.27272727272725,14,3,18,10
2005_13_CIN_PIT,PIT,CIN,13,2005,386,95,227,102,481,329,308.3636363636364,386.54545454545456,381.8181818181818,300.54545454545456,8,30,28,7
2005_13_DAL_NYG,NYG,DAL,13,2005,152,127,146,81,279,227,370.45454545454544,348,396.90909090909093,369.3636363636364,26,19,32,25
2005_13_DEN_KC,KC,DEN,13,2005,253,168,276,131,421,407,383,369.3636363636364,362.09090909090907,348,29,25,23,19
2005_13_GB_CHI,CHI,GB,13,2005,68,141,277,100,209,377,272,323.90909090909093,323,361.45454545454544,5,14,12,22
2005_13_HOU_BAL,BAL,HOU,13,2005,198,73,165,165,271,330,300.54545454545456,265.8181818181818,386.54545454545456,396.72727272727275,7,2,30,31
2005_13_JAX_CLE,CLE,JAX,13,2005,226,98,116,135,324,251,319.3636363636364,325.3636363636364,309.90909090909093,362.3636363636364,11,15,9,24
2005_13_MIN_DET,DET,MIN,13,2005,126,105,256,103,231,359,286.1818181818182,309.90909090909093,360.6363636363636,319.3636363636364,6,9,21,11
2005_13_NYJ_NE,NE,NYJ,13,2005,271,146,135,41,417,176,362.09090909090907,270.72727272727275,383,342.27272727272725,23,4,29,17
2005_13_OAK_SD,LAC,LV,13,2005,160,126,236,81,286,317,379,347.1818181818182,351.8181818181818,323.90909090909093,27,18,20,14
2005_13_SEA_PHI,PHI,SEA,13,2005,145,61,98,96,206,194,361.45454545454544,396.90909090909093,323.90909090909093,370.45454545454544,22,32,14,26
2005_13_TB_NO,NO,TB,13,2005,215,65,123,133,280,256,342.27272727272725,323,270.72727272727275,272,17,12,4,5
2005_13_TEN_IND,IND,TEN,13,2005,187,105,250,40,292,290,381.8181818181818,342.27272727272725,308.3636363636364,234.72727272727272,28,17,8,1
2005_13_WAS_STL,LA,WAS,13,2005,163,49,156,257,212,413,396.72727272727275,351.8181818181818,265.8181818181818,379,31,20,2,27
2005_14_BAL_DEN,DEN,BAL,14,2005,236,96,251,72,332,323,372.5,298.0833333333333,386.1666666666667,271.1666666666667,27,7,32,4
2005_14_CHI_PIT,PIT,CHI,14,2005,173,190,207,83,363,290,322.75,266.75,381.75,328.33333333333337,13,3,31,14
2005_14_CLE_CIN,CIN,CLE,14,2005,93,185,138,84,278,222,381.75,319.75,322.75,319.1666666666667,31,12,13,11
2005_14_DET_GB,GB,DET,14,2005,170,181,112,129,351,241,328.33333333333337,281.5833333333333,266.75,314.00000000000006,14,6,3,8
2005_14_HOU_TEN,TEN,HOU,14,2005,208,93,116,152,301,268,337.9166666666667,271.1666666666667,374.3333333333333,298.0833333333333,18,4,28,7
2005_14_IND_JAX,JAX,IND,14,2005,250,74,324,99,324,423,319.1666666666667,374.3333333333333,319.75,337.9166666666667,11,28,12,18
2005_14_KC_DAL,DAL,KC,14,2005,332,129,340,161,461,501,337.9166666666667,386.1666666666667,362.8333333333333,372.5,18,32,23,27
2005_14_MIA_SD,LAC,MIA,14,2005,279,96,229,71,375,300,371.25,335.25000000000006,344.6666666666667,272.25,26,15,19,5
2005_14_NE_BUF,BUF,NE,14,2005,181,14,336,159,195,495,272.25,366.6666666666667,335.25000000000006,262.8333333333333,5,24,15,2
2005_14_NO_ATL,ATL,NO,14,2005,279,127,219,125,406,344,354.8333333333333,337.0833333333333,315.4166666666667,317.4166666666667,21,16,9,10
2005_14_NYG_PHI,PHI,NYG,14,2005,190,175,312,138,365,450,348.5,362.8333333333333,380,337.9166666666667,20,23,29,18
2005_14_OAK_NYJ,NYJ,LV,14,2005,119,184,124,95,303,219,262.8333333333333,344.6666666666667,366.6666666666667,371.25,2,19,24,26
2005_14_SF_SEA,SEA,SF,14,2005,259,185,77,62,444,139,380,234.83333333333334,348.5,367.0833333333333,29,1,20,25
2005_14_STL_MIN,MIN,LA,14,2005,146,113,235,108,259,343,314.00000000000006,381.3333333333333,281.5833333333333,356.9166666666667,8,30,6,22
2005_14_TB_CAR,CAR,TB,14,2005,220,82,138,114,302,252,315.4166666666667,317.4166666666667,354.8333333333333,337.0833333333333,9,10,21,16
2005_14_WAS_ARI,ARI,WAS,14,2005,255,62,122,109,317,231,367.0833333333333,356.9166666666667,234.83333333333334,381.3333333333333,25,22,1,30
2005_15_ARI_HOU,HOU,ARI,15,2005,150,119,301,39,269,340,270.9230769230769,363.2307692307692,335.0769230769231,347.2307692307692,5,23,17,19
2005_15_ATL_CHI,CHI,ATL,15,2005,105,128,122,114,233,236,268.53846153846155,358.7692307692308,325.84615384615387,337.61538461538464,4,22,13,18
2005_15_CAR_NO,NO,CAR,15,2005,193,94,176,161,287,337,337.61538461538464,314.38461538461536,358.7692307692308,312.38461538461536,18,11,22,10
2005_15_CIN_DET,DET,CIN,15,2005,215,59,280,155,274,435,278.46153846153845,373.7692307692308,330.0769230769231,312.2307692307692,6,27,14,9
2005_15_CLE_OAK,LV,CLE,15,2005,132,143,198,71,275,269,335,312.2307692307692,265.9230769230769,373.7692307692308,16,9,2,27
2005_15_DAL_WAS,WAS,DAL,15,2005,163,171,153,109,334,262,347.2307692307692,347.38461538461536,363.2307692307692,395,19,20,23,32
2005_15_DEN_BUF,BUF,DEN,15,2005,202,75,259,178,277,437,266.3076923076923,369.38461538461536,376.53846153846155,300,3,24,28,7
2005_15_GB_BAL,BAL,GB,15,2005,253,182,209,107,435,316,300,330.0769230769231,369.38461538461536,278.46153846153845,7,14,24,6
2005_15_KC_NYG,NYG,KC,15,2005,186,223,176,188,409,364,369.53846153846155,395,349.7692307692308,347.38461538461536,25,32,21,20
2005_15_NYJ_MIA,MIA,NYJ,15,2005,175,128,327,90,303,417,332.5384615384616,265.9230769230769,371.53846153846155,335,15,2,26,16
2005_15_PHI_STL,LA,PHI,15,2005,127,178,97,125,305,222,378.38461538461536,349.7692307692308,309.76923076923083,369.53846153846155,30,21,8,25
2005_15_PIT_MIN,MIN,PIT,15,2005,143,54,149,142,197,291,309.76923076923083,325.84615384615387,378.38461538461536,268.53846153846155,8,13,30,4
2005_15_SD_IND,IND,LAC,15,2005,336,24,255,206,360,461,378.0769230769231,371.53846153846155,319.53846153846155,332.5384615384616,29,26,12,15
2005_15_SEA_TEN,TEN,SEA,15,2005,336,81,285,183,417,468,335.0769230769231,384.9230769230769,270.9230769230769,227.46153846153845,17,31,5,1
2005_15_SF_JAX,JAX,SF,15,2005,216,134,123,110,350,233,319.53846153846155,227.46153846153845,378.0769230769231,384.9230769230769,12,1,29,31
2005_15_TB_NE,NE,TB,15,2005,258,83,155,30,341,185,376.53846153846155,312.38461538461536,266.3076923076923,314.38461538461536,28,10,3,11
2005_16_ATL_TB,TB,ATL,16,2005,285,174,161,154,459,315,303.2857142857143,350,374,266,8,22,26,2
2005_16_BUF_CIN,CIN,BUF,16,2005,283,104,308,67,387,375,378.14285714285717,267.07142857142856,278.14285714285717,374.2142857142857,30,3,6,27
2005_16_CHI_GB,GB,CHI,16,2005,317,65,166,135,382,301,329.07142857142856,266,309.64285714285717,350,14,2,10,22
2005_16_DAL_CAR,CAR,DAL,16,2005,260,71,209,214,331,423,316,341.2857142857143,334,346.2857142857143,11,20,17,21
2005_16_DET_NO,NO,DET,16,2005,233,47,210,71,280,281,334,278.14285714285717,316,378.14285714285717,17,6,11,30
2005_16_IND_SEA,SEA,IND,16,2005,168,173,353,43,341,396,390.85714285714283,376.7857142857143,340.92857142857144,377.92857142857144,31,28,19,29
2005_16_JAX_HOU,HOU,JAX,16,2005,295,107,292,172,402,464,270.7857142857143,321.7142857142857,361.57142857142856,227.85714285714286,4,12,23,1
2005_16_MIN_BAL,BAL,MIN,16,2005,289,88,248,42,377,290,309.64285714285717,301.7142857142858,329.07142857142856,323.35714285714283,10,7,14,13
2005_16_NE_NYJ,NYJ,NE,16,2005,163,40,187,151,203,338,276.7142857142857,374,330.4285714285715,303.2857142857143,5,26,15,8
2005_16_NYG_WAS,WAS,NYG,16,2005,233,156,244,99,389,343,346.2857142857143,372.35714285714283,341.2857142857143,392.7857142857143,21,24,20,32
2005_16_OAK_DEN,DEN,LV,16,2005,268,155,178,87,423,265,374.2142857142857,330.7142857142857,267.07142857142856,309.14285714285717,27,16,3,9
2005_16_PHI_ARI,ARI,PHI,16,2005,294,75,170,43,369,213,361.57142857142856,340.64285714285717,270.7857142857143,373.14285714285717,23,18,4,25
2005_16_PIT_CLE,CLE,PIT,16,2005,183,55,257,209,238,466,309.14285714285717,323.35714285714283,330.7142857142857,301.7142857142858,9,13,16,7
2005_16_SD_KC,KC,LAC,16,2005,207,144,161,80,351,241,392.7857142857143,377.92857142857144,372.35714285714283,376.7857142857143,32,29,24,28
2005_16_SF_STL,LA,SF,16,2005,354,44,131,217,398,348,373.14285714285717,227.85714285714286,340.64285714285717,321.7142857142857,25,1,18,12
2005_16_TEN_MIA,MIA,TEN,16,2005,151,192,166,92,343,258,330.4285714285715,340.92857142857144,276.7142857142857,390.85714285714283,15,19,5,31
2005_17_ARI_IND,IND,ARI,17,2005,212,11,297,129,223,426,378.06666666666666,362.06666666666666,387.53333333333336,332.1333333333333,29,23,31,16
2005_17_BAL_CLE,CLE,BAL,17,2005,199,54,151,129,253,280,304.4,314.1333333333333,332.8666666666667,300.9333333333334,8,10,18,7
2005_17_BUF_NYJ,NYJ,BUF,17,2005,153,81,184,159,234,343,271.8,274.26666666666665,371.6,378.73333333333335,3,4,26,30
2005_17_CAR_ATL,ATL,CAR,17,2005,225,26,180,229,251,409,347.6666666666667,317,313.6666666666667,346.73333333333335,21,11,9,20
2005_17_CHI_MIN,MIN,CHI,17,2005,247,149,121,154,396,275,300.9333333333334,268.3333333333333,314.1333333333333,332.6,7,2,10,17
2005_17_CIN_KC,KC,CIN,17,2005,344,202,130,37,546,167,390,378.73333333333335,368.8,274.26666666666665,32,30,24,4
2005_17_DEN_SD,LAC,DEN,17,2005,183,91,98,157,274,255,368.8,377.46666666666664,390,326.3333333333333,24,28,32,12
2005_17_DET_PIT,PIT,DET,17,2005,135,199,212,105,334,317,332.8666666666667,278.3333333333333,304.4,330.4,18,5,8,13
2005_17_HOU_SF,SF,HOU,17,2005,159,182,196,88,341,284,235.86666666666667,279.53333333333336,374.8,331.2,1,6,27,14
2005_17_MIA_NE,NE,MIA,17,2005,205,55,239,148,260,387,371.6,331.2666666666667,271.8,335.4,26,15,3,19
2005_17_NO_TB,TB,NO,17,2005,143,149,265,71,292,336,313.6666666666667,330.4,347.6666666666667,278.3333333333333,9,13,21,5
2005_17_NYG_OAK,LV,NYG,17,2005,331,25,204,211,356,415,326.3333333333333,370.4,377.46666666666664,349.1333333333333,12,25,28,22
2005_17_SEA_GB,GB,SEA,17,2005,259,68,174,98,327,272,332.6,387.53333333333336,268.3333333333333,378.06666666666666,17,31,2,29
2005_17_STL_DAL,DAL,LA,17,2005,242,57,158,106,299,264,346.73333333333335,374.8,317,235.86666666666667,20,27,11,1
2005_17_TEN_JAX,JAX,TEN,17,2005,234,122,179,99,356,278,331.2,335.4,279.53333333333336,331.2666666666667,14,19,6,15
2005_17_WAS_PHI,PHI,WAS,17,2005,261,96,141,151,357,292,332.1333333333333,349.1333333333333,362.06666666666666,370.4,16,22,23,25
2005_18_CAR_NYG,NYG,CAR,18,2005,113,41,140,223,154,363,373.1875,322.75,328.1875,341.625,8,2,2,7
2005_18_JAX_NE,NE,JAX,18,2005,201,118,247,87,319,334,364.625,332.75,334.75000000000006,331.8125,6,3,6,4
2005_18_PIT_CIN,CIN,PIT,18,2005,263,84,208,144,347,352,365.5,332.9375,399.75,280.75,7,4,8,1
2005_18_WAS_TB,TB,WAS,18,2005,198,75,41,95,273,136,312.3125,345.5625,330.75,333.6875,1,5,3,5
2005_19_CAR_CHI,CHI,CAR,19,2005,192,97,319,123,289,442,268.75,325.11764705882354,306.87500000000006,360.29411764705884,1,2,1,5
2005_19_NE_DEN,DEN,NE,19,2005,197,96,341,79,293,420,369.8125,361.94117647058823,362.875,332.8235294117647,7,5,6,4
2005_19_PIT_IND,IND,PIT,19,2005,290,58,197,112,348,309,368.375,334.05882352941177,366.0625,364.4117647058824,6,4,8,7
2005_19_WAS_SEA,SEA,WAS,19,2005,215,119,242,59,334,301,380.3125,333.2352941176471,332.25,310,8,3,3,2
2005_20_CAR_SEA,SEA,CAR,20,2005,219,190,196,36,409,232,377.5882352941176,331.6111111111111,331.33910034602076,269.875,4,1,2,1
2005_20_PIT_DEN,DEN,PIT,20,2005,223,97,275,90,320,365,365.29411764705884,332.6666666666667,365.35640138408303,367.24305555555554,3,2,3,4
2005_21_SEA_PIT,PIT,SEA,21,2005,166,181,273,137,347,410,334.36842105263156,379.3333333333333,362.91021671826627,326.07716049382714,1,2,2,1
2006_01_ATL_CAR,CAR,ATL,1,2006,186,65,140,252,251,392,0,0,0,0,32,32,32,32
2006_01_BAL_TB,TB,BAL,1,2006,137,26,181,103,163,284,0,0,0,0,32,32,32,32
2006_01_BUF_NE,NE,BUF,1,2006,163,183,164,99,346,263,0,0,0,0,32,32,32,32
2006_01_CHI_GB,GB,CHI,1,2006,186,103,258,109,289,367,0,0,0,0,32,32,32,32
2006_01_CIN_KC,KC,CIN,1,2006,230,113,127,116,343,243,0,0,0,0,32,32,32,32
2006_01_DAL_JAX,JAX,DAL,1,2006,237,78,246,88,315,334,0,0,0,0,32,32,32,32
2006_01_DEN_STL,LA,DEN,1,2006,217,125,138,161,342,299,0,0,0,0,32,32,32,32
2006_01_IND_NYG,NYG,IND,1,2006,247,186,276,55,433,331,0,0,0,0,32,32,32,32
2006_01_MIA_PIT,PIT,MIA,1,2006,209,143,262,38,352,300,0,0,0,0,32,32,32,32
2006_01_MIN_WAS,WAS,MIN,1,2006,163,103,223,86,266,309,0,0,0,0,32,32,32,32
2006_01_NO_CLE,CLE,NO,1,2006,132,85,176,150,217,326,0,0,0,0,32,32,32,32
2006_01_NYJ_TEN,TEN,NYJ,1,2006,250,86,319,91,336,410,0,0,0,0,32,32,32,32
2006_01_PHI_HOU,HOU,PHI,1,2006,208,70,314,130,278,444,0,0,0,0,32,32,32,32
2006_01_SD_OAK,LV,LAC,1,2006,96,87,108,194,183,302,0,0,0,0,32,32,32,32
2006_01_SEA_DET,DET,SEA,1,2006,229,38,210,91,267,301,0,0,0,0,32,32,32,32
2006_01_SF_ARI,ARI,SF,1,2006,301,84,288,107,385,395,0,0,0,0,32,32,32,32
2006_02_ARI_SEA,SEA,ARI,2,2006,221,146,231,65,367,296,301,385,267,395,14,27,8,29
2006_02_BUF_MIA,MIA,BUF,2,2006,250,92,83,105,342,188,300,263,352,346,13,6,25,24
2006_02_CAR_MIN,MIN,CAR,2,2006,259,140,181,107,399,288,309,251,266,392,16,5,7,28
2006_02_CLE_CIN,CIN,CLE,2,2006,352,160,244,57,512,301,243,217,343,326,4,3,23,18
2006_02_DET_CHI,CHI,DET,2,2006,294,89,230,46,383,276,367,267,289,301,26,8,11,14
2006_02_HOU_IND,IND,HOU,2,2006,400,125,219,108,525,327,331,278,433,444,19,9,31,32
2006_02_KC_DEN,DEN,KC,2,2006,173,145,133,145,318,278,299,343,342,243,12,23,22,4
2006_02_NE_NYJ,NYJ,NE,2,2006,306,51,220,147,357,367,410,346,336,263,30,24,21,6
2006_02_NO_GB,GB,NO,2,2006,340,63,353,48,403,401,289,326,367,217,11,18,26,3
2006_02_NYG_PHI,PHI,NYG,2,2006,350,107,371,86,457,457,444,433,278,331,32,31,9,19
2006_02_OAK_BAL,BAL,LV,2,2006,143,138,162,39,281,201,284,183,163,302,10,2,1,15
2006_02_PIT_JAX,JAX,PIT,2,2006,260,110,141,26,370,167,315,352,334,300,17,25,20,13
2006_02_STL_SF,SF,LA,2,2006,233,127,185,118,360,303,395,342,385,299,29,22,27,12
2006_02_TB_ATL,ATL,TB,2,2006,92,306,313,40,398,353,392,163,251,284,28,1,5,10
2006_02_TEN_SD,LAC,TEN,2,2006,235,241,163,55,476,218,302,336,183,410,15,21,2,30
2006_02_WAS_DAL,DAL,WAS,2,2006,237,138,197,93,375,290,334,266,315,309,20,7,17,16
2006_03_ATL_NO,NO,ATL,3,2006,191,146,137,117,337,254,363.5,395,346,258,20,25,15,3
2006_03_BAL_CLE,CLE,BAL,3,2006,298,38,264,86,336,350,259,282.5,377.5,192,3,9,22,1
2006_03_CAR_TB,TB,CAR,3,2006,155,64,272,101,219,373,258,269.5,395,354,2,5,25,16
2006_03_CHI_MIN,MIN,CHI,3,2006,194,97,278,51,291,329,354,375,269.5,271.5,18,21,6,7
2006_03_CIN_PIT,PIT,CIN,3,2006,208,170,193,87,378,280,259.5,377.5,342.5,259,4,23,14,4
2006_03_DEN_NE,NE,DEN,3,2006,320,50,256,144,370,400,356.5,308.5,383.5,310.5,19,11,23,9
2006_03_GB_DET,DET,GB,3,2006,342,100,340,60,442,400,271.5,346,375,363.5,6,17,20,19
2006_03_JAX_IND,IND,JAX,3,2006,219,63,107,191,282,298,428,342.5,302.5,259.5,26,16,8,5
2006_03_NYG_SEA,SEA,NYG,3,2006,227,106,275,73,333,348,334,445,340.5,450.5,14,27,13,28
2006_03_NYJ_BUF,BUF,NYJ,3,2006,328,169,183,74,497,257,225.5,383.5,321,356.5,1,24,10,18
2006_03_PHI_SF,SF,PHI,3,2006,293,123,296,150,416,446,377.5,450.5,322.5,445,23,28,11,27
2006_03_STL_ARI,ARI,LA,3,2006,256,101,309,63,357,372,340.5,322.5,334,377.5,15,13,12,22
2006_03_TEN_MIA,MIA,TEN,3,2006,168,159,269,62,327,331,321,277,225.5,389,12,7,2,24
2006_03_WAS_HOU,HOU,WAS,3,2006,208,61,261,234,269,495,302.5,278,428,354.5,10,8,26,17
2006_04_ARI_ATL,ATL,ARI,4,2006,153,262,177,31,415,208,348,346,354.6666666666667,339,18,17,22,17
2006_04_CLE_OAK,LV,CLE,4,2006,68,194,192,104,262,296,192,284.6666666666667,282.5,305,1,2,4,9
2006_04_DAL_TEN,TEN,DAL,4,2006,155,78,179,217,233,396,295,354.5,323,278,4,20,12,3
2006_04_DET_STL,LA,DET,4,2006,328,106,280,93,434,373,339,328.3333333333333,346,364,14,11,19,24
2006_04_GB_PHI,PHI,GB,4,2006,299,131,219,99,430,318,449,364,390.3333333333333,328.3333333333333,28,24,26,14
2006_04_IND_NYJ,NYJ,IND,4,2006,207,135,217,160,342,377,341.3333333333333,379.3333333333333,316,327.6666666666667,15,25,11,13
2006_04_JAX_WAS,WAS,JAX,4,2006,329,152,289,33,481,322,350.3333333333333,327.6666666666667,291.3333333333333,379.3333333333333,19,10,6,25
2006_04_MIA_HOU,HOU,MIA,4,2006,230,65,249,70,295,319,291.3333333333333,323,350.3333333333333,295,3,9,21,7
2006_04_MIN_BUF,BUF,MIN,4,2006,222,95,267,63,317,330,316,333,341.3333333333333,359.6666666666667,8,12,18,23
2006_04_NE_CIN,CIN,NE,4,2006,245,71,188,236,316,424,345,361,299,339,16,23,8,17
2006_04_NO_CAR,CAR,NO,4,2006,169,167,349,63,336,412,304,354.6666666666667,245,348,5,21,1,20
2006_04_SD_BAL,BAL,LAC,4,2006,158,56,145,150,214,295,305,389,284.6666666666667,277,6,26,5,2
2006_04_SEA_CHI,CHI,SEA,4,2006,232,143,202,77,375,279,359.6666666666667,333.6666666666667,333,412.6666666666667,22,13,15,27
2006_04_SF_KC,KC,SF,4,2006,208,125,92,93,333,185,310.5,390.3333333333333,308.5,449,7,27,10,28
2006_05_BAL_DEN,DEN,BAL,5,2006,106,116,165,103,222,268,339,282.25,361,365.5,15,4,20,24
2006_05_BUF_CHI,CHI,BUF,5,2006,211,155,115,58,366,173,363.5,316.25,320,332.25,21,9,10,13
2006_05_CLE_CAR,CAR,CLE,5,2006,170,119,173,91,289,264,312,287.5,369,209.5,8,5,25,1
2006_05_DAL_PHI,PHI,DAL,5,2006,354,52,223,146,406,369,444.25,368.3333333333333,352.5,274.3333333333333,28,22,19,2
2006_05_DET_MIN,MIN,DET,5,2006,201,135,225,16,336,241,332.25,339.5,316.25,362.75,13,16,9,21
2006_05_KC_ARI,ARI,KC,5,2006,253,76,288,39,329,327,311.5,318,364.75,321.88888888888886,7,10,22,11
2006_05_MIA_NE,NE,MIA,5,2006,140,79,232,62,219,294,376.75,322,337.75,292.25,24,11,15,5
2006_05_NYJ_JAX,JAX,NYJ,5,2006,140,181,71,132,321,203,326.25,341.5,383,378.75,12,17,27,26
2006_05_OAK_SF,SF,LV,5,2006,165,165,216,154,330,370,339,215.33333333333334,316.125,288.44444444444446,15,1,8,4
2006_05_PIT_SD,LAC,PIT,5,2006,242,119,220,68,361,288,357.6666666666667,299,274.6666666666667,345,19,6,3,18
2006_05_STL_GB,GB,LA,5,2006,220,121,220,118,341,338,352.5,362.75,444.25,339.5,18,20,28,16
2006_05_TB_NO,NO,TB,5,2006,171,143,225,187,314,412,369,245,312,304,23,2,7,6
2006_05_TEN_IND,IND,TEN,5,2006,166,154,63,214,320,277,378.75,279.5,341.5,364.875,25,3,17,23
2006_05_WAS_NYG,NYG,WAS,5,2006,256,155,109,78,411,187,412.6666666666667,383,333.6666666666667,326.25,27,26,14,12
2006_06_BUF_DET,DET,BUF,6,2006,278,135,207,85,413,292,319.8,287.6,333,364,13,5,13,21
2006_06_CAR_BAL,BAL,CAR,6,2006,230,80,365,58,310,423,279.4,307.4,315.6,282.8,3,8,8,4
2006_06_CHI_ARI,ARI,CHI,6,2006,232,66,148,34,298,182,315,364,319.8,287.6,11,22,10,5
2006_06_CIN_TB,TB,CIN,6,2006,184,126,261,53,310,314,286.75,337.75,355.25,376.75,4,17,18,24
2006_06_HOU_DAL,DAL,HOU,6,2006,203,170,198,34,373,232,368.5,292.25,434.6875,322,24,6,26,11
2006_06_KC_PIT,PIT,KC,6,2006,244,219,185,38,463,223,296.25,320.25,358.5,315.875,7,15,19,9
2006_06_MIA_NYJ,NYJ,MIA,6,2006,175,103,266,129,278,395,313.8,316.4,325.2,345.2,10,12,12,16
2006_06_NYG_ATL,ATL,NYG,6,2006,154,223,180,259,377,439,364.75,412.25,311.5,334,23,25,7,14
2006_06_OAK_DEN,DEN,LV,6,2006,102,144,189,85,246,274,309.75,254,278.6875,336.75,9,1,3,15
2006_06_PHI_NO,NO,PHI,6,2006,275,97,247,99,372,346,358,436.6,278.4,368.46666666666664,20,26,2,23
2006_06_SD_SF,SF,LAC,6,2006,214,92,334,87,306,421,337.2,358.5,246.2666666666667,296.25,16,21,1,6
2006_06_SEA_STL,LA,SEA,6,2006,360,59,268,125,419,393,357.8,320,350.2,363.5,19,14,17,20
2006_06_TEN_WAS,WAS,TEN,6,2006,180,125,161,194,305,355,343.8,279,412.33333333333337,367,18,2,25,22
2006_07_ARI_OAK,LV,ARI,7,2006,279,137,203,50,416,253,258,312.1666666666667,297,333.6666666666667,1,9,8,19
2006_07_CAR_CIN,CIN,CAR,7,2006,240,112,238,60,352,298,333,326.6666666666667,291.4,284.5,15,11,6,4
2006_07_DEN_CLE,CLE,DEN,7,2006,149,34,209,150,183,359,282.8,297,307.4,258,3,6,10,1
2006_07_DET_NYJ,NYJ,DET,7,2006,189,221,269,125,410,394,307.8333333333333,335.3333333333333,329.5,288.3333333333333,8,17,15,5
2006_07_GB_MIA,MIA,GB,7,2006,414,67,206,155,481,361,329.5,350.2,307.8333333333333,357.8,12,20,11,21
2006_07_JAX_HOU,HOU,JAX,7,2006,224,131,125,102,355,227,280.2,325.2,369.4,313.8,2,10,24,12
2006_07_MIN_SEA,SEA,MIN,7,2006,261,53,186,175,314,361,334.6,333,370.04,319.8,16,15,25,14
2006_07_NE_BUF,BUF,NE,7,2006,193,75,195,94,268,289,288.3333333333333,345.2,335.3333333333333,316.4,4,19,20,13
2006_07_NYG_DAL,DAL,NYG,7,2006,338,69,189,155,407,344,369.4,417.6,280.2,367.2,23,25,3,23
2006_07_PHI_TB,TB,PHI,7,2006,104,111,302,208,215,510,291.4,421.5,333,360.3333333333333,5,26,18,22
2006_07_PIT_ATL,ATL,PIT,7,2006,232,173,433,55,405,488,367.2,329.6,417.6,300.8,22,13,26,9
2006_07_SD_KC,KC,LAC,7,2006,232,134,267,97,366,364,300.8,371,329.6,330.96,7,24,16,17
2006_07_WAS_IND,IND,WAS,7,2006,342,110,226,114,452,340,367,337.3333333333333,279,291.6666666666667,21,18,2,7
2006_08_ARI_GB,GB,ARI,8,2006,180,203,157,86,383,243,352,303.7142857142857,354.75,280.57142857142856,19,7,20,3
2006_08_ATL_CIN,CIN,ATL,8,2006,266,73,291,143,339,434,336.1666666666667,373.5,321.8888888888889,356,17,24,11,21
2006_08_BAL_NO,NO,BAL,8,2006,383,35,159,137,418,296,360.3333333333333,284.5,421.5,326.6666666666667,21,4,27,12
2006_08_DAL_CAR,CAR,DAL,8,2006,149,76,270,156,225,426,322.57142857142856,375.6666666666667,335.7142857142857,405.3333333333333,12,25,15,26
2006_08_HOU_TEN,TEN,HOU,8,2006,87,111,299,148,198,447,291.6666666666667,292.6666666666667,337.3333333333333,308.8333333333333,5,6,16,8
2006_08_IND_DEN,DEN,IND,8,2006,174,227,345,92,401,437,307.3333333333333,381.1666666666667,266.1666666666667,337.77777777777777,8,26,1,18
2006_08_JAX_PHI,PHI,JAX,8,2006,161,85,87,209,246,296,434.14285714285717,308.8333333333333,280.48571428571427,292.6666666666667,28,9,2,5
2006_08_NE_MIN,MIN,NE,8,2006,261,45,372,85,306,457,337.6666666666667,335.8333333333333,331.1666666666667,284.9444444444444,18,16,13,4
2006_08_NYJ_CLE,CLE,NYJ,8,2006,141,147,108,88,288,196,266.1666666666667,322.42857142857144,307.3333333333333,343.7142857142857,1,11,7,19
2006_08_PIT_OAK,LV,PIT,8,2006,51,81,301,89,132,390,284.3333333333333,356,302.3055555555556,373.5,3,20,6,24
2006_08_SEA_KC,KC,SEA,8,2006,312,191,198,47,503,245,311.6666666666667,331.1666666666667,369.8333333333333,337.6666666666667,10,13,23,17
2006_08_SF_CHI,CHI,SF,8,2006,263,145,146,130,408,276,333.6666666666667,332,312.1666666666667,368.9166666666667,15,14,10,22
2006_08_STL_SD,LAC,LA,8,2006,206,216,327,101,422,428,369.8333333333333,368,311.6666666666667,332.1666666666667,23,22,9,14
2006_08_TB_NYG,NYG,TB,8,2006,154,108,139,40,262,179,405.3333333333333,278.6666666666667,375.6666666666667,436.25,27,2,25,28
2006_09_ATL_DET,DET,ATL,9,2006,321,127,163,165,448,328,343.7142857142857,382.14285714285717,322.42857142857144,336.57142857142856,16,25,11,14
2006_09_CIN_BAL,BAL,CIN,9,2006,245,129,195,92,374,287,286.14285714285717,336.57142857142856,368.57142857142856,382.14285714285717,6,13,21,25
2006_09_CLE_SD,LAC,CLE,9,2006,211,190,236,89,401,325,377.2857142857143,269.2857142857143,376.57142857142856,304.3673469387755,24,3,22,6
2006_09_DAL_WAS,WAS,DAL,9,2006,192,117,284,111,309,395,337.7142857142857,382.85714285714283,379.14285714285717,308.6326530612245,14,26,24,7
2006_09_DEN_PIT,PIT,DEN,9,2006,433,96,227,115,529,342,360.85714285714283,320.7142857142857,262.57142857142856,389.14285714285717,21,10,1,27
2006_09_GB_BUF,BUF,GB,9,2006,102,120,287,147,222,434,285.42857142857144,356.42857142857144,337.1714285714285,295.0408163265306,5,20,15,5
2006_09_HOU_NYG,NYG,HOU,9,2006,179,122,176,81,301,257,384.85714285714283,314.7142857142857,264.42857142857144,278.2857142857143,27,8,2,3
2006_09_IND_NE,NE,IND,9,2006,201,148,326,53,349,379,353.14285714285717,389.14285714285717,333.14285714285717,320.7142857142857,19,28,13,10
2006_09_KC_STL,LA,KC,9,2006,354,115,148,186,469,334,376.57142857142856,339,377.2857142857143,318.85714285714283,23,15,23,9
2006_09_MIA_CHI,CHI,MIA,9,2006,210,103,137,161,313,298,344.2857142857143,351.14285714285717,324,351.74285714285713,17,18,12,18
2006_09_MIN_SF,SF,MIN,9,2006,105,42,136,135,147,271,324,333.14285714285717,344.2857142857143,353.14285714285717,11,12,17,19
2006_09_NO_TB,TB,NO,9,2006,185,68,314,49,253,363,264.42857142857144,368.57142857142856,384.85714285714283,286.14285714285717,2,22,26,4
2006_09_OAK_SEA,SEA,LV,9,2006,176,207,166,64,383,230,318.85714285714283,262.57142857142856,339,360.85714285714283,9,1,16,20
2006_09_TEN_JAX,JAX,TEN,9,2006,177,173,163,108,350,271,307,278.2857142857143,407.26530612244903,314.7142857142857,7,4,28,8
2006_10_BAL_TEN,TEN,BAL,10,2006,211,162,373,50,373,423,277.375,297.125,312.375,330.375,4,7,11,15
2006_10_BUF_IND,IND,BUF,10,2006,236,148,83,111,384,194,387.875,277.5,352.625,366.125,30,5,20,23
2006_10_CHI_NYG,NYG,CHI,10,2006,121,150,246,118,271,364,374.375,340.375,307.5,344.5,25,19,10,19
2006_10_CLE_ATL,ATL,CLE,10,2006,197,149,165,91,346,256,375.375,276.25,356.75,380.25,26,3,22,27
2006_10_DAL_ARI,ARI,DAL,10,2006,216,86,308,126,302,434,296.125,384.375,355.875,334.125,6,29,21,16
2006_10_DEN_OAK,LV,DEN,10,2006,214,46,210,63,260,273,258.5,323.375,326.875,381.875,1,13,14,28
2006_10_GB_MIN,MIN,GB,10,2006,257,90,347,47,347,394,325.375,366.125,301.875,277.5,14,23,8,6
2006_10_HOU_JAX,JAX,HOU,10,2006,214,118,176,148,332,324,312.375,307.5,277.375,374.375,12,10,5,25
2006_10_KC_MIA,MIA,KC,10,2006,201,117,201,80,318,281,344.5,338.375,340.375,388.125,20,18,18,32
2006_10_NO_PIT,PIT,NO,10,2006,264,217,398,120,481,518,381.875,367.875,323.375,263,28,24,12,2
2006_10_NYJ_NE,NE,NYJ,10,2006,255,143,168,117,398,285,352.625,306.625,387.875,268.89583333333337,21,9,31,3
2006_10_SD_CIN,CIN,LAC,10,2006,440,124,337,107,564,444,330.375,380.25,297.125,276.25,16,27,7,4
2006_10_SF_DET,DET,SF,10,2006,202,71,136,198,273,334,356.75,301.875,375.375,325.375,22,8,26,13
2006_10_STL_SEA,SEA,LA,10,2006,161,160,215,108,321,323,326.875,388.125,258.5,338.375,15,31,1,17
2006_10_TB_CAR,CAR,TB,10,2006,240,78,173,69,318,242,310.375,263,381.95833333333337,367.875,11,2,29,24
2006_10_WAS_PHI,PHI,WAS,10,2006,222,145,132,146,367,278,410.625,334.125,307.22916666666663,384.375,32,17,9,30
2006_11_ATL_BAL,BAL,ATL,11,2006,236,103,127,104,339,231,311.1111111111111,372.1111111111111,288,274,10,25,5,4
2006_11_BUF_HOU,HOU,BUF,11,2006,223,188,340,70,411,410,309.3333333333333,268.22222222222223,314.55555555555554,387.44444444444446,9,3,12,29
2006_11_CHI_NYJ,NYJ,CHI,11,2006,162,108,119,173,270,292,304.22222222222223,343,357.6666666666667,362.8888888888889,7,19,22,23
2006_11_CIN_NO,NO,CIN,11,2006,510,91,275,119,601,394,384.55555555555554,356.3333333333333,392.8888888888889,387.3333333333333,27,21,31,28
2006_11_DET_ARI,ARI,DET,11,2006,233,105,248,68,338,316,296.77777777777777,347.44444444444446,389.8888888888889,305.44444444444446,6,20,30,8
2006_11_IND_DAL,DAL,IND,11,2006,226,117,254,88,343,342,389.8888888888889,387.44444444444446,296.77777777777777,268.22222222222223,30,29,6,3
2006_11_MIN_MIA,MIA,MIN,11,2006,254,-3,262,114,251,376,341.55555555555554,327.77777777777777,332,369.22222222222223,18,15,17,24
2006_11_NE_GB,GB,NE,11,2006,105,43,244,122,148,366,369.22222222222223,357.6666666666667,327.77777777777777,304.22222222222223,24,22,15,7
2006_11_NYG_JAX,JAX,NYG,11,2006,249,165,230,25,414,255,314.55555555555554,362.8888888888889,309.3333333333333,343,12,23,9,19
2006_11_OAK_KC,KC,LV,11,2006,102,200,194,133,302,327,332,258.6666666666667,341.55555555555554,317.77777777777777,17,1,18,13
2006_11_PIT_CLE,CLE,PIT,11,2006,224,99,272,77,323,349,274,392.8888888888889,372.1111111111111,384.55555555555554,4,31,25,27
2006_11_SD_DEN,DEN,LAC,11,2006,183,158,222,125,341,347,317.77777777777777,387.3333333333333,258.6666666666667,356.3333333333333,13,28,1,21
2006_11_SEA_SF,SF,SEA,11,2006,163,262,252,70,425,322,305.44444444444446,326.22222222222223,347.44444444444446,380.8888888888889,8,14,20,26
2006_11_STL_CAR,CAR,LA,11,2006,191,242,142,31,433,173,311.22222222222223,380.8888888888889,260.6666666666667,326.22222222222223,11,26,2,14
2006_11_TEN_PHI,PHI,TEN,11,2006,267,123,101,209,390,310,405.77777777777777,288,327.8888888888889,311.1111111111111,32,5,16,10
2006_11_WAS_TB,TB,WAS,11,2006,178,181,196,64,359,260,260.6666666666667,327.8888888888889,311.22222222222223,405.77777777777777,2,16,11,32
2006_12_ARI_MIN,MIN,ARI,12,2006,271,157,405,17,428,422,332.6,300.9,332.5,344.3,18,7,17,20
2006_12_CAR_WAS,WAS,CAR,12,2006,118,143,168,101,261,269,321.1,323.4,270.5,360.1,12,13,2,26
2006_12_CHI_NE,NE,CHI,12,2006,269,85,176,153,354,329,358.5,337.9,347.1,300.8,24,19,21,6
2006_12_CIN_CLE,CLE,CIN,12,2006,186,51,300,99,237,399,278.9,360.1,388.5,406.2,3,26,30,32
2006_12_DEN_KC,KC,DEN,12,2006,161,223,216,38,384,254,329,320.1,265.5,383.3,16,11,1,28
2006_12_GB_SEA,SEA,GB,12,2006,157,235,266,51,392,317,325.8,347.1,317.4,358.5,15,21,9,24
2006_12_HOU_NYJ,NYJ,HOU,12,2006,286,27,321,25,313,346,300.8,319.5,337.9,282.4,6,10,19,4
2006_12_JAX_BUF,BUF,JAX,12,2006,169,72,132,207,241,339,282.4,324.5,319.5,352.1,4,14,10,22
2006_12_MIA_DET,DET,MIA,12,2006,252,21,213,186,273,399,344.3,332.5,300.9,332.6,20,17,7,18
2006_12_NO_ATL,ATL,NO,12,2006,84,281,349,95,365,444,358,406.2,313.9,360.1,23,32,8,26
2006_12_NYG_TEN,TEN,NYG,12,2006,249,108,143,144,357,287,290.2,352.1,404.2,324.5,5,22,31,14
2006_12_OAK_SD,LAC,LV,12,2006,152,110,187,84,262,271,383.3,265.5,320.1,329,28,1,11,16
2006_12_PHI_IND,IND,PHI,12,2006,183,237,161,149,420,310,382.9,404.2,385.2,290.2,27,31,29,5
2006_12_PIT_BAL,BAL,PIT,12,2006,161,114,224,21,275,245,313.9,388.5,358,278.9,8,30,23,3
2006_12_SF_STL,LA,SF,12,2006,228,140,148,171,368,319,360.1,317.4,323.4,325.8,26,9,13,15
2006_12_TB_DAL,DAL,TB,12,2006,306,137,120,101,443,221,385.2,270.5,382.9,321.1,29,2,27,12
2006_13_ARI_STL,LA,ARI,13,2006,314,107,186,137,421,323,360.8181818181818,311.90909090909093,317.54545454545456,341.27272727272725,25,8,11,20
2006_13_ATL_WAS,WAS,ATL,13,2006,217,177,122,256,394,378,315.6363636363636,358.6363636363636,318.45454545454544,409.6363636363636,10,24,12,32
2006_13_BAL_CIN,CIN,BAL,13,2006,234,67,227,89,301,316,363.6363636363636,310.3636363636364,275.09090909090907,375.45454545454544,26,7,3,28
2006_13_CAR_PHI,PHI,CAR,13,2006,312,98,269,108,410,377,395.6363636363636,318.45454545454544,386.27272727272725,315.6363636363636,31,12,29,10
2006_13_DAL_NYG,NYG,DAL,13,2006,270,126,257,110,396,367,346.1818181818182,390.45454545454544,296.27272727272725,266,22,30,5,2
2006_13_DET_NE,NE,DET,13,2006,305,79,314,77,384,391,358.09090909090907,337.8181818181818,337.09090909090907,338.54545454545456,23,18,17,19
2006_13_HOU_OAK,LV,HOU,13,2006,238,113,32,129,351,161,266,321.90909090909093,372.27272727272725,301.90909090909093,2,13,27,6
2006_13_IND_TEN,TEN,IND,13,2006,163,219,351,95,382,446,296.27272727272725,386.27272727272725,346.1818181818182,395.6363636363636,5,29,22,31
2006_13_JAX_MIA,MIA,JAX,13,2006,267,68,229,150,335,379,338.54545454545456,325.8181818181818,337.8181818181818,278.6363636363636,19,14,18,4
2006_13_KC_CLE,CLE,KC,13,2006,293,150,297,124,443,421,275.09090909090907,334,363.6363636363636,314.09090909090907,3,16,26,9
2006_13_MIN_CHI,CHI,MIN,13,2006,34,83,178,192,117,370,337.09090909090907,341.27272727272725,358.09090909090907,311.90909090909093,17,20,23,8
2006_13_NYJ_GB,GB,NYJ,13,2006,214,149,263,178,363,441,344.3636363636364,301.90909090909093,331.8181818181818,321.90909090909093,21,6,15,13
2006_13_SD_BUF,BUF,LAC,13,2006,184,63,160,197,247,357,278.6363636363636,372.27272727272725,325.8181818181818,266,4,27,14,2
2006_13_SEA_DEN,DEN,SEA,13,2006,143,181,168,108,324,276,314.09090909090907,331.8181818181818,334,344.3636363636364,9,15,16,21
2006_13_SF_NO,NO,SF,13,2006,186,190,171,57,376,228,409.6363636363636,317.54545454545456,358.6363636363636,360.8181818181818,32,11,24,25
2006_13_TB_PIT,PIT,TB,13,2006,198,76,175,110,274,285,375.45454545454544,266,310.3636363636364,390.45454545454544,28,2,7,30
2006_14_ATL_TB,TB,ATL,14,2006,204,80,155,139,284,294,267.5833333333333,360.25,367,322.1666666666667,1,25,27,13
2006_14_BAL_KC,KC,BAL,14,2006,178,135,283,93,313,376,341.25,310.8333333333333,289.0833333333333,358.4166666666667,18,8,4,23
2006_14_BUF_NYJ,NYJ,BUF,14,2006,182,134,157,174,316,331,313.50000000000006,276,345.9166666666667,371,10,3,21,28
2006_14_CHI_STL,LA,CHI,14,2006,356,101,200,172,457,372,365.8333333333333,318.74999999999994,312.83333333333337,343.6666666666667,26,12,9,20
2006_14_CLE_PIT,PIT,CLE,14,2006,225,303,276,18,528,294,367,289.0833333333333,267.5833333333333,341.25,27,4,1,18
2006_14_DEN_SD,LAC,DEN,14,2006,279,147,188,162,426,350,371,314.91666666666663,276,327.1666666666667,28,11,3,15
2006_14_GB_SF,SF,GB,14,2006,201,146,293,139,347,432,310.0833333333333,345.9166666666667,406.8333333333333,313.50000000000006,7,21,32,10
2006_14_IND_JAX,JAX,IND,14,2006,79,375,313,34,454,347,330.25,391.25,338.25,303.4166666666667,16,30,17,5
2006_14_MIN_DET,DET,MIN,14,2006,294,-3,159,172,291,331,342.25,343.6666666666667,360.25,318.74999999999994,19,20,25,12
2006_14_NE_MIA,MIA,NE,14,2006,190,131,90,123,321,213,338.25,360.25,330.25,342.25,17,25,16,19
2006_14_NO_DAL,DAL,NO,14,2006,249,116,384,159,365,543,388.5,406.8333333333333,350.3333333333333,310.0833333333333,29,32,22,7
2006_14_NYG_CAR,CAR,NYG,14,2006,423,45,172,135,468,307,323.3333333333333,350.3333333333333,396.8333333333333,388.5,14,22,31,29
2006_14_OAK_CIN,CIN,LV,14,2006,303,136,199,45,439,244,358.4166666666667,273.0833333333333,310.8333333333333,308.50000000000006,23,2,8,6
2006_14_PHI_WAS,WAS,PHI,14,2006,222,210,164,99,432,263,322.1666666666667,396.8333333333333,360.25,323.3333333333333,13,31,25,14
2006_14_SEA_ARI,ARI,SEA,14,2006,232,113,243,120,345,363,312.83333333333337,327.1666666666667,365.8333333333333,314.91666666666663,9,15,26,11
2006_14_TEN_HOU,HOU,TEN,14,2006,140,107,218,218,247,436,308.50000000000006,303.4166666666667,273.0833333333333,391.25,6,5,2,30
2006_15_CIN_IND,IND,CIN,15,2006,282,112,176,133,394,309,387.84615384615387,364.61538461538464,339.7692307692308,270.84615384615387,31,25,19,2
2006_15_CLE_BAL,BAL,CLE,15,2006,238,142,223,68,380,291,315.84615384615387,289.46153846153845,339.0769230769231,379.38461538461536,10,4,18,28
2006_15_DAL_ATL,ATL,DAL,15,2006,270,127,278,94,397,372,355.15384615384613,386.6923076923077,268.84615384615387,417.3076923076923,24,30,1,32
2006_15_DEN_ARI,ARI,DEN,15,2006,214,100,261,106,314,367,315.3076923076923,317.61538461538464,329.9230769230769,375.2307692307692,9,11,13,27
2006_15_DET_GB,GB,DET,15,2006,174,139,135,58,313,193,352.53846153846155,338.3076923076923,312.9230769230769,342.6923076923077,23,17,6,20
2006_15_HOU_NE,NE,HOU,15,2006,129,105,127,105,234,232,348.9230769230769,303.76923076923083,336.9230769230769,313.61538461538464,22,5,16,7
2006_15_JAX_TEN,TEN,JAX,15,2006,85,41,233,202,126,435,313.61538461538464,339.7692307692308,303.76923076923083,387.84615384615387,7,19,5,31
2006_15_KC_SD,LAC,KC,15,2006,97,265,185,90,362,275,375.2307692307692,339.0769230769231,317.61538461538464,315.84615384615387,27,18,11,10
2006_15_MIA_BUF,BUF,MIA,15,2006,200,100,118,112,300,230,280.2307692307692,336.9230769230769,313.69230769230774,348.9230769230769,3,16,8,22
2006_15_NYJ_MIN,MIN,NYJ,15,2006,273,62,339,68,335,407,342.6923076923077,313.69230769230774,338.3076923076923,280.2307692307692,20,8,17,3
2006_15_PHI_NYG,NYG,PHI,15,2006,282,88,237,161,370,398,347,386.53846153846155,334.46153846153845,330.61538461538464,21,29,15,14
2006_15_PIT_CAR,CAR,PIT,15,2006,226,43,169,159,269,328,334.46153846153845,379.38461538461536,347,289.46153846153845,15,28,21,4
2006_15_SF_SEA,SEA,SF,15,2006,220,90,162,228,310,390,329.9230769230769,312.9230769230769,315.3076923076923,352.53846153846155,13,6,9,23
2006_15_STL_OAK,LV,LA,15,2006,229,57,137,148,286,285,270.84615384615387,372.84615384615387,364.61538461538464,322.84615384615375,2,26,25,12
2006_15_TB_CHI,CHI,TB,15,2006,339,134,305,57,473,362,322.84615384615375,268.84615384615387,372.84615384615387,355.15384615384613,12,1,26,24
2006_15_WAS_NO,NO,WAS,15,2006,207,71,204,161,278,365,417.3076923076923,330.61538461538464,386.6923076923077,386.53846153846155,32,14,30,29
2006_16_ARI_SF,SF,ARI,16,2006,190,49,267,123,239,390,318.42857142857144,315.2142857142857,328.5,321.14285714285717,8,7,13,11
2006_16_BAL_PIT,PIT,BAL,16,2006,205,63,256,103,268,359,375.7142857142857,320.42857142857144,329.7857142857143,289.57142857142856,28,10,15,4
2006_16_CAR_ATL,ATL,CAR,16,2006,109,83,32,183,192,215,358.14285714285717,329.7857142857143,385.64285714285717,375.7142857142857,24,15,29,28
2006_16_CHI_DET,DET,CHI,16,2006,283,67,248,116,350,364,327.92857142857144,333.5714285714285,349.7142857142857,275.50000000000006,12,17,23,2
2006_16_CIN_DEN,DEN,CIN,16,2006,179,127,209,149,306,358,321.14285714285717,360.64285714285717,315.2142857142857,388.2857142857143,11,25,7,31
2006_16_IND_HOU,HOU,IND,16,2006,163,191,205,114,354,319,298.6428571428572,388.2857142857143,340.7142857142857,360.64285714285717,5,31,19,25
2006_16_KC_OAK,LV,KC,16,2006,226,112,148,150,338,298,271.92857142857144,334.5,366.57142857142856,374.2857142857143,1,18,26,27
2006_16_MIN_GB,GB,MIN,16,2006,285,46,50,77,331,127,349.7142857142857,342.14285714285717,327.92857142857144,320.35714285714283,23,20,12,9
2006_16_NE_JAX,JAX,NE,16,2006,195,144,249,117,339,366,346.57142857142856,340.7142857142857,300.2142857142857,298.6428571428572,21,19,6,5
2006_16_NO_NYG,NYG,NO,16,2006,74,83,132,236,157,368,348.64285714285717,407.35714285714283,387.35714285714283,333.07142857142856,22,32,30,16
2006_16_NYJ_MIA,MIA,NYJ,16,2006,146,124,237,95,270,332,329.2857142857143,320.35714285714283,281.64285714285717,342.14285714285717,14,9,3,20
2006_16_PHI_DAL,DAL,PHI,16,2006,142,83,238,204,225,442,385.64285714285717,387.35714285714283,358.14285714285717,348.64285714285717,29,30,24,22
2006_16_SD_SEA,SEA,LAC,16,2006,189,153,181,168,342,349,328.5,374.2857142857143,318.42857142857144,334.5,13,27,8,18
2006_16_TB_CLE,CLE,TB,16,2006,123,91,212,153,214,365,289.57142857142856,275.50000000000006,320.42857142857144,333.5714285714285,4,2,10,17
2006_16_TEN_BUF,BUF,TEN,16,2006,266,117,183,215,383,398,281.64285714285717,300.2142857142857,329.2857142857143,346.57142857142856,3,6,14,21
2006_16_WAS_STL,LA,WAS,16,2006,388,197,160,176,585,336,366.57142857142856,333.07142857142856,271.92857142857144,407.35714285714283,26,16,1,32
2006_17_ARI_SD,LAC,ARI,17,2006,235,169,356,98,404,454,372.6,320.2,329.4,313.1333333333333,27,9,16,7
2006_17_ATL_PHI,PHI,ATL,17,2006,350,43,256,159,393,415,391,347.06666666666666,374.93333333333334,322.1333333333333,31,23,28,11
2006_17_BUF_BAL,BAL,BUF,17,2006,216,111,237,39,327,276,323,288.4,368.53333333333336,306.73333333333335,12,4,26,6
2006_17_CAR_NO,NO,CAR,17,2006,254,61,207,106,315,313,404.73333333333335,322.1333333333333,335.8666666666667,347.06666666666666,32,11,20,23
2006_17_CLE_HOU,HOU,CLE,17,2006,86,94,187,127,180,314,302.33333333333337,284.53333333333336,383.6666666666667,281.46666666666675,5,3,30,2
2006_17_DET_DAL,DAL,DET,17,2006,321,58,306,85,379,391,374.93333333333334,329.4,391,335.59999999999997,28,16,31,19
2006_17_GB_CHI,CHI,GB,17,2006,194,135,285,97,329,382,335.59999999999997,348.46666666666664,329.4,327.8,19,24,16,14
2006_17_JAX_KC,KC,JAX,17,2006,235,170,306,113,405,419,332.06666666666666,346.06666666666666,276.3333333333333,342.4,17,22,1,21
2006_17_MIA_IND,IND,MIA,17,2006,282,117,210,150,399,360,383.6666666666667,325.3333333333333,302.33333333333337,321.1333333333333,30,13,5,10
2006_17_NE_TEN,TEN,NE,17,2006,227,135,254,171,362,425,306.73333333333335,342.4,288.4,346.06666666666666,6,21,4,22
2006_17_NYG_WAS,WAS,NYG,17,2006,268,128,101,261,396,362,333.26666666666665,335.8666666666667,381.1333333333333,404.73333333333335,18,20,29,32
2006_17_OAK_NYJ,NYJ,LV,17,2006,157,117,136,88,274,224,321.1333333333333,276.3333333333333,325.3333333333333,332.06666666666666,10,1,13,17
2006_17_PIT_CIN,CIN,PIT,17,2006,251,44,280,207,295,487,360.46666666666664,368.53333333333336,320.1333333333333,323,25,26,8,12
2006_17_SEA_TB,TB,SEA,17,2006,185,110,216,132,295,348,281.46666666666675,329.4,284.53333333333336,372.6,2,16,3,27
2006_17_SF_DEN,DEN,SF,17,2006,230,115,194,189,345,383,320.1333333333333,313.1333333333333,360.46666666666664,320.2,8,7,25,9
2006_17_STL_MIN,MIN,LA,17,2006,225,82,248,168,307,416,327.8,381.1333333333333,348.46666666666664,333.26666666666665,14,29,24,18
2006_18_DAL_SEA,SEA,DAL,18,2006,240,92,189,116,332,305,330.5625,375.1875,282.31250000000006,333.25,2,6,2,5
2006_18_KC_IND,IND,KC,18,2006,252,188,107,44,440,151,384.625,336.625,327.5,350.625,7,3,4,7
2006_18_NYG_PHI,PHI,NYG,18,2006,153,185,161,151,338,312,391.125,337.5,351.3125,337.1875,8,4,8,6
2006_18_NYJ_NE,NE,NYJ,18,2006,212,158,299,70,370,369,347.5625,318.1875,310.1875,273.0625,5,1,3,1
2006_19_IND_BAL,BAL,IND,19,2006,173,83,170,100,256,270,323.25,387.88235294117646,287.625,325.70588235294116,1,6,1,4
2006_19_NE_SD,LAC,NE,19,2006,230,148,280,51,378,331,374.5625,348.88235294117646,328.5625,321.1764705882353,5,4,5,2
2006_19_PHI_NO,NO,PHI,19,2006,243,208,240,123,451,363,399.125,388,321.5625,336,8,7,3,6
2006_19_SEA_CHI,CHI,SEA,19,2006,282,120,195,127,402,322,335.18749999999994,330.6470588235294,350.5625,371.05882352941177,3,2,7,8
2006_20_NE_IND,IND,NE,20,2006,349,125,232,93,474,325,381.3333333333333,347.8888888888889,319.5138888888889,374.75347222222223,3,2,1,3
2006_20_NO_CHI,CHI,NO,20,2006,144,196,354,56,340,410,339.1176470588235,402.1764705882353,330.1384083044982,386.52941176470586,1,4,2,4
2006_21_IND_CHI,CHI,IND,21,2006,165,111,247,191,276,438,339.16666666666663,386.2105263157895,402.6111111111111,346.6842105263158,1,2,2,1
2007_01_ARI_SF,SF,ARI,1,2007,126,92,102,161,218,263,0,0,0,0,32,32,32,32
2007_01_ATL_MIN,MIN,ATL,1,2007,163,139,199,96,302,295,0,0,0,0,32,32,32,32
2007_01_BAL_CIN,CIN,BAL,1,2007,194,55,222,107,249,329,0,0,0,0,32,32,32,32
2007_01_CAR_STL,LA,CAR,1,2007,167,76,201,186,243,387,0,0,0,0,32,32,32,32
2007_01_CHI_SD,LAC,CHI,1,2007,207,77,145,80,284,225,0,0,0,0,32,32,32,32
2007_01_DEN_BUF,BUF,DEN,1,2007,97,112,304,171,209,475,0,0,0,0,32,32,32,32
2007_01_DET_OAK,LV,DET,1,2007,313,92,289,108,405,397,0,0,0,0,32,32,32,32
2007_01_KC_HOU,HOU,KC,1,2007,225,109,168,72,334,240,0,0,0,0,32,32,32,32
2007_01_MIA_WAS,WAS,MIA,1,2007,222,191,219,66,413,285,0,0,0,0,32,32,32,32
2007_01_NE_NYJ,NYJ,NE,1,2007,202,60,297,134,262,431,0,0,0,0,32,32,32,32
2007_01_NO_IND,IND,NO,1,2007,288,164,192,106,452,298,0,0,0,0,32,32,32,32
2007_01_NYG_DAL,DAL,NYG,1,2007,345,142,319,124,487,443,0,0,0,0,32,32,32,32
2007_01_PHI_GB,GB,PHI,1,2007,206,46,184,103,252,287,0,0,0,0,32,32,32,32
2007_01_PIT_CLE,CLE,PIT,1,2007,218,46,161,206,264,367,0,0,0,0,32,32,32,32
2007_01_TB_SEA,SEA,TB,1,2007,222,139,210,90,361,300,0,0,0,0,32,32,32,32
2007_01_TEN_JAX,JAX,TEN,1,2007,204,72,78,282,276,360,0,0,0,0,32,32,32,32
2007_02_ATL_JAX,JAX,ATL,2,2007,272,113,200,82,385,282,276,295,360,302,11,15,21,18
2007_02_BUF_PIT,PIT,BUF,2,2007,242,184,154,102,426,256,367,209,264,475,23,1,10,31
2007_02_CIN_CLE,CLE,CIN,2,2007,328,226,401,137,554,538,264,249,367,329,10,6,23,19
2007_02_DAL_MIA,MIA,DAL,2,2007,287,61,186,166,348,352,285,487,413,443,13,32,27,29
2007_02_GB_NYG,NYG,GB,2,2007,244,94,286,83,338,369,443,252,487,287,29,7,32,14
2007_02_HOU_CAR,CAR,HOU,2,2007,316,66,227,119,382,346,387,334,243,240,24,20,5,4
2007_02_IND_TEN,TEN,IND,2,2007,184,141,312,81,325,393,360,452,276,298,21,30,11,16
2007_02_KC_CHI,CHI,KC,2,2007,160,107,230,70,267,300,225,240,284,334,3,4,12,20
2007_02_MIN_DET,DET,MIN,2,2007,393,56,192,123,449,315,397,302,405,295,25,18,26,15
2007_02_NO_TB,TB,NO,2,2007,243,87,260,99,330,359,300,298,361,452,17,16,22,30
2007_02_NYJ_BAL,BAL,NYJ,2,2007,185,118,260,69,303,329,329,262,249,431,19,8,6,28
2007_02_OAK_DEN,DEN,LV,2,2007,269,181,73,200,450,273,475,405,209,397,31,26,1,25
2007_02_SD_NE,NE,LAC,2,2007,279,144,179,52,423,231,431,284,262,225,28,12,8,3
2007_02_SEA_ARI,ARI,SEA,2,2007,299,132,281,92,431,373,263,361,218,300,9,22,2,17
2007_02_SF_STL,LA,SF,2,2007,368,61,126,89,429,215,243,218,387,263,5,2,24,9
2007_02_WAS_PHI,PHI,WAS,2,2007,240,114,209,130,354,339,287,413,252,285,14,27,7,13
2007_03_ARI_BAL,BAL,ARI,3,2007,281,129,311,61,410,372,316,347,295.5,367,11,20,7,21
2007_03_BUF_NE,NE,BUF,3,2007,311,177,101,110,488,211,427,232.5,257.5,396.5,31,2,4,26
2007_03_CAR_ATL,ATL,CAR,3,2007,361,91,165,175,452,340,288.5,384.5,330.5,340,6,23,15,18
2007_03_CIN_SEA,SEA,CIN,3,2007,248,102,342,84,350,426,367,393.5,347,409,21,25,20,27
2007_03_CLE_OAK,LV,CLE,3,2007,226,186,248,88,412,336,339,409,462.5,393.5,17,27,32,25
2007_03_DAL_CHI,CHI,DAL,3,2007,195,75,329,131,270,460,246,419.5,270,316.5,3,28,5,12
2007_03_DET_PHI,PHI,DET,3,2007,381,173,446,39,554,485,320.5,423,376,308.5,13,30,22,8
2007_03_IND_HOU,HOU,IND,3,2007,236,40,273,92,276,365,340,422.5,384.5,342.5,18,29,23,19
2007_03_JAX_DEN,DEN,JAX,3,2007,222,47,154,186,269,340,462.5,330.5,339,288.5,32,15,17,6
2007_03_MIA_NYJ,NYJ,MIA,3,2007,124,141,318,112,265,430,295.5,316.5,316,419.5,7,12,11,28
2007_03_MIN_KC,KC,MIN,3,2007,206,50,165,123,256,288,270,308.5,246,423,5,8,3,30
2007_03_NYG_WAS,WAS,NYG,3,2007,190,82,232,96,272,328,376,390.5,320.5,310.5,22,24,13,9
2007_03_SD_GB,GB,LAC,3,2007,369,42,306,73,411,379,310.5,257.5,390.5,427,9,4,24,31
2007_03_SF_PIT,PIT,SF,3,2007,160,205,209,91,365,300,396.5,216.5,232.5,336,26,1,2,16
2007_03_STL_TB,TB,LA,3,2007,151,182,116,136,333,252,315,336,328.5,216.5,10,16,14,1
2007_03_TEN_NO,NO,TEN,3,2007,225,34,186,98,259,284,328.5,342.5,315,422.5,14,19,10,29
2007_04_BAL_CLE,CLE,BAL,4,2007,204,99,307,111,303,418,384.6666666666667,347.3333333333333,363.3333333333333,355.3333333333333,20,13,19,17
2007_04_CHI_DET,DET,CHI,4,2007,247,95,286,69,342,355,443.6666666666667,254,398.3333333333333,433,27,3,23,26
2007_04_DEN_IND,IND,DEN,4,2007,193,226,131,223,419,354,403.3333333333333,398,318.6666666666667,333.6666666666667,24,22,9,11
2007_04_GB_MIN,MIN,GB,4,2007,258,155,344,46,413,390,301.6666666666667,344,265.3333333333333,298,7,12,4,6
2007_04_HOU_ATL,ATL,HOU,4,2007,223,90,317,87,313,404,343,318.6666666666667,369.6666666666667,403.3333333333333,11,9,20,24
2007_04_KC_SD,LAC,KC,4,2007,211,133,284,126,344,410,298,265.3333333333333,344,301.6666666666667,6,4,14,7
2007_04_NE_CIN,CIN,NE,4,2007,234,57,231,173,291,404,404.3333333333333,447.3333333333333,361.3333333333333,225.33333333333334,25,28,18,1
2007_04_NYJ_BUF,BUF,NYJ,4,2007,234,86,290,60,320,350,225.33333333333334,285.3333333333333,447.3333333333333,354.3333333333333,1,5,28,16
2007_04_OAK_MIA,MIA,LV,4,2007,158,141,75,299,299,374,354.3333333333333,363.3333333333333,285.3333333333333,384.6666666666667,14,17,5,21
2007_04_PHI_NYG,NYG,PHI,4,2007,135,83,138,114,218,252,369.6666666666667,398.3333333333333,341.3333333333333,443.6666666666667,19,23,12,27
2007_04_PIT_ARI,ARI,PIT,4,2007,225,86,244,77,311,321,355.3333333333333,386,347.3333333333333,244.33333333333334,15,21,15,2
2007_04_SEA_SF,SF,SEA,4,2007,128,109,281,93,237,374,244.33333333333334,361.3333333333333,386,404.3333333333333,2,16,22,25
2007_04_STL_DAL,DAL,LA,4,2007,339,167,143,62,506,205,433,308,254,321,26,8,3,10
2007_04_TB_CAR,CAR,TB,4,2007,155,99,176,189,254,365,369.6666666666667,321,343,308,19,10,13,8
2007_05_ARI_STL,LA,ARI,5,2007,262,123,290,102,385,392,282.25,344.25,451.25,369.75,4,18,28,22
2007_05_ATL_TEN,TEN,ATL,5,2007,157,92,115,99,249,214,323,335.5,305.3333333333333,340,9,13,7,13
2007_05_BAL_SF,SF,BAL,5,2007,126,49,214,101,175,315,242.5,365,364.5,364.25,1,22,18,17
2007_05_CAR_NO,NO,CAR,5,2007,252,89,162,88,341,250,305.3333333333333,340.75,323,332,7,16,9,11
2007_05_CHI_GB,GB,CHI,5,2007,322,121,214,82,443,296,355.5,279.25,329.5,418.25,19,3,10,27
2007_05_CLE_NE,NE,CLE,5,2007,265,147,287,92,412,379,436.5,364.25,376,365,27,20,23,19
2007_05_DAL_BUF,BUF,DAL,5,2007,176,81,309,76,257,385,249,451.25,301.5,282.25,2,28,6,4
2007_05_DET_WAS,WAS,DET,5,2007,248,118,106,68,366,174,341.3333333333333,418.25,369.6666666666667,279.25,17,26,21,3
2007_05_JAX_KC,KC,JAX,5,2007,279,10,218,156,289,374,301.5,333.6666666666667,309.5,398,6,12,8,25
2007_05_MIA_HOU,HOU,MIA,5,2007,294,74,156,137,368,293,340,340.5,335.5,366,14,15,12,20
2007_05_NYJ_NYG,NYG,NYJ,5,2007,186,188,229,55,374,284,331.75,301.5,361.75,249,10,6,16,2
2007_05_SD_DEN,DEN,LAC,5,2007,232,72,270,214,304,484,387,309.5,407.25,301.5,24,8,26,6
2007_05_SEA_PIT,PIT,SEA,5,2007,206,163,122,38,369,160,369.75,364.5,344.25,242.5,23,21,15,1
2007_05_TB_IND,IND,TB,5,2007,253,147,165,17,400,182,407.25,332,387,340.75,25,11,24,14
2007_06_CAR_ARI,ARI,CAR,6,2007,180,96,206,181,276,387,353.8,322.6,302.8,312.46666666666664,18,9,6,9
2007_06_CIN_KC,KC,CIN,6,2007,264,121,320,78,385,398,299,376,341.73333333333335,436.5,3,24,15,26
2007_06_HOU_JAX,JAX,HOU,6,2007,221,244,341,61,465,402,343.75,345.6,298.375,331,14,16,5,11
2007_06_MIA_CLE,CLE,MIA,6,2007,245,140,256,110,385,366,367.2,331,431.6,345.6,22,12,25,16
2007_06_MIN_CHI,CHI,MIN,6,2007,381,83,136,311,464,447,282.6,329.5,373,355.5,1,11,23,18
2007_06_NE_DAL,DAL,NE,6,2007,199,97,388,75,296,463,438,431.6,250.6,367.2,26,25,2,20
2007_06_NO_SEA,SEA,NO,6,2007,362,92,246,121,454,367,323.6,314.25,369.6,318.0625,10,8,21,10
2007_06_NYG_ATL,ATL,NYG,6,2007,209,103,303,188,312,491,311.2,340.2,308.2,298,7,13,8,4
2007_06_OAK_SD,LAC,LV,6,2007,156,206,230,53,362,283,344.4,366,370.4,340.5,15,21,22,14
2007_06_PHI_NYJ,NYJ,PHI,6,2007,128,158,278,151,286,429,298,361.75,340.2,331.75,2,20,13,12
2007_06_STL_BAL,BAL,LA,6,2007,184,77,208,67,261,275,355,302.8,229,353.8,19,5,1,17
2007_06_TEN_TB,TB,TEN,6,2007,274,30,245,96,304,341,302,304.5,405.8,305.125,4,6,24,7
2007_06_WAS_GB,GB,WAS,6,2007,188,56,217,94,244,311,373,347.5,282.6,357.1875,23,17,3,19
2007_07_ARI_WAS,WAS,ARI,7,2007,95,73,283,84,168,367,340.2,340.8333333333333,347.2,333.3333333333333,13,14,15,11
2007_07_ATL_NO,NO,ATL,7,2007,219,91,273,75,310,348,324.8,311.3333333333333,349.68,365.3333333333333,10,6,18,22
2007_07_BAL_BUF,BUF,BAL,7,2007,153,103,191,127,256,318,250.6,339.3333333333333,438,298.1666666666667,2,12,28,2
2007_07_CHI_PHI,PHI,CHI,7,2007,226,123,322,72,349,394,375.2,312.8333333333333,295.6,349.0833333333333,24,8,1,17
2007_07_IND_JAX,JAX,IND,7,2007,128,117,259,141,245,400,368,405.8,356.88,302,20,26,20,3
2007_07_KC_OAK,LV,KC,7,2007,228,55,177,126,283,303,349.4,313.3333333333333,347.91999999999996,379.6666666666667,16,9,16,25
2007_07_MIN_DAL,DAL,MIN,7,2007,277,128,72,131,405,203,414.3333333333333,353,436.8333333333333,318.88,27,17,27,8
2007_07_NE_MIA,MIA,NE,7,2007,236,179,369,84,415,453,336.8333333333333,436.8333333333333,370.1666666666667,414.3333333333333,11,28,23,26
2007_07_NYJ_CIN,CIN,NYJ,7,2007,226,177,272,84,403,356,380.4,296,316.2,372.9583333333333,25,3,7,24
2007_07_PIT_DEN,DEN,PIT,7,2007,248,90,290,119,338,409,370.4,369.6,344.4,323.6,23,22,13,10
2007_07_SF_NYG,NYG,SF,7,2007,146,140,209,103,286,312,365.3333333333333,229,311.3333333333333,355,19,1,6,19
2007_07_STL_SEA,SEA,LA,7,2007,195,100,225,53,295,278,345.3333333333333,298.1666666666667,323.0416666666667,339.3333333333333,15,4,9,12
2007_07_TB_DET,DET,TB,7,2007,147,147,316,124,294,440,369.4,302.3333333333333,346.26666666666665,310.5833333333333,21,5,14,5
2007_07_TEN_HOU,HOU,TEN,7,2007,313,39,280,155,352,435,355,311.8,363.9583333333333,302.4,18,7,21,4
2007_08_BUF_NYJ,NYJ,BUF,8,2007,173,100,243,108,273,351,304.57142857142856,251.5,383.6285714285714,335.77777777777777,4,2,23,8
2007_08_CLE_STL,LA,CLE,8,2007,322,79,248,132,401,380,295.2857142857143,370.1666666666667,338.14285714285717,336.8333333333333,3,21,10,9
2007_08_DET_CHI,CHI,DET,8,2007,208,63,268,119,271,387,324.42857142857144,356.8333333333333,371.45714285714286,325.27777777777777,8,19,21,5
2007_08_GB_DEN,DEN,GB,8,2007,264,88,331,105,352,436,365,351.5,376.1666666666667,341.4166666666667,20,16,22,12
2007_08_HOU_SD,LAC,HOU,8,2007,130,109,253,115,239,368,347.3333333333333,354.57142857142856,352.1666666666667,329.40000000000003,13,18,17,7
2007_08_IND_CAR,CAR,IND,8,2007,185,108,264,131,293,395,333.3333333333333,404.8333333333333,340.8333333333333,347.5,11,25,11,14
2007_08_JAX_TB,TB,JAX,8,2007,267,136,100,133,403,233,322,347.5,358.6285714285714,404.8333333333333,6,14,19,24
2007_08_NO_SF,SF,NO,8,2007,190,83,336,102,273,438,242.83333333333334,322.3333333333333,352.1111111111111,317.4444444444444,1,7,16,4
2007_08_NYG_MIA,MIA,NYG,8,2007,149,116,59,189,265,248,348,354,439.14285714285717,240.85714285714286,15,17,26,1
2007_08_OAK_TEN,TEN,LV,8,2007,42,192,167,92,234,259,332.3333333333333,338.3333333333333,354.5,311.6111111111111,10,12,18,3
2007_08_PHI_MIN,MIN,PHI,8,2007,182,105,333,62,287,395,328,370.8333333333333,412.77777777777777,326.3611111111111,9,22,25,6
2007_08_PIT_CIN,CIN,PIT,8,2007,205,91,230,160,296,390,384.1666666666667,376.1666666666667,306,365,24,23,2,20
2007_08_WAS_NE,NE,WAS,8,2007,334,152,197,47,486,244,439.14285714285717,311.5,348,345.1944444444444,26,5,15,13
2007_09_ARI_TB,TB,ARI,9,2007,196,162,172,23,358,195,332.125,344.57142857142856,333.1875,315.59999999999997,13,17,16,8
2007_09_BAL_PIT,PIT,BAL,9,2007,223,90,84,64,313,148,378.14285714285717,336.2857142857143,371.57142857142856,251.37142857142857,25,14,24,2
2007_09_CAR_TEN,TEN,CAR,9,2007,110,140,143,78,250,221,318.2857142857143,327.57142857142856,327,403.42857142857144,7,10,13,27
2007_09_CIN_BUF,BUF,CIN,9,2007,303,176,271,28,479,299,265.7142857142857,371.57142857142856,300.06122448979596,378.14285714285717,2,23,5,26
2007_09_DAL_PHI,PHI,DAL,9,2007,264,66,324,110,330,434,374.2857142857143,413,322.14285714285717,331.57142857142856,24,27,11,15
2007_09_DEN_DET,DET,DEN,9,2007,252,130,282,47,382,329,361.14285714285717,363.14285714285717,316.79591836734693,363.57142857142856,19,20,9,23
2007_09_GB_KC,KC,GB,9,2007,213,61,360,78,274,438,311.85714285714283,363.57142857142856,339.91428571428565,363.14285714285717,5,21,20,22
2007_09_HOU_OAK,LV,HOU,9,2007,158,153,181,178,311,359,327,356.25,318.2857142857143,333.79166666666663,9,18,10,18
2007_09_JAX_NO,NO,JAX,9,2007,445,103,354,88,548,442,338.85714285714283,331.14285714285717,247.14285714285714,333.57142857142856,16,11,1,17
2007_09_NE_IND,IND,NE,9,2007,225,119,255,105,344,360,403.42857142857144,445,327.57142857142856,303.0625,26,28,14,6
2007_09_SD_MIN,MIN,LAC,9,2007,158,378,197,42,536,239,322.14285714285717,331.85714285714283,374.2857142857143,356.48979591836735,8,12,25,21
2007_09_SEA_CLE,CLE,SEA,9,2007,364,64,318,105,428,423,371.57142857142856,338.14285714285717,310.38775510204084,295.2857142857143,23,15,7,4
2007_09_SF_ATL,ATL,SF,9,2007,138,155,149,116,293,265,316.57142857142856,247.14285714285714,322.6857142857143,338.85714285714283,6,1,12,19
2007_09_WAS_NYJ,NYJ,WAS,9,2007,226,124,142,296,350,438,300.625,301.85714285714283,263.9375,445.8367346938776,3,4,3,28
2007_10_ATL_CAR,CAR,ATL,10,2007,153,90,201,88,243,289,314.25,313.625,309.75,249.375,8,7,5,1
2007_10_BUF_MIA,MIA,BUF,10,2007,131,143,157,63,274,220,337.625,292.375,340.75,362.5,14,2,12,19
2007_10_CHI_OAK,LV,CHI,10,2007,108,113,239,78,221,317,325,317.75,356.59375,360.60416666666663,12,9,16,18
2007_10_CIN_BAL,BAL,CIN,10,2007,217,66,271,70,283,341,312.75,362.5,370,292.375,6,20,23,2
2007_10_CLE_PIT,PIT,CLE,10,2007,278,159,123,40,437,163,370,378.625,312.75,348.75,24,26,6,14
2007_10_DAL_NYG,NYG,DAL,10,2007,236,106,247,82,342,329,340.75,415.625,337.625,368.75,15,28,11,22
2007_10_DEN_KC,KC,DEN,10,2007,245,67,192,141,312,333,307.125,358.875,372.875,363.75,3,19,25,20
2007_10_DET_ARI,ARI,DET,10,2007,261,73,294,-18,334,276,325.875,363.75,335.359375,358.875,13,21,10,17
2007_10_IND_SD,LAC,IND,10,2007,104,91,328,75,195,403,320.25,396,348.875,434.375,11,27,15,28
2007_10_JAX_TEN,TEN,JAX,10,2007,257,62,101,166,319,267,309.75,345,314.25,365,5,16,8,21
2007_10_MIN_GB,GB,MIN,10,2007,368,120,176,86,488,262,372.875,348.875,307.125,320.25,25,18,4,9
2007_10_PHI_WAS,WAS,PHI,10,2007,215,158,251,139,373,390,318.875,368.75,306.796875,415.625,10,23,3,27
2007_10_SF_SEA,SEA,SF,10,2007,278,106,114,79,384,193,348.75,249.375,378.625,313.625,17,1,26,7
2007_10_STL_NO,NO,LA,10,2007,272,43,304,133,315,437,365,308.5,345,371.39583333333337,22,4,13,24
2007_11_ARI_CIN,CIN,ARI,11,2007,329,72,211,50,401,261,360.1111111111111,326.77777777777777,309.44444444444446,354,26,14,6,22
2007_11_CAR_GB,GB,CAR,11,2007,218,103,258,131,321,389,385.6666666666667,306.3333333333333,339.22222222222223,310.8888888888889,29,5,19,8
2007_11_CHI_SEA,SEA,CHI,11,2007,337,103,266,107,440,373,352.6666666666667,317.6666666666667,243.11111111111111,313.44444444444446,20,11,1,9
2007_11_CLE_BAL,BAL,CLE,11,2007,279,128,274,111,407,385,309.44444444444446,354.6666666666667,360.1111111111111,377.44444444444446,7,22,26,28
2007_11_KC_IND,IND,KC,11,2007,163,66,169,72,229,241,396.77777777777777,307.6666666666667,306.3333333333333,356,30,6,4,24
2007_11_MIA_PHI,PHI,MIA,11,2007,150,202,109,77,352,186,371.1111111111111,330.55555555555554,324.8888888888889,284.3333333333333,27,15,13,2
2007_11_NE_BUF,BUF,NE,11,2007,173,78,383,127,251,510,284.3333333333333,435.55555555555554,330.55555555555554,396.82539682539687,2,32,17,31
2007_11_NO_HOU,HOU,NO,11,2007,293,103,290,47,396,337,356.55555555555554,359.44444444444446,325.22222222222223,322.77777777777777,24,25,14,12
2007_11_NYG_DET,DET,NYG,11,2007,377,25,283,72,402,355,354,340.8888888888889,326.77777777777777,406,21,19,15,32
2007_11_OAK_MIN,MIN,LV,11,2007,265,228,344,61,493,405,339.22222222222223,313.44444444444446,385.6666666666667,317.6666666666667,18,10,29,11
2007_11_PIT_NYJ,NYJ,PIT,11,2007,162,151,195,112,313,307,306.1111111111111,377.44444444444446,316.984126984127,354.6666666666667,3,28,10,23
2007_11_SD_JAX,JAX,LAC,11,2007,189,122,309,79,311,388,336.3333333333333,306.3333333333333,310.77777777777777,396.77777777777777,17,5,7,30
2007_11_STL_SF,SF,LA,11,2007,231,32,155,102,263,257,243.11111111111111,322.77777777777777,352.6666666666667,359.44444444444446,1,12,21,25
2007_11_TB_ATL,ATL,TB,11,2007,245,49,161,149,294,310,310.8888888888889,335,306.3333333333333,327.95238095238096,9,16,4,16
2007_11_TEN_DEN,DEN,TEN,11,2007,200,166,305,133,366,438,356,310.77777777777777,307.6666666666667,336.3333333333333,23,8,5,18
2007_11_WAS_DAL,DAL,WAS,11,2007,293,72,367,62,365,429,406,324.8888888888889,340.8888888888889,371.1111111111111,31,13,20,27
2007_12_BAL_SD,LAC,BAL,12,2007,249,83,191,56,332,247,314.5,319.2,333.8,357.7,6,10,16,22
2007_12_BUF_JAX,JAX,BUF,12,2007,296,124,211,94,420,305,333.8,281,314.5,443,16,2,6,32
2007_12_DEN_CHI,CHI,DEN,12,2007,193,122,302,138,315,440,323.2,357,361.4,323.5,13,20,25,14
2007_12_GB_DET,DET,GB,12,2007,224,134,381,100,358,481,358.8,379.2,342.3,314.6,23,29,18,7
2007_12_HOU_CLE,CLE,HOU,12,2007,253,148,256,77,401,333,357.7,360.5,319.2,357.2,22,24,10,21
2007_12_IND_ATL,ATL,IND,12,2007,155,112,272,118,267,390,309.2,380,332.5,301,5,30,15,3
2007_12_MIA_PIT,PIT,MIA,12,2007,165,84,132,49,249,181,370.4,316.1,306.8,369.2,28,8,4,27
2007_12_MIN_NYG,NYG,MIN,12,2007,273,75,129,127,348,256,342.3,354.6,358.8,322.6,18,19,23,12
2007_12_NO_CAR,CAR,NO,12,2007,161,43,260,113,204,373,314.6,357.2,379.2,360.5,7,21,29,24
2007_12_NYJ_DAL,DAL,NYJ,12,2007,195,174,142,60,369,202,401.9,306.8,335.3,370.4,31,4,17,28
2007_12_OAK_KC,KC,LV,12,2007,145,164,170,153,309,323,301,322.6,380,354.6,3,12,30,19
2007_12_PHI_NE,NE,PHI,12,2007,380,48,345,55,428,400,443,369.2,281,316.1,32,27,2,8
2007_12_SEA_STL,LA,SEA,12,2007,193,104,249,87,297,336,316.2,361.4,245.1,323.2,9,25,1,13
2007_12_SF_ARI,ARI,SF,12,2007,486,96,256,137,582,393,320.2,245.1,364.2,316.2,11,1,26,9
2007_12_TEN_CIN,CIN,TEN,12,2007,283,148,246,61,431,307,364.2,323.5,320.2,357,26,14,11,20
2007_12_WAS_TB,TB,WAS,12,2007,115,99,301,120,214,421,332.5,335.3,309.2,401.9,15,17,5,31
2007_13_ATL_STL,LA,ATL,13,2007,311,105,356,111,416,467,314.45454545454544,305.3636363636364,359.09090909090907,380.90909090909093,9,7,23,29
2007_13_BUF_WAS,WAS,BUF,13,2007,216,80,257,100,296,357,343.09090909090907,283.1818181818182,321.72727272727275,341.6363636363636,17,2,11,15
2007_13_CIN_PIT,PIT,CIN,13,2007,184,101,183,74,285,257,359.3636363636364,370.27272727272725,303.8181818181818,322,24,27,5,12
2007_13_CLE_ARI,ARI,CLE,13,2007,169,133,304,84,302,388,344,361.6363636363636,258.54545454545456,358,18,25,1,20
2007_13_DEN_OAK,LV,DEN,13,2007,197,175,214,86,372,300,322.6363636363636,364.54545454545456,301.72727272727275,322.45454545454544,14,26,4,13
2007_13_DET_MIN,MIN,DET,13,2007,231,216,260,23,447,283,345.6363636363636,358.72727272727275,342.8181818181818,388.45454545454544,19,22,16,30
2007_13_GB_DAL,DAL,GB,13,2007,309,105,257,124,414,381,398.90909090909093,388.45454545454544,297.27272727272725,358.72727272727275,31,30,3,22
2007_13_HOU_TEN,TEN,HOU,13,2007,248,153,219,119,401,338,322,358,370.27272727272725,361.6363636363636,12,20,27,25
2007_13_JAX_IND,IND,JAX,13,2007,288,63,257,168,351,425,380.90909090909093,341.6363636363636,305.3636363636364,283.1818181818182,29,15,7,2
2007_13_NE_BAL,BAL,NE,13,2007,210,166,257,90,376,347,312.6363636363636,441.6363636363636,316.09090909090907,372,8,32,10,28
2007_13_NYG_CHI,CHI,NYG,13,2007,296,68,195,175,364,370,322.45454545454544,342.8181818181818,364.54545454545456,345.6363636363636,13,16,26,19
2007_13_NYJ_MIA,MIA,NYJ,13,2007,177,37,236,163,214,399,303.8181818181818,297.27272727272725,359.3636363636364,398.90909090909093,5,3,24,31
2007_13_SD_KC,KC,LAC,13,2007,227,88,157,191,315,348,301.72727272727275,316.09090909090907,322.6363636363636,312.6363636363636,4,10,14,8
2007_13_SEA_PHI,PHI,SEA,13,2007,220,144,187,135,364,322,372,359.09090909090907,441.6363636363636,314.45454545454544,28,23,32,9
2007_13_SF_CAR,CAR,SF,13,2007,153,166,171,59,319,230,304.54545454545456,258.54545454545456,358.6363636363636,344,6,1,21,18
2007_13_TB_NO,NO,TB,13,2007,179,84,313,172,263,485,358.6363636363636,321.72727272727275,304.54545454545456,343.09090909090907,21,11,6,17
2007_14_ARI_SEA,SEA,ARI,14,2007,272,80,337,50,352,387,356,340.5,371.3333333333333,363.8333333333333,23,16,28,27
2007_14_CAR_JAX,JAX,CAR,14,2007,249,178,105,50,427,155,348.5833333333333,305.75,378.4166666666667,256.1666666666667,18,6,29,1
2007_14_CHI_WAS,WAS,CHI,14,2007,324,31,309,60,355,369,339.16666666666663,325.9166666666667,289.3333333333333,345.0833333333333,15,11,2,17
2007_14_CLE_NYJ,NYJ,CLE,14,2007,286,119,185,152,405,337,305.75,363.8333333333333,296.3333333333333,340.5,6,27,3,16
2007_14_DAL_DET,DET,DAL,14,2007,248,152,302,87,400,389,352.4166666666667,400.1666666666667,354.0833333333333,387.8333333333333,20,31,22,30
2007_14_IND_BAL,BAL,IND,14,2007,165,98,275,59,263,334,317.9166666666667,378.4166666666667,433.75,348.5833333333333,7,29,32,18
2007_14_KC_DEN,DEN,KC,14,2007,244,215,132,16,459,148,359.1666666666667,302.8333333333333,326.75,318.74999999999994,25,4,12,8
2007_14_MIA_BUF,BUF,MIA,14,2007,165,224,247,65,389,312,289.3333333333333,296.3333333333333,339.16666666666663,305.75,2,3,15,6
2007_14_MIN_SF,SF,MIN,14,2007,226,73,163,117,299,280,256.1666666666667,354.0833333333333,305.75,352.4166666666667,1,22,6,20
2007_14_NO_ATL,ATL,NO,14,2007,298,37,328,145,335,473,318.8333333333333,350.6666666666667,322.9166666666667,335.3333333333333,9,19,10,14
2007_14_NYG_PHI,PHI,NYG,14,2007,179,141,219,111,320,330,371.3333333333333,345.0833333333333,356,325.9166666666667,28,17,23,11
2007_14_OAK_GB,GB,LV,14,2007,266,179,148,85,445,233,387.8333333333333,326.75,400.1666666666667,359.1666666666667,30,12,31,25
2007_14_PIT_NE,NE,PIT,14,2007,399,22,187,181,421,368,433.75,353.1666666666667,317.9166666666667,360.8333333333333,32,21,7,26
2007_14_SD_TEN,TEN,LAC,14,2007,119,131,228,148,250,376,328.5833333333333,318.74999999999994,356.3333333333333,302.8333333333333,13,8,24,4
2007_14_STL_CIN,CIN,LA,14,2007,189,192,153,88,381,241,360.8333333333333,322.9166666666667,353.1666666666667,318.8333333333333,26,10,21,9
2007_14_TB_HOU,HOU,TB,14,2007,209,71,266,71,280,337,356.3333333333333,335.3333333333333,328.5833333333333,350.6666666666667,24,14,13,19
2007_15_ARI_NO,NO,ARI,15,2007,315,114,233,103,429,336,360.0769230769231,344.0769230769231,320.0769230769231,355.6923076923077,24,17,10,22
2007_15_ATL_TB,TB,ATL,15,2007,109,190,34,106,299,140,335.46153846153845,320.0769230769231,350.46153846153845,360.0769230769231,14,10,19,24
2007_15_BAL_MIA,MIA,BAL,15,2007,315,72,208,163,387,371,297.53846153846155,313.6923076923077,297,375,5,7,4,29
2007_15_BUF_CLE,CLE,BUF,15,2007,137,174,124,108,311,232,361.7692307692308,297,313.38461538461536,297.53846153846155,25,4,6,5
2007_15_CHI_MIN,MIN,CHI,15,2007,249,136,184,32,385,216,348.38461538461536,329.2307692307692,259.46153846153845,340.38461538461536,18,13,1,15
2007_15_CIN_SF,SF,CIN,15,2007,197,156,251,61,353,312,259.46153846153845,362.38461538461536,348.38461538461536,316.61538461538464,1,26,18,8
2007_15_DEN_HOU,HOU,DEN,15,2007,200,158,254,72,358,326,350.46153846153845,366.84615384615387,335.46153846153845,290.9230769230769,19,27,14,2
2007_15_DET_SD,LAC,DET,15,2007,142,274,302,26,416,328,323.1538461538461,356.0769230769231,322.53846153846155,399.3076923076923,12,23,11,31
2007_15_GB_STL,LA,GB,15,2007,219,173,225,52,392,277,316.61538461538464,392.2307692307692,362.38461538461536,319.53846153846155,8,30,26,9
2007_15_IND_OAK,LV,IND,15,2007,104,149,276,58,253,334,319.53846153846155,375,392.2307692307692,313.6923076923077,9,29,30,7
2007_15_JAX_PIT,PIT,JAX,15,2007,146,111,197,224,257,421,354.3076923076923,354.61538461538464,432.7692307692308,294.15384615384613,20,21,32,3
2007_15_NYJ_NE,NE,NYJ,15,2007,140,131,186,90,271,276,432.7692307692308,313.38461538461536,354.3076923076923,361.7692307692308,32,6,20,25
2007_15_PHI_DAL,DAL,PHI,15,2007,214,53,208,134,267,342,399.3076923076923,367.38461538461536,356.0769230769231,343.9230769230769,31,28,23,16
2007_15_SEA_CAR,CAR,SEA,15,2007,208,114,274,44,322,318,294.15384615384613,355.6923076923077,354.61538461538464,344.0769230769231,3,22,21,17
2007_15_TEN_KC,KC,TEN,15,2007,217,89,191,148,306,339,290.9230769230769,322.53846153846155,366.84615384615387,323.1538461538461,2,11,27,12
2007_15_WAS_NYG,NYG,WAS,15,2007,184,139,166,153,323,319,343.9230769230769,340.38461538461536,367.38461538461536,329.2307692307692,16,15,28,13
2007_16_ATL_ARI,ARI,ATL,16,2007,361,76,315,102,437,417,343.5,307.2142857142857,365,332.85714285714283,17,6,27,14
2007_16_BAL_SEA,SEA,BAL,16,2007,202,144,199,106,346,305,353,317.7857142857143,296.14285714285717,303.92857142857144,21,9,4,5
2007_16_CLE_CIN,CIN,CLE,16,2007,115,155,250,136,270,386,358.7857142857143,358.14285714285717,266.14285714285717,292.35714285714283,24,23,1,3
2007_16_DAL_CAR,CAR,DAL,16,2007,182,69,257,148,251,405,296.14285714285717,389.85714285714283,353,365.57142857142856,4,31,21,28
2007_16_DEN_SD,LAC,DEN,16,2007,190,147,155,92,337,247,329.7857142857142,363.92857142857144,354.07142857142856,351,13,26,22,20
2007_16_GB_CHI,CHI,GB,16,2007,101,139,153,125,240,278,321.14285714285717,384,351,322,10,30,20,11
2007_16_HOU_IND,IND,HOU,16,2007,340,120,233,66,460,299,372.07142857142856,351,314.7857142857143,363.92857142857144,29,20,8,26
2007_16_KC_DET,DET,KC,16,2007,115,137,374,63,252,437,354.07142857142856,292,329.7857142857142,323.7142857142857,22,2,13,12
2007_16_MIA_NE,NE,MIA,16,2007,215,196,171,108,411,279,421.2142857142857,303.92857142857144,310.7142857142857,317.7857142857143,32,5,7,9
2007_16_NYG_BUF,BUF,NYG,16,2007,161,117,111,291,278,402,292.35714285714283,342.42857142857144,358.14285714285717,338.85714285714283,3,16,23,15
2007_16_NYJ_TEN,TEN,NYJ,16,2007,166,127,264,68,293,332,323.7142857142857,310.7142857142857,292,421.2142857142857,12,7,2,32
2007_16_OAK_JAX,JAX,LV,16,2007,253,201,129,110,454,239,359.35714285714283,314.7857142857143,347.35714285714283,372.07142857142856,25,8,18,29
2007_16_PHI_NO,NO,PHI,16,2007,284,70,263,184,354,447,365,365.57142857142856,343.5,389.85714285714283,27,28,17,31
2007_16_PIT_STL,LA,PIT,16,2007,235,90,293,166,325,459,322,347.35714285714283,384,359.35714285714283,11,18,30,25
2007_16_TB_SF,SF,TB,16,2007,123,97,381,67,220,448,266.14285714285717,332.85714285714283,358.7857142857143,307.2142857142857,1,14,24,6
2007_16_WAS_MIN,MIN,WAS,16,2007,220,87,269,106,307,375,351,338.85714285714283,321.14285714285717,342.42857142857144,20,15,10,16
2007_17_BUF_PHI,PHI,BUF,17,2007,345,69,133,138,414,271,371,291.4,364.26666666666665,346.4,28,2,26,16
2007_17_CAR_TB,TB,CAR,17,2007,236,107,174,180,343,354,340.53333333333336,293.1333333333333,263.0666666666667,390.8666666666667,14,3,1,31
2007_17_CIN_MIA,MIA,CIN,17,2007,258,86,316,77,344,393,302.26666666666665,352.8666666666667,420.53333333333336,360,5,22,32,25
2007_17_DAL_WAS,WAS,DAL,17,2007,244,131,165,1,375,166,341.26666666666665,390.8666666666667,348.06666666666666,293.1333333333333,15,31,19,3
2007_17_DET_GB,GB,DET,17,2007,187,217,246,47,404,293,376.93333333333334,347.26666666666665,315.73333333333335,301.6666666666667,29,17,9,4
2007_17_JAX_HOU,HOU,JAX,17,2007,128,170,302,96,298,398,347.53333333333336,365.6666666666667,377.93333333333334,309.73333333333335,18,27,30,6
2007_17_KC_NYJ,NYJ,KC,17,2007,151,199,195,53,350,248,312.1333333333333,301.6666666666667,321.6666666666667,347.26666666666665,7,4,11,17
2007_17_MIN_DEN,DEN,MIN,17,2007,246,128,175,172,374,347,356.1333333333333,348.06666666666666,330.2666666666666,341.26666666666665,24,19,13,15
2007_17_NE_NYG,NYG,NE,17,2007,251,79,356,44,330,400,346.4,420.53333333333336,291.4,302.26666666666665,16,32,2,5
2007_17_NO_CHI,CHI,NO,17,2007,199,96,320,105,295,425,315.73333333333335,364.26666666666665,376.93333333333334,371,9,26,29,28
2007_17_PIT_BAL,BAL,PIT,17,2007,171,180,218,46,351,264,316.93333333333334,354.8,352.53333333333336,322.2,10,23,21,12
2007_17_SD_OAK,LV,LAC,17,2007,224,122,140,120,346,260,309.73333333333335,330.2666666666666,365.6666666666667,356.1333333333333,6,13,27,24
2007_17_SEA_ATL,ATL,SEA,17,2007,251,124,353,167,375,520,314.53333333333336,352.53333333333336,349.73333333333335,316.93333333333334,8,21,20,10
2007_17_SF_CLE,CLE,SF,17,2007,197,163,104,112,360,216,360,263.0666666666667,352.8666666666667,340.53333333333336,25,1,22,14
2007_17_STL_ARI,ARI,LA,17,2007,300,122,180,75,422,255,349.73333333333335,322.2,314.53333333333336,354.8,20,12,8,23
2007_17_TEN_IND,IND,TEN,17,2007,163,46,263,98,209,361,377.93333333333334,321.6666666666667,347.53333333333336,312.1333333333333,30,11,18,7
2007_18_JAX_PIT,PIT,JAX,18,2007,337,43,140,135,380,275,349.125,367.6875,319.0625,344.4375,6,8,4,5
2007_18_NYG_TB,TB,NYG,18,2007,207,69,185,100,276,285,340.6875,345.375,296.9375,419.25,3,5,1,8
2007_18_TEN_SD,LAC,TEN,18,2007,292,68,138,119,360,257,325.87499999999994,324.125,312,367.375,2,1,2,6
2007_18_WAS_SEA,SEA,WAS,18,2007,229,77,266,75,306,341,363,343.375,318.3125,376.8125,7,4,3,7
2007_19_JAX_NE,NE,JAX,19,2007,262,145,278,80,407,358,419.25,362.2352941176471,345.375,350.94117647058823,8,4,7,8
2007_19_NYG_DAL,DAL,NYG,19,2007,201,154,163,90,355,253,376.8125,341.8235294117647,343.375,336.88235294117646,6,2,5,3
2007_19_SD_IND,IND,LAC,19,2007,402,44,312,99,446,411,367.375,327.8823529411764,324.125,320.1764705882353,5,1,2,1
2007_19_SEA_GB,GB,SEA,19,2007,173,235,194,28,408,222,378.625,359.6470588235294,343.875,343.2352941176471,7,3,6,4
2007_20_NYG_GB,GB,NYG,20,2007,236,28,254,134,264,388,380.3529411764706,336.8888888888889,351.5501730103806,375.60069444444446,3,2,1,4
2007_20_SD_NE,NE,LAC,20,2007,209,149,211,104,358,315,418.52941176470586,332.49999999999994,361.9861591695502,371.74305555555554,4,1,2,3
2007_21_NYG_NE,NE,NYG,21,2007,266,45,255,91,311,346,415.1666666666667,339.57894736842104,331.5277777777777,374.2291021671827,2,1,1,2
2008_01_ARI_SF,SF,ARI,1,2008,195,108,197,109,303,306,0,0,0,0,32,32,32,32
2008_01_CAR_SD,LAC,CAR,1,2008,217,105,247,142,322,389,0,0,0,0,32,32,32,32
2008_01_CHI_IND,IND,CHI,1,2008,257,53,150,183,310,333,0,0,0,0,32,32,32,32
2008_01_CIN_BAL,BAL,CIN,1,2008,129,229,99,65,358,164,0,0,0,0,32,32,32,32
2008_01_DAL_CLE,CLE,DAL,1,2008,114,91,320,167,205,487,0,0,0,0,32,32,32,32
2008_01_DEN_OAK,LV,DEN,1,2008,180,150,299,142,330,441,0,0,0,0,32,32,32,32
2008_01_DET_ATL,ATL,DET,1,2008,161,318,262,62,479,324,0,0,0,0,32,32,32,32
2008_01_HOU_PIT,PIT,HOU,1,2008,137,183,202,75,320,277,0,0,0,0,32,32,32,32
2008_01_JAX_TEN,TEN,JAX,1,2008,175,137,215,33,312,248,0,0,0,0,32,32,32,32
2008_01_KC_NE,NE,KC,1,2008,228,126,206,102,354,308,0,0,0,0,32,32,32,32
2008_01_MIN_GB,GB,MIN,1,2008,178,139,178,187,317,365,0,0,0,0,32,32,32,32
2008_01_NYJ_MIA,MIA,NYJ,1,2008,251,49,194,112,300,306,0,0,0,0,32,32,32,32
2008_01_SEA_BUF,BUF,SEA,1,2008,234,106,190,85,340,275,0,0,0,0,32,32,32,32
2008_01_STL_PHI,PHI,LA,1,2008,414,108,158,36,522,194,0,0,0,0,32,32,32,32
2008_01_TB_NO,NO,TB,1,2008,343,101,221,146,444,367,0,0,0,0,32,32,32,32
2008_01_WAS_NYG,NYG,WAS,1,2008,216,154,133,84,370,217,0,0,0,0,32,32,32,32
2008_02_ATL_TB,TB,ATL,2,2008,160,164,158,105,324,263,367,479,444,324,23,28,27,16
2008_02_BUF_JAX,JAX,BUF,2,2008,165,98,239,75,263,314,248,340,312,275,5,20,13,5
2008_02_CHI_CAR,CAR,CHI,2,2008,128,114,149,115,242,264,389,333,322,310,25,19,15,12
2008_02_GB_DET,DET,GB,2,2008,282,49,328,123,331,451,324,317,479,365,17,14,28,22
2008_02_IND_MIN,MIN,IND,2,2008,130,179,311,25,309,336,365,310,317,333,22,12,14,18
2008_02_MIA_ARI,ARI,MIA,2,2008,376,81,179,72,457,251,306,300,303,306,10,7,8,10
2008_02_NE_NYJ,NYJ,NE,2,2008,181,104,165,104,285,269,306,354,300,308,10,21,7,11
2008_02_NO_WAS,WAS,NO,2,2008,321,149,216,55,470,271,217,444,370,367,4,27,24,23
2008_02_NYG_STL,LA,NYG,2,2008,177,68,260,200,245,460,194,370,522,217,2,24,30,3
2008_02_OAK_KC,KC,LV,2,2008,173,55,55,300,228,355,308,330,354,441,11,18,20,26
2008_02_PHI_DAL,DAL,PHI,2,2008,312,68,281,78,380,359,487,522,205,194,29,30,2,1
2008_02_PIT_CLE,CLE,PIT,2,2008,166,53,186,117,219,303,205,320,487,277,3,15,29,6
2008_02_SD_DEN,DEN,LAC,2,2008,350,145,377,80,495,457,441,322,330,389,26,16,17,25
2008_02_SF_SEA,SEA,SF,2,2008,189,169,321,93,358,414,275,303,340,306,6,8,19,10
2008_02_TEN_CIN,CIN,TEN,2,2008,134,88,128,177,222,305,164,312,358,248,1,13,21,4
2008_03_ARI_WAS,WAS,ARI,3,2008,204,136,210,116,340,326,343.5,381.5,357.5,275.5,20,26,23,7
2008_03_CAR_MIN,MIN,CAR,3,2008,204,119,191,47,323,238,337,315.5,323,298.5,18,13,16,9
2008_03_CIN_NYG,NYG,CIN,3,2008,289,117,286,102,406,388,415,193,219.5,308.5,29,1,4,10
2008_03_CLE_BAL,BAL,CLE,3,2008,129,151,125,73,280,198,358,212,164,311.5,23,2,1,12
2008_03_DAL_GB,GB,DAL,3,2008,290,84,260,217,374,477,384,433.5,327.5,440.5,27,30,18,31
2008_03_DET_SF,SF,DET,3,2008,189,182,146,116,371,262,358.5,327.5,316.5,384,24,17,14,27
2008_03_HOU_TEN,TEN,HOU,3,2008,189,154,188,146,343,334,308.5,277,193,320,10,7,2,15
2008_03_JAX_IND,IND,JAX,3,2008,216,114,167,236,330,403,323,255.5,337,327,15,4,19,17
2008_03_KC_ATL,ATL,KC,3,2008,192,186,128,184,378,312,371,268,345.5,342.5,25,5,22,20
2008_03_MIA_NE,NE,MIA,3,2008,156,79,245,216,235,461,311.5,275.5,295.5,381.5,12,6,8,26
2008_03_NO_DEN,DEN,NO,3,2008,264,105,421,88,369,509,468,357.5,389.5,343.5,32,22,28,21
2008_03_NYJ_SD,LAC,NYJ,3,2008,250,107,297,41,357,338,389.5,295.5,468,311.5,28,8,32,12
2008_03_OAK_BUF,BUF,LV,3,2008,279,116,156,98,395,254,327,342.5,255.5,268,16,19,5,6
2008_03_PIT_PHI,PHI,PIT,3,2008,214,65,191,33,279,224,440.5,311.5,433.5,212,31,12,30,3
2008_03_STL_SEA,SEA,LA,3,2008,172,245,184,65,417,249,316.5,219.5,358.5,415,14,3,24,29
2008_03_TB_CHI,CHI,TB,3,2008,268,158,407,47,426,454,298.5,345.5,315.5,371,9,21,13,25
2008_04_ARI_NYJ,NYJ,ARI,4,2008,289,89,472,42,378,514,309.6666666666667,363,378.6666666666667,342.3333333333333,9,18,19,14
2008_04_ATL_CAR,CAR,ATL,4,2008,294,107,158,118,401,276,289.6666666666667,373.3333333333333,332.3333333333333,282.6666666666667,6,19,12,3
2008_04_BAL_PIT,PIT,BAL,4,2008,191,69,192,103,260,295,282.3333333333333,319,386.6666666666667,205,4,11,22,1
2008_04_BUF_STL,LA,BUF,4,2008,236,167,197,111,403,308,229.33333333333334,349.6666666666667,350,313,2,16,16,8
2008_04_CLE_CIN,CIN,CLE,4,2008,156,69,138,134,225,272,258,207.33333333333334,412,332,3,1,24,11
2008_04_DEN_KC,KC,DEN,4,2008,160,213,361,94,373,455,282.6666666666667,435,373.3333333333333,408,5,25,18,23
2008_04_GB_TB,TB,GB,4,2008,149,178,171,28,327,199,381.6666666666667,380.6666666666667,341,448,22,21,13,26
2008_04_HOU_JAX,JAX,HOU,4,2008,236,139,307,79,375,386,304.6666666666667,305.5,325.3333333333333,325.75,7,8,9,10
2008_04_MIN_TEN,TEN,MIN,4,2008,199,76,274,80,275,354,320,332.3333333333333,296,289.6666666666667,12,13,5,4
2008_04_PHI_CHI,CHI,PHI,4,2008,199,78,262,103,277,365,341,386.6666666666667,381.6666666666667,282.3333333333333,14,23,21,2
2008_04_SD_OAK,LV,LAC,4,2008,277,72,180,141,349,321,313,378.6666666666667,349.6666666666667,309.6666666666667,10,20,15,7
2008_04_SF_NO,NO,SF,4,2008,363,104,257,91,467,348,408,362.6666666666667,435,305.6666666666667,24,17,25,6
2008_04_WAS_DAL,DAL,WAS,4,2008,300,44,231,161,344,392,448,342.3333333333333,380.6666666666667,363,26,15,20,17
2008_05_ATL_GB,GB,ATL,5,2008,313,104,194,176,417,370,335.25,349,368,317.5,13,17,24,11
2008_05_BUF_ARI,ARI,BUF,5,2008,250,123,238,84,373,322,400.75,339.25,326.75,272.75,24,16,15,4
2008_05_CHI_DET,DET,CHI,5,2008,171,54,334,97,225,431,305.6666666666667,325,362.6666666666667,381.25,5,10,23,25
2008_05_CIN_DAL,DAL,CIN,5,2008,176,198,217,61,374,278,422,249.75,354.75,223.5,26,1,21,1
2008_05_IND_HOU,HOU,IND,5,2008,246,156,247,79,402,326,332.3333333333333,325.3333333333333,328.11111111111114,304.6666666666667,12,11,16,7
2008_05_KC_CAR,CAR,KC,5,2008,236,205,123,35,441,158,317.5,305.25,349,440,8,4,20,28
2008_05_MIN_NO,NO,MIN,5,2008,330,55,226,44,385,270,422.75,337.75,359,308.75,27,15,22,9
2008_05_NE_SF,SF,NE,5,2008,130,77,259,144,207,403,359,286,422.75,337.3333333333333,20,3,27,18
2008_05_PIT_JAX,JAX,PIT,5,2008,200,38,309,129,238,438,322.25,276.75,325.625,313,9,2,14,10
2008_05_SD_MIA,MIA,LAC,5,2008,228,167,159,60,395,219,337.3333333333333,364.25,286,322,14,21,6,12
2008_05_SEA_NYG,NYG,SEA,5,2008,272,254,125,74,526,199,412,350,258,229.33333333333334,25,18,3,2
2008_05_TB_DEN,DEN,TB,5,2008,227,106,181,139,333,320,440,368,305.25,335.25,28,22,8,17
2008_05_TEN_BAL,BAL,TEN,5,2008,153,132,163,47,285,210,311,308.75,274.88888888888886,337.75,7,6,5,19
2008_05_WAS_PHI,PHI,WAS,5,2008,196,58,194,203,254,397,381.25,354.75,325,422,23,19,13,26
2008_06_BAL_IND,IND,BAL,6,2008,271,76,241,51,347,292,325.5,304.5,349.75,284.0625,11,5,16,4
2008_06_CAR_TB,TB,CAR,6,2008,173,142,242,40,315,282,358.4,342.2,418.6,275.8,22,15,27,3
2008_06_CHI_ATL,ATL,CHI,6,2008,301,75,286,79,376,365,353.2,346.2,351.6,289.53333333333336,20,16,18,5
2008_06_CIN_NYJ,NYJ,CIN,6,2008,189,86,152,43,275,195,326.75,255.4,400.75,412.4,12,2,24,25
2008_06_DAL_ARI,ARI,DAL,6,2008,236,50,321,73,286,394,395.2,412.4,335.8,255.4,24,25,13,2
2008_06_DET_MIN,MIN,DET,6,2008,296,135,150,100,431,250,324.2,285.5,415.2,351.5,10,4,26,17
2008_06_GB_SEA,SEA,GB,6,2008,83,113,208,113,196,321,312.25,351.6,440.5,353.2,7,18,28,19
2008_06_JAX_DEN,DEN,JAX,6,2008,192,131,276,155,323,431,418.6,305.4,358.4,309,27,6,21,6
2008_06_MIA_HOU,HOU,MIA,6,2008,379,114,284,96,493,380,349.75,351.75,325.5,327.9375,17,19,11,12
2008_06_NE_SD,LAC,NE,6,2008,306,98,203,106,404,309,335.2,315.25,348.8666666666667,321,14,8,15,9
2008_06_NYG_CLE,CLE,NYG,6,2008,310,144,196,181,454,377,223.5,440.5,249.75,312.25,1,28,1,8
2008_06_OAK_NO,NO,LV,6,2008,320,122,159,85,442,244,415.2,322,324.2,364.25,26,9,10,23
2008_06_PHI_SF,SF,PHI,6,2008,199,131,280,103,330,383,328.6,355.8,309.4,363.2,13,21,7,22
2008_06_STL_WAS,WAS,LA,6,2008,208,181,136,76,389,212,363.2,272.75,355.8,339.25,23,3,20,14
2008_07_BAL_MIA,MIA,BAL,7,2008,295,71,232,140,366,372,357.4,302,378.4,329.8,22,8,25,13
2008_07_CLE_WAS,WAS,CLE,7,2008,164,193,136,102,357,238,367.5,269.6,262.625,427.8,23,3,2,28
2008_07_DAL_STL,LA,DAL,7,2008,173,180,234,124,353,358,260.6,409.3333333333333,368.36,377,2,26,23,24
2008_07_DEN_NE,NE,DEN,7,2008,185,257,187,106,442,293,314,402.6666666666667,348.96,326.3333333333333,11,25,18,12
2008_07_DET_HOU,HOU,DET,7,2008,267,150,265,77,417,342,378.4,278.4,357.4,345.56,24,5,21,17
2008_07_IND_GB,GB,IND,7,2008,186,116,229,73,302,302,346.5,329.8,292.875,302,18,14,5,6
2008_07_MIN_CHI,CHI,MIN,7,2008,283,53,298,155,336,453,349.3333333333333,342,357,279.5833333333333,20,17,20,4
2008_07_NO_CAR,CAR,NO,7,2008,195,143,231,115,338,346,332.1666666666667,419.6666666666667,351.1666666666667,309,15,27,19,9
2008_07_NYJ_OAK,LV,NYJ,7,2008,203,153,197,242,356,439,306.4,316.4,420.56000000000006,243.32,9,12,27,1
2008_07_PIT_CIN,CIN,PIT,7,2008,175,84,250,125,259,375,245.33333333333334,309,318.125,305.4,1,10,11,7
2008_07_SD_BUF,BUF,LAC,7,2008,261,109,208,72,370,280,335.8,346.6666666666667,395.2,314.2083333333333,16,19,26,10
2008_07_SEA_TB,TB,SEA,7,2008,310,97,73,103,407,176,351.1666666666667,289,332.1666666666667,345.48,21,7,14,16
2008_07_SF_NYG,NYG,SF,7,2008,161,112,256,35,273,291,427.8,328.8333333333333,269.6,360.3333333333333,28,13,3,22
2008_07_TEN_KC,KC,TEN,7,2008,235,58,123,332,293,455,275.8,289,342.2,305.8,4,7,15,8
2008_08_ARI_CAR,CAR,ARI,8,2008,248,113,391,50,361,441,333,377,409.14285714285717,409.3333333333333,14,24,27,28
2008_08_ATL_PHI,PHI,ATL,8,2008,253,192,277,77,445,354,360.3333333333333,357,328.8333333333333,349.3333333333333,22,19,12,18
2008_08_BUF_MIA,MIA,BUF,8,2008,314,52,227,119,366,346,358.8333333333333,341.5,313.6666666666667,335.5555555555556,20,18,7,14
2008_08_CIN_HOU,HOU,CIN,8,2008,280,109,155,105,389,260,384.8333333333333,247.28571428571428,289,318.42857142857144,25,1,6,10
2008_08_CLE_JAX,JAX,CLE,8,2008,283,113,246,91,396,337,326.3333333333333,264.3333333333333,402.6666666666667,365.75,13,2,25,21
2008_08_IND_TEN,TEN,IND,8,2008,193,88,223,94,281,317,316.6666666666667,325.1666666666667,278.6666666666667,339.0833333333333,9,12,5,16
2008_08_KC_NYJ,NYJ,KC,8,2008,290,135,280,80,425,360,336.8333333333333,278.6666666666667,314.6666666666667,316.6666666666667,16,5,8,9
2008_08_NYG_PIT,PIT,NYG,8,2008,189,95,199,83,284,282,320,402,247.61111111111111,322.52777777777777,10,27,1,11
2008_08_OAK_BAL,BAL,LV,8,2008,183,173,228,47,356,275,313.6666666666667,314.6666666666667,358.8333333333333,336.8333333333333,7,8,19,15
2008_08_SD_NO,NO,LAC,8,2008,339,70,341,110,409,451,409.14285714285717,337.14285714285717,333,340.6857142857143,28,17,13,17
2008_08_SEA_SF,SF,SEA,8,2008,304,124,222,39,428,261,323.42857142857144,270.1666666666667,405.6857142857143,360.47222222222223,11,3,26,20
2008_08_STL_NE,NE,LA,8,2008,267,98,301,90,365,391,335.3333333333333,276,384.3888888888889,400.77777777777777,15,4,22,24
2008_08_TB_DAL,DAL,TB,8,2008,122,70,227,49,192,276,402,359.14285714285717,273.8,272.85714285714283,27,21,4,3
2008_08_WAS_DET,DET,WAS,8,2008,223,57,328,135,280,463,289,366,384.8333333333333,265.0857142857143,6,23,23,2
2008_09_ARI_STL,LA,ARI,9,2008,186,61,342,177,247,519,292.42857142857144,386.14285714285717,339.57142857142856,337,6,27,16,14
2008_09_ATL_OAK,LV,ATL,9,2008,31,67,220,252,98,472,309,356.57142857142856,319.7142857142857,372.42857142857144,7,19,9,24
2008_09_BAL_CLE,CLE,BAL,9,2008,219,64,248,193,283,441,274.7142857142857,319.7142857142857,336.2857142857143,309,3,10,13,6
2008_09_DAL_NYG,NYG,DAL,9,2008,147,200,134,81,347,215,384.85714285714283,375.75,314.85714285714283,348.75,25,23,8,19
2008_09_DET_CHI,CHI,DET,9,2008,166,154,292,53,320,345,347.42857142857144,287.7142857142857,357.85714285714283,379.85714285714283,16,4,22,26
2008_09_GB_TEN,TEN,GB,9,2008,180,178,314,102,358,416,311.57142857142856,340.14285714285717,324,325.8285714285715,8,14,10,11
2008_09_HOU_MIN,MIN,HOU,9,2008,182,177,363,62,359,425,357.85714285714283,385.42857142857144,347.42857142857144,249.10204081632654,20,26,18,1
2008_09_JAX_CIN,CIN,JAX,9,2008,162,159,229,68,321,297,248.875,336.2857142857143,385.35416666666663,274.7142857142857,1,12,28,2
2008_09_MIA_DEN,DEN,MIA,9,2008,307,14,281,75,321,356,387,359.85714285714283,332.2857142857143,342.14285714285717,28,21,12,17
2008_09_NE_IND,IND,NE,9,2008,254,47,202,140,301,342,324,339.57142857142856,311.57142857142856,292.42857142857144,11,13,7,5
2008_09_NYJ_BUF,BUF,NYJ,9,2008,289,30,201,96,319,297,342.14285714285717,349.42857142857144,359.85714285714283,290.2857142857143,15,18,23,4
2008_09_PHI_SEA,SEA,PHI,9,2008,169,86,349,72,255,421,268.85714285714283,372.42857142857144,338.3673469387755,356.57142857142856,2,22,15,21
2008_09_PIT_WAS,WAS,PIT,9,2008,206,60,179,64,266,243,378.125,314.85714285714283,287.875,384.85714285714283,24,9,3,27
2008_09_TB_KC,KC,TB,9,2008,201,183,342,81,384,423,290.2857142857143,348.75,349.42857142857144,375.75,5,17,20,25
2008_10_BAL_HOU,HOU,BAL,10,2008,294,75,199,162,369,361,390.375,334.875,358,275.75,26,11,18,4
2008_10_BUF_NE,NE,BUF,10,2008,234,144,120,60,378,180,339.875,339.25,321.125,342.875,15,14,9,13
2008_10_CAR_OAK,LV,CAR,10,2008,147,147,72,162,294,234,282.625,336.5,371,385,3,13,22,25
2008_10_DEN_CLE,CLE,DEN,10,2008,239,160,447,123,399,570,275.75,378.75,334.875,359.375,2,24,10,20
2008_10_GB_MIN,MIN,GB,10,2008,151,220,142,74,371,216,358,349.625,390.375,317.375,20,18,26,8
2008_10_IND_PIT,PIT,IND,10,2008,284,55,240,62,339,302,305.875,321.125,364.109375,339.875,7,9,21,12
2008_10_JAX_DET,DET,JAX,10,2008,198,103,238,157,301,395,294.875,331.375,344,257.890625,5,10,14,1
2008_10_KC_SD,LAC,KC,10,2008,316,92,266,76,408,342,351.375,302,409.125,358.03125,19,6,28,19
2008_10_NO_ATL,ATL,NO,10,2008,248,113,422,105,361,527,371,409.125,282.625,351.375,22,28,5,16
2008_10_NYG_PHI,PHI,NYG,10,2008,194,106,191,219,300,410,378.5,380.125,267.125,355.65625,23,25,2,17
2008_10_SEA_MIA,MIA,SEA,10,2008,209,155,185,126,364,311,359.375,267.125,378.75,378.5,21,1,24,23
2008_10_SF_ARI,ARI,SF,10,2008,328,46,217,119,374,336,402.75,336.5,286.75,269.02083333333337,27,13,6,3
2008_10_STL_NYJ,NYJ,LA,10,2008,167,206,135,80,373,215,342.875,286.75,339.25,402.75,16,4,11,27
2008_10_TEN_CHI,CHI,TEN,10,2008,173,78,289,20,251,309,344,317.375,294.875,349.625,17,8,7,15
2008_11_ARI_SEA,SEA,ARI,11,2008,170,43,395,76,213,471,272,399.55555555555554,359.8888888888889,336.44444444444446,2,30,24,17
2008_11_BAL_NYG,NYG,BAL,11,2008,153,207,164,121,360,285,383.44444444444446,337.77777777777777,369.77777777777777,388,28,16,25,29
2008_11_CHI_GB,GB,CHI,11,2008,227,200,159,83,427,242,334.77777777777777,333.6666666666667,359.44444444444446,316.44444444444446,14,13,23,10
2008_11_CLE_BUF,BUF,CLE,11,2008,148,186,185,161,334,346,321.55555555555554,289.44444444444446,344.1111111111111,400,11,5,20,31
2008_11_DAL_WAS,WAS,DAL,11,2008,162,92,198,117,254,315,365.6666666666667,357.8888888888889,306.87301587301585,380.6507936507936,25,22,8,27
2008_11_DEN_ATL,ATL,DEN,11,2008,250,114,216,124,364,340,369.8888888888889,400,422.22222222222223,289.44444444444446,27,31,32,4
2008_11_DET_CAR,CAR,DET,11,2008,98,264,207,130,362,337,325.1111111111111,295.55555555555554,283.8888888888889,338.44444444444446,12,6,3,19
2008_11_HOU_IND,IND,HOU,11,2008,320,154,192,177,474,369,319,388,309.55555555555554,337.77777777777777,10,29,9,18
2008_11_MIN_TB,TB,MIN,11,2008,255,108,138,99,363,237,357,359.44444444444446,300.6984126984127,334.77777777777777,20,23,6,16
2008_11_NO_KC,KC,NO,11,2008,235,124,266,103,359,369,306.44444444444446,422.22222222222223,357.6666666666667,369.8888888888889,7,32,22,26
2008_11_NYJ_NE,NE,NYJ,11,2008,400,125,258,140,525,398,344.1111111111111,346.22222222222223,321.55555555555554,278.77777777777777,18,19,12,2
2008_11_OAK_MIA,MIA,LV,11,2008,174,222,156,70,396,226,359.8888888888889,283.8888888888889,272,325.1111111111111,24,4,1,13
2008_11_PHI_CIN,CIN,PHI,11,2008,261,56,339,68,317,407,256.8888888888889,369.77777777777777,331.92063492063494,383.44444444444446,1,26,14,28
2008_11_SD_PIT,PIT,LAC,11,2008,308,124,159,66,432,225,309.55555555555554,357.6666666666667,319,306.44444444444446,8,21,11,7
2008_11_STL_SF,SF,LA,11,2008,213,135,295,126,348,421,336.44444444444446,278.77777777777777,399.55555555555554,346.22222222222223,15,3,30,21
2008_11_TEN_JAX,JAX,TEN,11,2008,135,140,230,114,275,344,338.44444444444446,316.44444444444446,295.55555555555554,333.6666666666667,17,9,5,15
2008_12_BUF_KC,KC,BUF,12,2008,316,159,273,171,475,444,311.7,322.8,416.9,295.1,7,10,32,5
2008_12_CAR_ATL,ATL,CAR,12,2008,259,133,295,134,392,429,369.3,328.8,394,299.7,26,12,30,6
2008_12_CHI_STL,LA,CHI,12,2008,236,14,139,201,250,340,293,324.5,337.6,344,4,11,16,17
2008_12_CIN_PIT,PIT,CIN,12,2008,243,121,168,43,364,211,321.8,262.9,344.4,373.5,9,1,18,27
2008_12_GB_NO,NO,GB,12,2008,323,98,248,109,421,357,416.9,344,311.7,324.5,32,17,7,11
2008_12_HOU_CLE,CLE,HOU,12,2008,145,95,275,112,240,387,295.1,386.1,322.8,334.5,5,29,10,15
2008_12_IND_SD,LAC,IND,12,2008,288,120,255,91,408,346,344.4,334.5,321.8,386.1,18,15,9,29
2008_12_MIN_JAX,JAX,MIN,12,2008,317,35,120,122,352,242,332.1,347.2,319.2,357.6,13,19,8,23
2008_12_NE_MIA,MIA,NE,12,2008,341,62,415,122,403,537,363.5,362.2,278.1,351.4,25,24,3,20
2008_12_NYG_ARI,ARI,NYG,12,2008,351,23,240,87,374,327,406.7,381.1,266.1,332.5,31,28,2,14
2008_12_NYJ_TEN,TEN,NYJ,12,2008,243,45,224,192,288,416,319.2,351.4,332.1,362.2,8,20,13,24
2008_12_OAK_DEN,DEN,LV,12,2008,204,115,160,158,319,318,394,278.1,369.3,363.5,30,3,26,25
2008_12_PHI_BAL,BAL,PHI,12,2008,183,110,132,86,293,218,332.5,373.5,381.1,262.9,14,27,28,1
2008_12_SF_DAL,DAL,SF,12,2008,341,74,303,26,415,329,353.6,337.6,354.5,293,21,16,22,4
2008_12_TB_DET,DET,TB,12,2008,134,108,165,119,242,284,299.7,357.6,328.8,347.2,6,23,12,19
2008_12_WAS_SEA,SEA,WAS,12,2008,103,139,206,187,242,393,266.1,354.5,406.7,353.6,2,22,31,21
2008_13_ARI_PHI,PHI,ARI,13,2008,260,185,235,25,445,260,359.3636363636364,403.72727272727275,328.90909090909093,376.1818181818182,24,31,11,27
2008_13_ATL_SD,LAC,ATL,13,2008,149,70,207,141,219,348,350.1818181818182,371.3636363636364,335.54545454545456,337.90909090909093,19,26,14,17
2008_13_BAL_CIN,CIN,BAL,13,2008,124,57,312,147,181,459,258.1818181818182,328.90909090909093,325.6363636363636,359.3636363636364,1,11,8,24
2008_13_CAR_GB,GB,CAR,13,2008,298,145,177,130,443,307,345.1818181818182,337.90909090909093,417.27272727272725,371.3636363636364,18,17,32,26
2008_13_CHI_MIN,MIN,CHI,13,2008,210,178,153,103,388,256,337.6363636363636,325.90909090909093,333.90909090909093,289.09090909090907,16,9,13,4
2008_13_DEN_NYJ,NYJ,DEN,13,2008,247,142,357,127,389,484,357.27272727272725,387.1818181818182,316.3636363636364,281.72727272727275,21,30,7,3
2008_13_IND_CLE,CLE,IND,13,2008,110,101,125,90,211,215,290.09090909090907,335.54545454545456,386.1818181818182,350.1818181818182,5,14,29,19
2008_13_JAX_HOU,HOU,JAX,13,2008,200,126,287,126,326,413,386.1818181818182,333.90909090909093,290.09090909090907,337.6363636363636,29,13,5,16
2008_13_KC_OAK,LV,KC,13,2008,132,139,162,145,271,307,281.72727272727275,326.54545454545456,387.1818181818182,333.8181818181818,3,10,30,12
2008_13_MIA_STL,LA,MIA,13,2008,149,129,178,149,278,327,289.09090909090907,367.09090909090907,325.90909090909093,378.09090909090907,4,25,9,28
2008_13_NO_TB,TB,NO,13,2008,119,149,296,44,268,340,350.90909090909093,417.27272727272725,294.45454545454544,345.1818181818182,20,32,6,18
2008_13_NYG_WAS,WAS,NYG,13,2008,249,92,305,108,341,413,358,376.1818181818182,263.90909090909093,403.72727272727275,22,27,2,31
2008_13_PIT_NE,NE,PIT,13,2008,169,122,179,161,291,340,378.09090909090907,325.6363636363636,367.09090909090907,258.1818181818182,28,8,25,1
2008_13_SEA_DAL,DAL,SEA,13,2008,331,116,287,80,447,367,359.1818181818182,263.90909090909093,336.8181818181818,358,23,2,15,22
2008_13_SF_BUF,BUF,SF,13,2008,205,156,161,62,361,223,333.8181818181818,336.8181818181818,326.54545454545456,359.1818181818182,12,15,10,23
2008_13_TEN_DET,DET,TEN,13,2008,154,23,181,292,177,473,294.45454545454544,316.3636363636364,350.90909090909093,357.27272727272725,6,7,20,21
2008_14_ATL_NO,NO,ATL,14,2008,230,184,315,99,414,414,410.8333333333333,369.4166666666667,344,339.25,32,26,19,15
2008_14_CIN_IND,IND,CIN,14,2008,277,57,200,82,334,282,325.5,251.75,283.49999999999994,339.75000000000006,9,1,4,16
2008_14_CLE_TEN,TEN,CLE,14,2008,155,235,150,35,390,185,329.4166666666667,283.49999999999994,284.6666666666667,325.5,12,4,5,9
2008_14_DAL_PIT,PIT,DAL,14,2008,204,70,210,95,274,305,326.8333333333333,366.5,370.8333333333333,272.50000000000006,10,25,27,2
2008_14_HOU_GB,GB,HOU,14,2008,295,108,414,141,403,555,353.3333333333333,381.1666666666667,335.33333333333337,340.50000000000006,20,29,13,17
2008_14_JAX_CHI,CHI,JAX,14,2008,219,86,178,119,305,297,320.08333333333337,340.50000000000006,341.8333333333333,381.1666666666667,7,17,18,29
2008_14_KC_DEN,DEN,KC,14,2008,286,139,187,83,425,270,395.25,324.9166666666667,359.9166666666667,280.8333333333333,31,8,22,3
2008_14_MIA_BUF,BUF,MIA,14,2008,123,84,181,115,207,296,336.0833333333333,363.75,327.3333333333333,288.16666666666663,14,23,11,6
2008_14_MIN_DET,DET,MIN,14,2008,220,76,175,130,296,305,284.6666666666667,341.8333333333333,329.4166666666667,320.08333333333337,5,18,12,7
2008_14_NE_SEA,SEA,NE,14,2008,212,134,268,84,346,352,272.50000000000006,370.8333333333333,366.5,326.8333333333333,2,27,25,10
2008_14_NYJ_SF,SF,NYJ,14,2008,285,100,137,59,385,196,327.3333333333333,359.9166666666667,336.0833333333333,395.25,11,22,14,31
2008_14_OAK_SD,LAC,LV,14,2008,214,158,129,54,372,183,339.25,280.8333333333333,369.4166666666667,324.9166666666667,15,3,26,8
2008_14_PHI_NYG,NYG,PHI,14,2008,123,88,191,144,211,335,379.25,366.5,356.5833333333333,391.75,28,25,21,30
2008_14_STL_ARI,ARI,LA,14,2008,279,63,228,85,342,313,391.75,288.16666666666663,366.5,363.75,30,6,25,23
2008_14_TB_CAR,CAR,TB,14,2008,173,299,321,86,472,407,335.33333333333337,344,353.3333333333333,410.8333333333333,13,19,20,32
2008_14_WAS_BAL,BAL,WAS,14,2008,134,147,218,62,281,280,339.75000000000006,356.5833333333333,251.75,379.25,16,21,1,28
2008_15_BUF_NYJ,NYJ,BUF,15,2008,207,165,148,187,372,335,347.3076923076923,326.15384615384613,331.7692307692308,358.53846153846155,19,11,12,23
2008_15_CLE_PHI,PHI,CLE,15,2008,290,134,156,57,424,213,364.0769230769231,275.92307692307685,366.3076923076923,334.0769230769231,25,3,26,13
2008_15_DEN_CAR,CAR,DEN,15,2008,253,147,172,121,400,293,345.84615384615387,397.53846153846155,348.84615384615387,320.6923076923077,18,31,20,8
2008_15_DET_IND,IND,DET,15,2008,318,106,233,90,424,323,326.15384615384613,285.53846153846155,254.07692307692307,339,11,5,1,16
2008_15_GB_JAX,JAX,GB,15,2008,238,94,278,84,332,362,337.15384615384625,357.15384615384613,318.9230769230769,394.53846153846155,15,22,7,30
2008_15_MIN_ARI,ARI,MIN,15,2008,298,43,163,239,341,402,387.9230769230769,339,290.07692307692304,285.53846153846155,29,16,6,5
2008_15_NE_OAK,LV,NE,15,2008,242,116,218,277,358,495,273.3076923076923,369.38461538461536,341.7692307692308,278.15384615384625,2,27,17,4
2008_15_NO_CHI,CHI,NO,15,2008,172,55,232,119,227,351,318.9230769230769,411.0769230769231,337.15384615384625,372.84615384615387,7,32,15,28
2008_15_NYG_DAL,DAL,NYG,15,2008,244,100,191,72,344,263,361.7692307692308,366.3076923076923,322.7692307692308,364.0769230769231,24,26,9,25
2008_15_PIT_BAL,BAL,PIT,15,2008,115,112,246,91,227,337,335.2307692307693,322.7692307692308,350.6923076923077,361.7692307692308,14,9,21,24
2008_15_SD_KC,KC,LAC,15,2008,175,102,346,68,277,414,320.6923076923077,341.7692307692308,397.53846153846155,273.3076923076923,8,17,31,2
2008_15_SEA_STL,LA,SEA,15,2008,218,131,226,125,349,351,290.07692307692304,278.15384615384625,387.9230769230769,369.38461538461536,6,4,29,27
2008_15_SF_MIA,MIA,SF,15,2008,156,98,233,112,254,345,358.53846153846155,331.7692307692308,326.15384615384613,347.3076923076923,23,12,11,19
2008_15_TB_ATL,ATL,TB,15,2008,206,175,269,99,381,368,372.84615384615387,348.84615384615387,411.0769230769231,345.84615384615387,28,20,32,18
2008_15_TEN_HOU,HOU,TEN,15,2008,284,107,181,100,391,281,394.53846153846155,334.0769230769231,357.15384615384613,275.92307692307685,30,13,22,3
2008_15_WAS_CIN,CIN,WAS,15,2008,209,106,167,113,315,280,254.07692307692307,350.6923076923077,326.15384615384613,335.2307692307693,1,21,11,14
2008_16_ARI_NE,NE,ARI,16,2008,343,183,168,44,526,212,378.35714285714283,384.57142857142856,279.35714285714283,343.5,28,29,3,16
2008_16_ATL_MIN,MIN,ATL,16,2008,233,155,134,98,388,232,343.5,373.42857142857144,384.57142857142856,350.2142857142857,16,27,29,21
2008_16_BAL_DAL,DAL,BAL,16,2008,252,92,149,265,344,414,360.5,327.50000000000006,358.92857142857144,323.7857142857143,25,11,24,9
2008_16_BUF_DEN,DEN,BUF,16,2008,359,181,193,87,540,280,390.07142857142856,326.7857142857143,349.7142857142857,349.07142857142856,30,10,20,19
2008_16_CAR_NYG,NYG,CAR,16,2008,181,301,185,158,482,343,358.92857142857144,349.7142857142857,360.5,390.07142857142856,24,20,25,30
2008_16_CIN_CLE,CLE,CIN,16,2008,76,137,55,191,213,246,271.4285714285714,258.42857142857144,368.35714285714283,345.64285714285717,2,1,26,17
2008_16_GB_CHI,CHI,GB,16,2008,142,74,260,65,216,325,312.35714285714283,357.5,406.7857142857143,336.78571428571433,7,23,32,15
2008_16_HOU_OAK,LV,HOU,16,2008,236,139,255,90,375,345,279.35714285714283,394.2857142857143,378.35714285714283,330.2857142857143,3,31,28,12
2008_16_IND_JAX,JAX,IND,16,2008,329,105,364,32,434,396,336.78571428571433,333.14285714285717,357.5,288.2142857142857,15,14,23,5
2008_16_MIA_KC,KC,MIA,16,2008,320,180,235,168,500,403,317.57142857142856,351.07142857142856,346.92857142857144,332.7142857142857,8,22,18,13
2008_16_NO_DET,DET,NO,16,2008,137,129,351,181,266,532,288.2142857142857,406.7857142857143,333.14285714285717,312.35714285714283,5,32,14,7
2008_16_NYJ_SEA,SEA,NYJ,16,2008,175,120,187,115,295,302,283.35714285714295,349.07142857142856,294.2857142857143,326.7857142857143,4,19,6,10
2008_16_PHI_WAS,WAS,PHI,16,2008,144,122,230,62,266,292,345.64285714285717,368.35714285714283,258.42857142857144,271.4285714285714,17,26,1,2
2008_16_PIT_TEN,TEN,PIT,16,2008,216,117,331,71,333,402,330.2857142857143,323.7857142857143,394.2857142857143,327.50000000000006,12,9,31,11
2008_16_SD_TB,TB,LAC,16,2008,232,111,287,90,343,377,350.2142857142857,346.92857142857144,373.42857142857144,317.57142857142856,21,18,27,8
2008_16_SF_STL,LA,SF,16,2008,233,129,216,83,362,299,294.2857142857143,332.7142857142857,283.35714285714295,351.07142857142856,6,13,4,22
2008_17_CAR_NO,NO,CAR,17,2008,386,50,250,234,436,484,415.1333333333333,349.26666666666665,286.73333333333335,367.1333333333333,32,20,5,27
2008_17_CHI_HOU,HOU,CHI,17,2008,328,127,244,69,455,313,391,305.93333333333334,285.73333333333335,355.3333333333333,30,7,4,23
2008_17_CLE_PIT,PIT,CLE,17,2008,193,176,26,106,369,132,329,267.5333333333333,330.46666666666664,257.6,9,2,12,1
2008_17_DAL_PHI,PHI,DAL,17,2008,175,137,233,87,312,320,363.26666666666665,359.4,340.3333333333333,333.2666666666667,25,24,15,13
2008_17_DEN_SD,LAC,DEN,17,2008,207,289,316,90,496,406,348.93333333333334,400.06666666666666,349.73333333333335,323.6666666666667,19,31,21,8
2008_17_DET_GB,GB,DET,17,2008,308,211,225,96,519,321,355.3333333333333,286.73333333333335,305.93333333333334,415.1333333333333,23,5,7,32
2008_17_JAX_BAL,BAL,JAX,17,2008,322,127,127,118,449,245,333.2666666666667,343.2666666666667,359.4,337.3333333333333,13,16,24,14
2008_17_KC_CIN,CIN,KC,17,2008,129,204,191,31,333,222,257.6,329.73333333333335,267.5333333333333,354.53333333333336,1,10,2,22
2008_17_MIA_NYJ,NYJ,MIA,17,2008,251,80,200,126,331,326,345.93333333333334,354.53333333333336,284.13333333333344,329.73333333333335,17,22,3,10
2008_17_NE_BUF,BUF,NE,17,2008,128,161,78,168,289,246,323.6666666666667,388.2,400.06666666666666,373.06666666666666,8,29,31,28
2008_17_NYG_MIN,MIN,NYG,17,2008,239,110,229,135,349,364,346.46666666666664,367.1333333333333,364,349.26666666666665,18,27,26,20
2008_17_OAK_TB,TB,LV,17,2008,257,125,148,192,382,340,349.73333333333335,285.73333333333335,348.93333333333334,391,21,4,19,30
2008_17_SEA_ARI,ARI,SEA,17,2008,346,111,250,87,457,337,373.06666666666666,284.13333333333344,388.2,345.93333333333334,28,3,29,17
2008_17_STL_ATL,ATL,LA,17,2008,160,263,230,202,423,432,364,298.8,346.46666666666664,330.46666666666664,26,6,18,12
2008_17_TEN_IND,IND,TEN,17,2008,273,121,62,83,394,145,337.3333333333333,330.46666666666664,343.2666666666667,329,14,12,16,9
2008_17_WAS_SF,SF,WAS,17,2008,245,121,156,125,366,281,330.46666666666664,340.3333333333333,298.8,363.26666666666665,12,15,6,25
2008_18_ATL_ARI,ARI,ATL,18,2008,271,86,199,60,357,259,378.3125,367.6875,287.4375000000001,307.125,8,7,1,2
2008_18_BAL_MIA,MIA,BAL,18,2008,252,52,135,151,304,286,352.75,340.50000000000006,345,337.12500000000006,4,1,5,4
2008_18_IND_SD,LAC,IND,18,2008,217,167,310,64,384,374,358.125,340.875,400.4375,318.875,5,2,8,3
2008_18_PHI_MIN,MIN,PHI,18,2008,164,148,300,67,312,367,346.625,360.0625,366.9375,356.9375,3,6,7,6
2008_19_ARI_CAR,CAR,ARI,19,2008,205,75,220,145,280,365,357.6875,377.05882352941177,416.4375,361.29411764705884,4,8,8,7
2008_19_BAL_TEN,TEN,BAL,19,2008,281,116,161,50,397,211,318.875,337.2941176470589,340.875,349.88235294117646,1,3,2,6
2008_19_PHI_NYG,NYG,PHI,19,2008,169,138,217,59,307,276,366.9375,360.47058823529414,346.625,344.5882352941176,7,6,5,4
2008_19_SD_PIT,PIT,LAC,19,2008,181,165,308,15,346,323,331.5,359.6470588235294,259.0625,342.8235294117647,2,5,1,3
2008_20_BAL_PIT,PIT,BAL,20,2008,255,52,141,73,307,214,332.3529411764706,330.27777777777783,357.49134948096884,323.21527777777777,2,1,3,1
2008_20_PHI_ARI,ARI,PHI,20,2008,279,102,375,97,381,472,376.3888888888889,355.77777777777777,353.37152777777777,363.6076388888889,4,3,2,4
2008_21_PIT_ARI,ARI,PIT,21,2008,377,33,256,58,410,314,376.63157894736844,330.94444444444446,361.89473684210526,323.8179012345679,2,1,2,1
2009_01_BUF_NE,NE,BUF,1,2009,378,73,212,90,451,302,0,0,0,0,32,32,32,32
2009_01_CHI_GB,GB,CHI,1,2009,184,76,277,86,260,363,0,0,0,0,32,32,32,32
2009_01_DAL_TB,TB,DAL,1,2009,276,174,353,118,450,471,0,0,0,0,32,32,32,32
2009_01_DEN_CIN,CIN,DEN,1,2009,247,86,243,75,333,318,0,0,0,0,32,32,32,32
2009_01_DET_NO,NO,DET,1,2009,358,157,205,33,515,238,0,0,0,0,32,32,32,32
2009_01_JAX_IND,IND,JAX,1,2009,301,71,122,114,372,236,0,0,0,0,32,32,32,32
2009_01_KC_BAL,BAL,KC,1,2009,307,198,177,29,505,206,0,0,0,0,32,32,32,32
2009_01_MIA_ATL,ATL,MIA,1,2009,229,68,176,96,297,272,0,0,0,0,32,32,32,32
2009_01_MIN_CLE,CLE,MIN,1,2009,205,89,110,225,294,335,0,0,0,0,32,32,32,32
2009_01_NYJ_HOU,HOU,NYJ,1,2009,166,38,272,190,204,462,0,0,0,0,32,32,32,32
2009_01_PHI_CAR,CAR,PHI,1,2009,138,86,102,185,224,287,0,0,0,0,32,32,32,32
2009_01_SD_OAK,LV,LAC,1,2009,225,148,252,77,373,329,0,0,0,0,32,32,32,32
2009_01_SF_ARI,ARI,SF,1,2009,288,40,209,21,328,230,0,0,0,0,32,32,32,32
2009_01_STL_SEA,SEA,LA,1,2009,279,167,191,77,446,268,0,0,0,0,32,32,32,32
2009_01_TEN_PIT,PIT,TEN,1,2009,363,36,244,86,399,330,0,0,0,0,32,32,32,32
2009_01_WAS_NYG,NYG,WAS,1,2009,256,103,211,85,359,296,0,0,0,0,32,32,32,32
2009_02_ARI_JAX,JAX,ARI,2,2009,282,92,265,118,374,383,236,328,372,230,5,16,23,4
2009_02_BAL_SD,LAC,BAL,2,2009,436,53,190,130,489,320,329,505,373,206,17,31,24,2
2009_02_CAR_ATL,ATL,CAR,2,2009,220,151,308,144,371,452,297,224,272,287,13,3,9,10
2009_02_CIN_GB,GB,CIN,2,2009,261,89,185,151,350,336,260,333,363,318,7,19,22,15
2009_02_CLE_DEN,DEN,CLE,2,2009,263,186,161,54,449,215,318,294,333,335,15,11,19,20
2009_02_HOU_TEN,TEN,HOU,2,2009,216,240,357,63,456,420,330,204,399,462,18,1,25,29
2009_02_IND_MIA,MIA,IND,2,2009,183,239,303,61,422,364,272,372,297,236,9,23,13,5
2009_02_MIN_DET,DET,MIN,2,2009,152,129,169,112,281,281,238,335,515,294,6,20,32,11
2009_02_NE_NYJ,NYJ,NE,2,2009,163,117,216,83,280,299,462,451,204,302,29,28,1,14
2009_02_NO_PHI,PHI,NO,2,2009,391,85,311,133,476,444,287,515,224,238,10,32,3,6
2009_02_NYG_DAL,DAL,NYG,2,2009,127,251,330,97,378,427,471,359,450,296,30,21,27,12
2009_02_OAK_KC,KC,LV,2,2009,241,173,109,67,414,176,206,373,505,329,2,24,31,17
2009_02_PIT_CHI,CHI,PIT,2,2009,236,43,221,105,279,326,363,399,260,330,22,25,7,18
2009_02_SEA_SF,SF,SEA,2,2009,144,256,224,66,400,290,230,446,328,268,4,26,16,8
2009_02_STL_WAS,WAS,LA,2,2009,242,125,125,126,367,251,296,268,359,446,12,8,21,26
2009_02_TB_BUF,BUF,TB,2,2009,230,218,296,57,448,353,302,450,451,471,14,27,28,30
2009_03_ATL_NE,NE,ATL,3,2009,277,168,199,58,445,257,375,334,371,338,23,13,21,15
2009_03_CAR_DAL,DAL,CAR,3,2009,255,212,220,73,467,293,424.5,338,393,334,31,15,27,13
2009_03_CHI_SEA,SEA,CHI,3,2009,261,103,247,85,364,332,368,321,315,362.5,20,11,10,18
2009_03_CLE_BAL,BAL,CLE,3,2009,346,142,126,71,488,197,412.5,254.5,409,383.5,30,1,29,25
2009_03_DEN_OAK,LV,DEN,3,2009,61,95,157,215,156,372,274.5,383.5,310,254.5,4,25,8,1
2009_03_GB_STL,LA,GB,3,2009,187,149,269,152,336,421,259.5,305,331.5,334.5,3,6,12,14
2009_03_IND_ARI,ARI,IND,3,2009,339,24,379,126,363,505,355.5,368,305,347,17,20,6,16
2009_03_JAX_HOU,HOU,JAX,3,2009,300,111,214,184,411,398,312,305,393,355.5,9,6,27,17
2009_03_KC_PHI,PHI,KC,3,2009,327,93,116,99,420,215,381.5,310,479.5,274.5,24,8,32,4
2009_03_MIA_SD,LAC,MIA,3,2009,303,69,146,149,372,295,409,347,412.5,368,29,16,30,20
2009_03_NO_BUF,BUF,NO,3,2009,181,89,172,222,270,394,375,479.5,401.5,381.5,23,32,28,24
2009_03_NYG_TB,TB,NYG,3,2009,58,28,171,226,86,397,401.5,393,375,424.5,28,27,23,31
2009_03_PIT_CIN,CIN,PIT,3,2009,183,100,276,102,283,378,334.5,362.5,305,321,14,18,6,11
2009_03_SF_MIN,MIN,SF,3,2009,301,94,195,58,395,253,308,315,259.5,368,7,10,3,20
2009_03_TEN_NYJ,NYJ,TEN,3,2009,171,83,170,127,254,297,371,393,375,312,21,27,23,9
2009_03_WAS_DET,DET,WAS,3,2009,241,154,340,65,395,405,259.5,331.5,308,259.5,3,12,7,3
2009_04_BAL_NE,NE,BAL,4,2009,258,85,264,116,343,380,398.3333333333333,437.6666666666667,308.3333333333333,235.33333333333334,24,26,7,2
2009_04_BUF_MIA,MIA,BUF,4,2009,115,250,192,46,365,238,329.6666666666667,340,396.6666666666667,451,10,14,26,28
2009_04_CIN_CLE,CLE,CIN,4,2009,269,146,230,154,415,384,235.33333333333334,317.3333333333333,437.6666666666667,367.6666666666667,2,8,27,22
2009_04_DAL_DEN,DEN,DAL,4,2009,243,116,255,74,359,329,379.6666666666667,438.6666666666667,235,323,21,27,1,9
2009_04_DET_CHI,CHI,DET,4,2009,141,151,350,90,292,440,324.6666666666667,304.6666666666667,366.6666666666667,356,9,7,21,18
2009_04_GB_MIN,MIN,GB,4,2009,271,63,384,82,334,466,337,343.6666666666667,294.3333333333333,285,13,15,4,3
2009_04_NYG_KC,KC,NYG,4,2009,127,105,292,156,232,448,278.3333333333333,394.3333333333333,394.3333333333333,296.3333333333333,3,22,25,5
2009_04_NYJ_NO,NO,NYJ,4,2009,190,153,138,132,343,270,451,332,340,361,28,11,15,20
2009_04_OAK_HOU,HOU,LV,4,2009,224,120,128,45,344,173,345,235,336,379.6666666666667,16,1,13,23
2009_04_SD_PIT,PIT,LAC,4,2009,339,177,254,16,516,270,367.6666666666667,396.6666666666667,317.3333333333333,329.6666666666667,20,23,8,11
2009_04_SEA_IND,IND,SEA,4,2009,353,78,257,49,431,306,413.6666666666667,366.6666666666667,358,324.6666666666667,25,19,19,10
2009_04_STL_SF,SF,LA,4,2009,152,96,108,95,248,203,294.3333333333333,285,337,343.6666666666667,5,4,14,16
2009_04_TB_WAS,WAS,TB,4,2009,170,125,106,129,295,235,356,296.3333333333333,304.6666666666667,394.3333333333333,17,6,6,25
2009_04_TEN_JAX,JAX,TEN,4,2009,323,137,284,95,460,379,336,361,345,332,12,18,17,12
2009_05_ATL_SF,SF,ATL,5,2009,198,100,329,148,298,477,282.75,308.3333333333333,264.5,398.3333333333333,6,7,2,21
2009_05_CIN_BAL,BAL,CIN,5,2009,186,82,271,142,268,413,423.25,334,384.5,280.25,28,11,20,5
2009_05_CLE_BUF,BUF,CLE,5,2009,152,145,23,171,297,194,314.5,280.25,338.5,334,8,4,11,10
2009_05_DAL_KC,KC,DAL,5,2009,253,72,351,150,325,501,266.75,411.25,407.75,374.5,3,26,22,19
2009_05_HOU_ARI,ARI,HOU,5,2009,302,44,371,45,346,416,358,344.75,413.6666666666667,219.5,18,16,24,1
2009_05_IND_TEN,TEN,IND,5,2009,164,90,309,58,254,367,365.5,418,367,351.5,19,27,17,14
2009_05_JAX_SEA,SEA,JAX,5,2009,241,143,190,38,384,228,351.5,367,418,365.5,17,20,25,16
2009_05_MIN_STL,LA,MIN,5,2009,297,122,300,89,419,389,264.5,336.25,282.75,374.25,2,12,7,18
2009_05_NE_DEN,DEN,NE,5,2009,330,103,215,96,433,311,374.5,384.5,411.25,423.25,21,22,23,26
2009_05_NYJ_MIA,MIA,NYJ,5,2009,262,151,172,138,413,310,338.5,316.5,314.5,424,14,9,8,27
2009_05_OAK_NYG,NYG,LV,5,2009,263,220,100,60,483,160,407.75,219.5,266.75,344.75,25,1,3,13
2009_05_PIT_DET,DET,PIT,5,2009,282,110,277,82,392,359,338.5,404.75,316.5,365,14,24,9,15
2009_05_TB_PHI,PHI,TB,5,2009,265,76,240,85,341,325,394.3333333333333,281,278.3333333333333,340.75,23,5,4,12
2009_05_WAS_CAR,CAR,WAS,5,2009,181,86,145,74,267,219,323,340.75,438.6666666666667,281,10,15,28,6
2009_06_ARI_SEA,SEA,ARI,6,2009,154,14,292,62,168,354,358,355,339.2,362.5625,18,17,12,19
2009_06_BAL_MIN,MIN,BAL,6,2009,278,167,385,81,445,466,346.8,392.2,295.4,349.8,13,25,5,15
2009_06_BUF_NYJ,NYJ,BUF,6,2009,119,318,159,142,437,301,315.2,311,353.4,263,8,7,16,2
2009_06_CAR_TB,TB,CAR,6,2009,147,124,65,267,271,332,289.8,309,383.66666666666663,310.3125,4,6,21,6
2009_06_CHI_ATL,ATL,CHI,6,2009,185,68,300,83,253,383,350.5,316.5,286.5625,338.5,16,10,3,11
2009_06_CLE_PIT,PIT,CLE,6,2009,417,140,122,91,557,213,395.6,263,349.2,311,26,2,14,7
2009_06_DEN_SD,LAC,DEN,6,2009,274,73,229,101,347,330,365,386.2,404.75,369.8,20,24,25,20
2009_06_DET_GB,GB,DET,6,2009,358,107,105,78,465,183,374.25,349.2,336.25,395.6,22,14,10,24
2009_06_HOU_CIN,CIN,HOU,6,2009,259,46,392,87,305,479,349.8,359,392.2,355.6,15,19,23,17
2009_06_KC_WAS,WAS,KC,6,2009,164,118,186,110,282,296,316.4,278.4,311.8,429.2,9,3,8,28
2009_06_NYG_NO,NO,NYG,6,2009,369,133,250,84,502,334,424,422.8,316.5,207.6,28,27,9,1
2009_06_PHI_OAK,LV,PHI,6,2009,224,116,269,67,340,336,207.6,381,422.8,292,1,23,27,4
2009_06_STL_JAX,JAX,LA,6,2009,335,166,213,55,501,268,339.2,295.4,358,346.8,11,5,18,13
2009_06_TEN_NE,NE,TEN,6,2009,432,193,-7,193,625,186,369.8,343.2,386.2,407.8,21,12,22,26
2009_07_ARI_NYG,NYG,ARI,7,2009,243,107,231,72,350,303,408,354.8,437,320,22,15,26,12
2009_07_ATL_DAL,DAL,ATL,7,2009,311,115,198,124,426,322,429.2,331,278.4,329.8,25,11,3,13
2009_07_BUF_CAR,CAR,BUF,7,2009,325,116,123,53,441,176,313.6,309.3333333333333,286.04,335.5,9,7,5,15
2009_07_CHI_CIN,CIN,CHI,7,2009,233,215,254,35,448,289,342.3333333333333,329.8,379,331,13,10,22,14
2009_07_GB_CLE,CLE,GB,7,2009,99,58,258,202,157,460,254.66666666666666,392.4,422.5,315.96,2,20,25,10
2009_07_IND_STL,LA,IND,7,2009,140,155,235,156,295,391,290.8333333333333,407.8,366.1666666666667,343.2,6,21,19,18
2009_07_MIN_PIT,PIT,MIN,7,2009,175,106,334,89,281,423,422.5,363.1666666666667,254.66666666666666,404.5,24,17,2,23
2009_07_NE_TB,TB,NE,7,2009,172,89,308,107,261,415,286.6666666666667,412.3333333333333,312.8333333333333,317,5,23,8,11
2009_07_NO_MIA,MIA,NO,7,2009,211,137,298,138,348,436,353.4,439.6,315.2,405.04,14,26,9,24
2009_07_NYJ_OAK,LV,NYJ,7,2009,158,119,143,316,277,459,229.66666666666666,335.5,373.5,309.3333333333333,1,12,20,6
2009_07_PHI_WAS,WAS,PHI,7,2009,284,62,161,122,346,283,310.6666666666667,372,281.3333333333333,234.08,8,18,4,1
2009_07_SD_KC,KC,LAC,7,2009,100,121,268,135,221,403,281.3333333333333,361.4,310.6666666666667,374.96,3,16,7,21
2009_07_SF_HOU,HOU,SF,7,2009,264,90,251,59,354,310,379,285.8,342.3333333333333,342.06666666666666,19,4,17,16
2009_08_ATL_NO,NO,ATL,8,2009,308,146,289,161,454,450,439,329.5,352.5,428.6666666666667,26,10,12,25
2009_08_CAR_ARI,ARI,CAR,8,2009,242,94,90,270,336,360,346.1666666666667,334.8333333333333,398.3333333333333,287.1111111111111,12,11,20,4
2009_08_CLE_CHI,CHI,CLE,8,2009,225,170,85,117,395,202,323,240.71428571428572,359.9444444444444,402.0571428571428,8,2,15,21
2009_08_DEN_BAL,BAL,DEN,8,2009,175,125,152,66,300,218,404.5,376.8333333333333,363.1666666666667,362,23,20,17,16
2009_08_HOU_BUF,BUF,HOU,8,2009,117,97,268,186,214,454,290.2857142857143,375.42857142857144,331.80000000000007,289.25714285714287,4,19,10,5
2009_08_JAX_TEN,TEN,JAX,8,2009,125,305,139,217,430,356,317,366.1666666666667,412.3333333333333,290.8333333333333,6,16,24,6
2009_08_MIA_NYJ,NYJ,MIA,8,2009,265,127,112,52,392,164,353.14285714285717,352.5,236.42857142857142,439,14,13,1,26
2009_08_MIN_GB,GB,MIN,8,2009,290,90,244,111,380,355,403.6666666666667,371.7142857142857,238.38888888888889,402.2857142857143,22,18,2,22
2009_08_NYG_PHI,PHI,NYG,8,2009,240,180,222,141,420,363,357.1666666666667,399.7142857142857,316.5555555555556,347.40000000000003,15,21,8,11
2009_08_OAK_SD,LAC,LV,8,2009,249,100,109,99,349,208,368.3333333333333,236.42857142857142,271.27777777777777,353.14285714285717,17,1,3,13
2009_08_SEA_DAL,DAL,SEA,8,2009,256,113,249,79,369,328,428.6666666666667,326.3333333333333,329.5,354.8333333333333,25,9,9,14
2009_08_SF_IND,IND,SF,8,2009,369,61,198,113,430,311,405,289.8333333333333,291.52777777777777,374.8333333333333,24,3,7,18
2009_08_STL_DET,DET,LA,8,2009,168,127,212,150,295,362,321.5,291.42857142857144,389.375,405.40000000000003,7,5,19,23
2009_09_ARI_CHI,CHI,ARI,9,2009,369,70,261,182,439,443,333.2857142857143,344.7142857142857,235.18367346938774,338.42857142857144,9,11,2,10
2009_09_BAL_CIN,CIN,BAL,9,2009,224,146,195,55,370,250,357.42857142857144,389.57142857142856,323.9714285714286,354.14285714285717,14,19,7,13
2009_09_CAR_NO,NO,CAR,9,2009,330,84,201,182,414,383,441.14285714285717,338.42857142857144,346.7142857142857,344.7142857142857,26,10,12,11
2009_09_DAL_PHI,PHI,DAL,9,2009,227,89,307,76,316,383,366.14285714285717,420.14285714285717,394.46938775510205,326.57142857142856,17,25,22,8
2009_09_DET_SEA,SEA,DET,9,2009,344,55,203,114,399,317,326.57142857142856,317.7142857142857,420.14285714285717,301.51020408163265,7,5,25,6
2009_09_GB_TB,TB,GB,9,2009,205,81,266,170,286,436,283,400.2857142857143,412.7142857142857,369.3265306122449,2,21,24,19
2009_09_HOU_IND,IND,HOU,9,2009,318,72,311,81,390,392,408.57142857142856,385.25,292.85714285714283,280.75,23,18,5,3
2009_09_KC_JAX,JAX,KC,9,2009,264,173,262,60,437,322,364.7142857142857,272.7142857142857,333.14285714285717,367.3428571428571,15,1,9,18
2009_09_MIA_NE,NE,MIA,9,2009,332,109,220,133,441,353,412.7142857142857,325.57142857142856,283,358.6938775510204,24,6,4,14
2009_09_PIT_DEN,DEN,PIT,9,2009,221,27,233,173,248,406,354.14285714285717,402.2857142857143,389.57142857142856,371.7142857142857,13,22,21,20
2009_09_SD_NYG,NYG,LAC,9,2009,215,116,209,34,331,243,395.125,365.57142857142856,365.02083333333337,232.36734693877548,20,16,17,1
2009_09_TEN_SF,SF,TEN,9,2009,286,108,172,152,394,324,292.85714285714283,333.14285714285717,408.57142857142856,364.7142857142857,3,8,23,16
2009_09_WAS_ATL,ATL,WAS,9,2009,135,181,208,136,316,344,346.7142857142857,315.7142857142857,441.14285714285717,359.2857142857143,12,4,26,15
2009_10_ATL_CAR,CAR,ATL,10,2009,195,185,224,176,380,400,344,342.875,437.75,319.25,15,14,30,6
2009_10_BAL_CLE,CLE,BAL,10,2009,99,86,155,134,185,289,235.875,372.125,332,359,2,23,10,17
2009_10_BUF_TEN,TEN,BUF,10,2009,210,168,218,89,378,307,332,280.75,305.5,385.25,11,4,3,22
2009_10_CHI_SF,SF,CHI,10,2009,118,110,307,43,228,350,305.5,346.5,332,357,7,16,10,16
2009_10_CIN_PIT,PIT,CIN,10,2009,174,80,178,61,254,239,402.75,359,340.875,372.125,25,20,12,20
2009_10_DAL_GB,GB,DAL,10,2009,189,105,251,61,294,312,404.75,415.5,283.375,359.875,26,28,2,18
2009_10_DEN_WAS,WAS,DEN,10,2009,228,174,206,120,402,326,319.25,340.875,342.875,402.75,9,13,13,26
2009_10_DET_MIN,MIN,DET,10,2009,344,152,224,93,496,317,369.625,317.625,400.70833333333337,335.625,22,8,25,11
2009_10_JAX_NYJ,NYJ,JAX,10,2009,212,110,221,139,322,360,358,373.75,328.9375,278.875,19,24,7,1
2009_10_KC_OAK,LV,KC,10,2009,113,182,216,112,295,328,232.875,278.875,365.91666666666663,373.75,1,3,19,21
2009_10_NE_IND,IND,NE,10,2009,327,91,375,113,418,488,406.25,416.25,386.09375,329,27,29,23,8
2009_10_NO_STL,LA,NO,10,2009,298,141,223,203,439,426,300.25,437.75,318.1875,344,6,30,5,14
2009_10_PHI_SD,LAC,PHI,10,2009,231,119,450,29,350,479,350.25,359.875,387.109375,415.5,17,21,24,28
2009_10_SEA_ARI,ARI,SEA,10,2009,340,122,331,164,462,495,357,335.625,346.5,317.625,18,12,15,4
2009_10_TB_MIA,MIA,TB,10,2009,175,199,196,122,374,318,329,283.375,416.25,404.75,10,5,29,27
2009_11_ARI_STL,LA,ARI,11,2009,215,123,277,183,338,460,315.6666666666667,368.6666666666667,436.44444444444446,353.3333333333333,7,21,32,19
2009_11_ATL_NYG,NYG,ATL,11,2009,384,88,268,90,472,358,388,349.22222222222223,351.95238095238096,348,27,16,18,15
2009_11_BUF_JAX,JAX,BUF,11,2009,215,102,297,53,317,350,372.22222222222223,283.6666666666667,354,337.1111111111111,22,3,20,11
2009_11_CIN_OAK,LV,CIN,11,2009,183,92,207,177,275,384,239.77777777777777,345.6666666666667,284.3333333333333,386.22222222222223,2,13,4,26
2009_11_CLE_DET,DET,CLE,11,2009,422,57,314,131,479,445,317.55555555555554,230.22222222222223,383.6666666666667,362.8888888888889,8,1,25,21
2009_11_IND_BAL,BAL,IND,11,2009,256,98,299,76,354,375,362.8888888888889,407.55555555555554,230.22222222222223,424.22222222222223,20,30,1,31
2009_11_MIA_CAR,CAR,MIA,11,2009,227,182,172,154,409,326,348,334,349.22222222222223,287.22222222222223,15,10,16,5
2009_11_NO_TB,TB,NO,11,2009,126,119,187,183,245,370,287.22222222222223,436.44444444444446,334,315.6666666666667,5,32,10,7
2009_11_NYJ_NE,NE,NYJ,11,2009,310,111,136,104,421,240,424.22222222222223,354,407.55555555555554,372.22222222222223,31,19,30,23
2009_11_PHI_CHI,CHI,PHI,11,2009,171,126,244,157,297,401,346.8888888888889,373.1111111111111,296.8888888888889,350.22222222222223,14,23,6,17
2009_11_PIT_KC,KC,PIT,11,2009,248,68,415,114,316,529,284.3333333333333,386.22222222222223,239.77777777777777,345.6666666666667,4,26,2,13
2009_11_SD_DEN,DEN,LAC,11,2009,181,115,145,203,296,348,339.22222222222223,350.22222222222223,328.44444444444446,373.1111111111111,12,17,9,24
2009_11_SEA_MIN,MIN,SEA,11,2009,290,160,231,4,450,235,383.6666666666667,353.3333333333333,317.55555555555554,368.6666666666667,24,18,8,22
2009_11_SF_GB,GB,SF,11,2009,344,158,227,69,502,296,392.44444444444446,296.8888888888889,404,346.8888888888889,28,6,28,14
2009_11_TEN_HOU,HOU,TEN,11,2009,305,57,116,228,362,344,386,337.1111111111111,406.5079365079365,283.6666666666667,25,11,29,3
2009_11_WAS_DAL,DAL,WAS,11,2009,158,153,256,78,311,334,404,328.44444444444446,392.44444444444446,339.22222222222223,29,9,27,12
2009_12_ARI_TEN,TEN,ARI,12,2009,387,163,220,75,550,295,337.8,377.8,383.6,317.9,12,23,24,7
2009_12_CAR_NYJ,NYJ,CAR,12,2009,154,139,130,75,293,205,342.6,354.1,423.9,333.2,15,19,31,9
2009_12_CHI_MIN,MIN,CHI,12,2009,392,159,147,43,551,190,390.3,341.9,341.5,375.9,25,14,13,22
2009_12_CLE_CIN,CIN,CLE,12,2009,110,210,118,58,320,176,349.5,251.7,243.3,333.7,16,2,1,10
2009_12_GB_DET,DET,GB,12,2009,213,73,348,80,286,428,333.7,403.4,251.7,296.8,10,29,2,6
2009_12_IND_HOU,HOU,IND,12,2009,284,122,244,114,406,358,383.6,404.3,337.8,362,24,30,12,20
2009_12_JAX_SF,SF,JAX,12,2009,232,52,307,96,284,403,296.8,366.7,403.4,290.3,6,21,29,5
2009_12_KC_SD,LAC,KC,12,2009,332,94,181,114,426,295,350,287.5,334.9,400.5,17,4,11,28
2009_12_MIA_BUF,BUF,MIA,12,2009,246,129,175,157,375,332,290.3,333.2,366.7,354.1,5,9,21,19
2009_12_NE_NO,NO,NE,12,2009,371,113,256,122,484,378,429.8,423.9,283,342.6,32,31,3,15
2009_12_NYG_DEN,DEN,NYG,12,2009,245,138,230,57,383,287,334.9,396.4,350,350.1,11,27,17,18
2009_12_OAK_DAL,DAL,LV,12,2009,309,195,200,124,504,324,394.7,243.3,329,349.5,26,1,8,16
2009_12_PIT_BAL,BAL,PIT,12,2009,289,132,145,153,421,298,362,400.5,404.3,287.5,20,28,30,4
2009_12_SEA_STL,LA,SEA,12,2009,282,113,102,170,395,272,317.9,341.5,377.8,390.3,7,13,23,25
2009_12_TB_ATL,ATL,TB,12,2009,258,75,250,73,333,323,350.1,283,396.4,429.8,18,3,27,32
2009_12_WAS_PHI,PHI,WAS,12,2009,260,123,231,82,383,313,375.9,329,341.9,394.7,22,8,14,26
2009_13_BAL_GB,GB,BAL,13,2009,263,94,137,66,357,203,405.6363636363636,367.3636363636364,329.3636363636364,391.1818181818182,30,20,10,26
2009_13_DAL_NYG,NYG,DAL,13,2009,241,100,392,45,341,437,386.45454545454544,404.6363636363636,339.27272727272725,250.63636363636363,25,28,14,2
2009_13_DEN_KC,KC,DEN,13,2009,134,94,180,245,228,425,288.1818181818182,339.27272727272725,356.90909090909093,386.45454545454544,4,14,18,25
2009_13_DET_CIN,CIN,DET,13,2009,220,119,192,80,339,272,346.8181818181818,329.3636363636364,244.8181818181818,405.6363636363636,16,10,1,30
2009_13_HOU_JAX,JAX,HOU,13,2009,238,107,240,68,345,308,370,385.6363636363636,295.6363636363636,400.09090909090907,21,24,5,27
2009_13_MIN_ARI,ARI,MIN,13,2009,285,113,275,62,398,337,370.27272727272725,404.90909090909093,357.09090909090907,328.09090909090907,22,29,19,9
2009_13_NE_MIA,MIA,NE,13,2009,335,88,352,96,423,448,333.09090909090907,419.72727272727275,298,434.72727272727275,11,31,6,32
2009_13_NO_WAS,WAS,NO,13,2009,367,88,419,55,455,474,327.54545454545456,434.72727272727275,376.54545454545456,419.72727272727275,8,32,23,31
2009_13_NYJ_BUF,BUF,NYJ,13,2009,98,123,118,249,221,367,298,338.09090909090907,333.09090909090907,340.54545454545456,6,13,11,15
2009_13_OAK_PIT,PIT,LV,13,2009,278,132,308,109,410,417,391.1818181818182,250.63636363636363,367.3636363636364,404.6363636363636,26,2,20,28
2009_13_PHI_ATL,ATL,PHI,13,2009,235,61,286,103,296,389,348.54545454545456,376.54545454545456,286.6363636363636,327.54545454545456,17,23,3,8
2009_13_SD_CLE,CLE,LAC,13,2009,271,115,394,91,386,485,244.8181818181818,356.90909090909093,346.8181818181818,288.1818181818182,1,18,16,4
2009_13_SF_SEA,SEA,SF,13,2009,205,107,310,53,312,363,335.1818181818182,295.6363636363636,324.90909090909093,370,12,5,7,21
2009_13_STL_CHI,CHI,LA,13,2009,143,120,113,135,263,248,328.09090909090907,324.90909090909093,404.90909090909093,335.1818181818182,9,7,29,12
2009_13_TB_CAR,CAR,TB,13,2009,161,157,321,154,318,475,340.54545454545456,286.6363636363636,338.09090909090907,348.54545454545456,15,3,13,17
2009_13_TEN_IND,IND,TEN,13,2009,270,88,241,142,358,383,400.09090909090907,357.09090909090907,385.6363636363636,370.27272727272725,27,19,24,22
2009_14_ARI_SF,SF,ARI,14,2009,144,189,178,85,333,263,301.25,372.5833333333333,333.25,399.25,5,22,10,28
2009_14_BUF_KC,KC,BUF,14,2009,224,152,86,200,376,286,283.1666666666667,291.5833333333333,346.4166666666667,340.49999999999994,3,4,17,13
2009_14_CAR_NE,NE,CAR,14,2009,192,185,197,126,377,323,422.0833333333333,338.6666666666667,340.5833333333333,302.3333333333333,31,12,14,6
2009_14_CIN_MIN,MIN,CIN,14,2009,192,142,103,119,334,222,399.25,346.1666666666667,372.5833333333333,324.5833333333333,28,16,22,9
2009_14_DEN_IND,IND,DEN,14,2009,220,92,277,95,312,372,396.5833333333333,346.4166666666667,359.25,283.1666666666667,27,17,19,3
2009_14_DET_BAL,BAL,DET,14,2009,240,308,135,103,548,238,353.6666666666667,324.5833333333333,401.5833333333333,346.1666666666667,18,9,29,16
2009_14_GB_CHI,CHI,GB,14,2009,209,59,180,146,268,326,322.66666666666663,401.5833333333333,318.50000000000006,353.6666666666667,8,29,7,18
2009_14_MIA_JAX,JAX,MIA,14,2009,139,95,220,146,234,366,367.9166666666667,340.5833333333333,379.1666666666667,422.0833333333333,21,14,24,31
2009_14_NO_ATL,ATL,NO,14,2009,303,89,296,95,392,391,344.1666666666667,438,377.5833333333333,338.1666666666667,15,32,23,11
2009_14_NYJ_TB,TB,NYJ,14,2009,93,43,138,175,136,313,302.3333333333333,340.49999999999994,338.6666666666667,291.5833333333333,6,13,12,4
2009_14_PHI_NYG,NYG,PHI,14,2009,391,133,307,77,524,384,382.6666666666667,377.5833333333333,407.3333333333333,344.1666666666667,25,23,30,15
2009_14_PIT_CLE,CLE,PIT,14,2009,90,171,201,75,261,276,256.5833333333333,392.75,367.5833333333333,264.5,1,26,20,2
2009_14_SD_DAL,DAL,LAC,14,2009,249,108,272,73,357,345,407.3333333333333,367.5833333333333,382.6666666666667,256.5833333333333,30,20,25,1
2009_14_SEA_HOU,HOU,SEA,14,2009,365,85,247,62,450,309,379.1666666666667,333.25,367.9166666666667,301.25,24,10,21,5
2009_14_STL_TEN,TEN,LA,14,2009,286,160,157,88,446,245,359.25,318.50000000000006,396.5833333333333,322.66666666666663,19,7,27,8
2009_14_WAS_OAK,LV,WAS,14,2009,227,65,222,100,292,322,264.5,338.1666666666667,392.75,438,2,11,26,32
2009_15_ARI_DET,DET,ARI,15,2009,136,161,233,117,297,350,317.9230769230769,364.15384615384613,368.61538461538464,303.6923076923077,8,19,22,6
2009_15_ATL_NYJ,NYJ,ATL,15,2009,226,99,152,86,325,238,338.3846153846153,347.84615384615387,289.53846153846155,434.38461538461536,14,16,3,32
2009_15_CHI_BAL,BAL,CHI,15,2009,244,124,102,122,368,224,368.61538461538464,318.46153846153845,317.9230769230769,395.7692307692308,22,9,8,29
2009_15_CIN_SD,LAC,CIN,15,2009,308,70,314,114,378,428,365.84615384615387,336.61538461538464,403.46153846153845,394.2307692307692,20,11,30,28
2009_15_CLE_KC,KC,CLE,15,2009,331,168,66,351,499,417,290.3076923076923,256.9230769230769,291.15384615384613,383.7692307692308,4,1,5,24
2009_15_DAL_NO,NO,DAL,15,2009,298,65,312,145,363,457,434.38461538461536,403.46153846153845,347.84615384615387,365.84615384615387,32,30,16,20
2009_15_GB_PIT,PIT,GB,15,2009,503,65,383,60,568,443,383.7692307692308,395.7692307692308,256.9230769230769,318.46153846153845,24,29,1,9
2009_15_HOU_STL,LA,HOU,15,2009,173,88,367,52,261,419,312.8461538461539,384.61538461538464,365.9230769230769,331.38461538461536,7,25,21,10
2009_15_IND_JAX,JAX,IND,15,2009,223,139,308,61,362,369,357.61538461538464,390.0769230769231,342.53846153846155,348.38461538461536,18,26,15,17
2009_15_MIA_TEN,TEN,MIA,15,2009,236,128,349,121,364,470,365.9230769230769,342.53846153846155,312.8461538461539,357.61538461538464,21,15,7,18
2009_15_MIN_CAR,CAR,MIN,15,2009,299,124,224,41,423,265,337.46153846153845,394.2307692307692,418.61538461538464,336.61538461538464,13,28,31,11
2009_15_NE_BUF,BUF,NE,15,2009,177,105,115,109,282,224,291.15384615384613,418.61538461538464,290.3076923076923,337.46153846153845,5,31,4,13
2009_15_NYG_WAS,WAS,NYG,15,2009,249,89,295,114,338,409,336.9230769230769,393.53846153846155,266.61538461538464,378.0769230769231,12,27,2,23
2009_15_OAK_DEN,DEN,LV,15,2009,278,80,115,241,358,356,348.38461538461536,266.61538461538464,390.0769230769231,336.9230769230769,17,2,26,12
2009_15_SF_PHI,PHI,SF,15,2009,306,116,177,107,422,284,378.0769230769231,303.6923076923077,393.53846153846155,364.15384615384613,23,6,27,19
2009_15_TB_SEA,SEA,TB,15,2009,256,128,205,134,384,339,331.38461538461536,289.53846153846155,384.61538461538464,338.3846153846153,10,3,25,14
2009_16_BAL_PIT,PIT,BAL,16,2009,259,48,166,175,307,341,396.92857142857144,368.57142857142856,399.14285714285717,311.7142857142857,28,22,29,8
2009_16_BUF_ATL,ATL,BUF,16,2009,250,157,146,40,407,186,340,290.49999999999994,337.4285714285714,404.7142857142857,13,3,12,30
2009_16_CAR_NYG,NYG,CAR,16,2009,296,60,171,247,356,418,394.64285714285717,343.57142857142856,337,385,27,15,11,24
2009_16_DAL_WAS,WAS,DAL,16,2009,199,43,286,108,242,394,337,407.2857142857143,394.64285714285717,429.2857142857143,11,31,27,32
2009_16_DEN_PHI,PHI,DEN,16,2009,322,105,189,70,427,259,381.2142857142857,349.07142857142856,302.2857142857143,273.00000000000006,23,16,5,2
2009_16_DET_SF,SF,DET,16,2009,230,84,181,114,314,295,302.2857142857143,316.42857142857144,381.2142857142857,363.14285714285717,5,9,23,19
2009_16_HOU_MIA,MIA,HOU,16,2009,322,60,286,126,382,412,351.64285714285717,387.07142857142856,365.7857142857143,309.1428571428572,17,25,20,7
2009_16_JAX_NE,NE,JAX,16,2009,267,197,185,98,464,283,404.7142857142857,357.92857142857144,290.49999999999994,388.57142857142856,30,18,3,26
2009_16_KC_CIN,CIN,KC,16,2009,139,144,180,123,283,303,343.14285714285717,305.2142857142857,366.7142857142857,268.35714285714283,14,6,21,1
2009_16_MIN_CHI,CHI,MIN,16,2009,273,105,321,123,378,444,311.7142857142857,385,368.57142857142856,343.57142857142856,8,24,22,15
2009_16_NYJ_IND,IND,NYJ,16,2009,236,64,106,202,300,308,388.57142857142856,337.4285714285714,357.92857142857144,340,26,12,18,13
2009_16_OAK_CLE,CLE,LV,16,2009,121,164,333,88,285,421,268.35714285714283,273.00000000000006,305.2142857142857,349.07142857142856,1,2,6,16
2009_16_SD_TEN,TEN,LAC,16,2009,89,182,264,166,271,430,365.7857142857143,366.7142857142857,351.64285714285717,343.14285714285717,20,21,17,14
2009_16_SEA_GB,GB,SEA,16,2009,273,153,198,115,426,313,399.14285714285717,335.14285714285717,396.92857142857144,293.07142857142856,29,10,28,4
2009_16_STL_ARI,ARI,LA,16,2009,313,110,171,88,423,259,363.14285714285717,309.1428571428572,316.42857142857144,387.07142857142856,19,7,9,25
2009_16_TB_NO,NO,TB,16,2009,258,124,271,176,382,447,429.2857142857143,293.07142857142856,407.2857142857143,335.14285714285717,32,4,31,10
2009_17_ATL_TB,TB,ATL,17,2009,174,38,223,183,212,406,303.3333333333333,344.46666666666664,426.1333333333333,283.53333333333325,5,15,32,3
2009_17_BAL_OAK,LV,BAL,17,2009,282,51,102,240,333,342,282.86666666666673,366.73333333333335,269.46666666666664,390.93333333333334,2,20,1,27
2009_17_CHI_DET,DET,CHI,17,2009,262,100,276,150,362,426,315,316.1333333333333,303.06666666666666,388.93333333333334,8,9,4,26
2009_17_CIN_NYJ,NYJ,CIN,17,2009,63,257,31,72,320,103,335.4666666666666,339.1333333333333,382.6666666666667,305.06666666666666,12,13,23,6
2009_17_GB_ARI,ARI,GB,17,2009,139,48,242,109,187,351,367.1333333333333,400.93333333333334,305.80000000000007,333.6666666666667,21,29,7,11
2009_17_IND_BUF,BUF,IND,17,2009,155,248,134,25,403,159,283.53333333333325,382.6666666666667,344.46666666666664,335.4666666666666,3,23,15,12
2009_17_JAX_CLE,CLE,JAX,17,2009,86,214,202,131,300,333,269.46666666666664,352.93333333333334,282.86666666666673,408.6666666666667,1,17,2,31
2009_17_KC_DEN,DEN,KC,17,2009,431,84,207,317,515,524,343.06666666666666,305.06666666666666,384.26666666666665,339.1333333333333,14,6,24,13
2009_17_NE_HOU,HOU,NE,17,2009,303,144,257,74,447,331,388.73333333333335,408.6666666666667,353.6666666666667,352.93333333333334,25,31,18,17
2009_17_NO_CAR,CAR,NO,17,2009,162,178,102,111,340,213,348.53333333333336,426.1333333333333,392.06666666666666,303.3333333333333,16,32,28,5
2009_17_NYG_MIN,MIN,NYG,17,2009,358,129,167,35,487,202,388.93333333333334,392.06666666666666,316.1333333333333,348.53333333333336,26,28,9,16
2009_17_PHI_DAL,DAL,PHI,17,2009,311,179,223,37,490,260,406.4,384.26666666666665,330.6666666666667,343.06666666666666,30,24,10,14
2009_17_PIT_MIA,MIA,PIT,17,2009,223,99,220,202,322,422,353.6666666666667,390.93333333333334,388.73333333333335,366.73333333333335,18,27,25,20
2009_17_SF_STL,LA,SF,17,2009,80,87,222,125,167,347,305.80000000000007,303.06666666666666,367.1333333333333,315,7,4,21,8
2009_17_TEN_SEA,SEA,TEN,17,2009,192,140,171,133,332,304,333.6666666666667,359.46666666666664,400.93333333333334,370.93333333333334,11,19,29,22
2009_17_WAS_SD,LAC,WAS,17,2009,315,50,281,64,365,345,370.93333333333334,330.6666666666667,359.46666666666664,406.4,22,10,19,30
2009_18_BAL_NE,NE,BAL,18,2009,154,64,34,234,218,268,403.8125,365.1875,392.375,286.00000000000006,7,4,6,1
2009_18_GB_ARI,ARI,GB,18,2009,379,156,422,90,535,512,355.875,397.8125,397.8125,355.875,3,6,7,4
2009_18_NYJ_CIN,CIN,NYJ,18,2009,146,171,182,171,317,353,324.375,334.49999999999994,334.49999999999994,324.375,1,2,3,2
2009_18_PHI_DAL,DAL,PHI,18,2009,244,198,306,56,442,362,411.625,376.5,376.5,411.625,8,5,5,8
2009_19_ARI_NO,NO,ARI,19,2009,247,171,266,101,418,367,412.8125,366.4117647058824,348,404.52941176470586,7,3,4,8
2009_19_BAL_IND,IND,BAL,19,2009,246,42,189,87,288,276,368.6875,359.47058823529414,290.99999999999994,392.88235294117646,4,2,1,7
2009_19_DAL_MIN,MIN,DAL,19,2009,234,109,198,92,343,290,395.0625,413.4117647058824,380.1875,375.6470588235294,6,8,6,5
2009_19_NYJ_SD,LAC,NYJ,19,2009,298,61,100,169,359,269,370.5625,335.58823529411757,331.5625,323.94117647058823,5,1,3,2
2009_20_MIN_NO,NO,MIN,20,2009,197,68,310,165,265,475,413.11764705882354,392,366.4463667820069,406.15224913494814,4,3,2,4
2009_20_NYJ_IND,IND,NYJ,20,2009,377,101,302,86,478,388,363.94117647058823,331.8888888888888,354.56055363321803,369.9201388888889,2,1,1,3
2009_21_NO_IND,IND,NO,21,2009,333,99,288,51,432,339,370.27777777777777,404.8888888888889,335.00617283950606,396.6111111111111,1,2,1,2
2010_01_ARI_STL,LA,ARI,1,2010,253,85,297,112,338,409,0,0,0,0,32,32,32,32
2010_01_ATL_PIT,PIT,ATL,1,2010,236,143,252,58,379,310,0,0,0,0,32,32,32,32
2010_01_BAL_NYJ,NYJ,BAL,1,2010,74,116,248,49,190,297,0,0,0,0,32,32,32,32
2010_01_CAR_NYG,NYG,CAR,1,2010,263,118,182,89,381,271,0,0,0,0,32,32,32,32
2010_01_CIN_NE,NE,CIN,1,2010,258,118,345,87,376,432,0,0,0,0,32,32,32,32
2010_01_CLE_TB,TB,CLE,1,2010,182,119,236,104,301,340,0,0,0,0,32,32,32,32
2010_01_DAL_WAS,WAS,DAL,1,2010,171,89,282,103,260,385,0,0,0,0,32,32,32,32
2010_01_DEN_JAX,JAX,DEN,1,2010,170,134,295,89,304,384,0,0,0,0,32,32,32,32
2010_01_DET_CHI,CHI,DET,1,2010,372,101,171,17,473,188,0,0,0,0,32,32,32,32
2010_01_GB_PHI,PHI,GB,1,2010,199,149,188,132,348,320,0,0,0,0,32,32,32,32
2010_01_IND_HOU,HOU,IND,1,2010,107,257,433,44,364,477,0,0,0,0,32,32,32,32
2010_01_MIA_BUF,BUF,MIA,1,2010,139,50,182,132,189,314,0,0,0,0,32,32,32,32
2010_01_MIN_NO,NO,MIN,1,2010,237,79,171,91,316,262,0,0,0,0,32,32,32,32
2010_01_OAK_TEN,TEN,LV,1,2010,154,205,180,135,359,315,0,0,0,0,32,32,32,32
2010_01_SD_KC,KC,LAC,1,2010,68,135,298,109,203,407,0,0,0,0,32,32,32,32
2010_01_SF_SEA,SEA,SF,1,2010,170,77,225,49,247,274,0,0,0,0,32,32,32,32
2010_02_ARI_ATL,ATL,ARI,2,2010,225,221,164,118,446,282,310,409,379,338,13,29,24,18
2010_02_BAL_CIN,CIN,BAL,2,2010,167,94,154,109,261,263,432,297,376,190,30,10,23,3
2010_02_BUF_GB,GB,BUF,2,2010,255,91,102,124,346,226,320,189,348,314,17,2,20,14
2010_02_CHI_DAL,DAL,CHI,2,2010,374,36,277,38,410,315,385,473,260,188,27,31,6,1
2010_02_HOU_WAS,WAS,HOU,2,2010,426,18,497,58,444,555,260,364,385,477,6,22,27,32
2010_02_JAX_SD,LAC,JAX,2,2010,334,151,293,71,485,364,407,304,203,384,28,12,4,26
2010_02_KC_CLE,CLE,KC,2,2010,229,73,176,140,302,316,340,203,301,407,19,4,11,28
2010_02_MIA_MIN,MIN,MIA,2,2010,225,156,114,120,381,234,262,314,316,189,7,14,16,2
2010_02_NE_NYJ,NYJ,NE,2,2010,220,136,248,52,356,300,190,376,297,432,3,23,10,30
2010_02_NO_SF,SF,NO,2,2010,275,142,254,50,417,304,274,316,247,262,9,16,5,7
2010_02_NYG_IND,IND,NYG,2,2010,255,160,161,120,415,281,477,381,364,271,32,25,22,8
2010_02_PHI_DET,DET,PHI,2,2010,335,115,284,162,450,446,188,348,473,320,1,20,31,17
2010_02_PIT_TEN,TEN,PIT,2,2010,215,46,43,106,261,149,359,379,315,310,21,24,15,13
2010_02_SEA_DEN,DEN,SEA,2,2010,307,65,233,109,372,342,384,247,304,274,26,5,12,9
2010_02_STL_OAK,LV,LA,2,2010,249,173,167,75,422,242,315,338,359,409,15,18,21,29
2010_02_TB_CAR,CAR,TB,2,2010,184,119,178,95,303,273,271,301,381,340,8,11,25,19
2010_03_ATL_NO,NO,ATL,3,2010,365,43,228,202,408,430,310,378,345.5,345.5,12,26,21,21
2010_03_BUF_NE,NE,BUF,3,2010,252,200,247,134,452,381,338,207.5,273,333,19,1,4,17
2010_03_CIN_CAR,CAR,CIN,3,2010,188,87,195,120,275,315,287,346.5,287,280,8,22,8,6
2010_03_CLE_BAL,BAL,CLE,3,2010,256,109,141,173,365,314,280,321,346.5,259.5,6,14,22,2
2010_03_DAL_HOU,HOU,DAL,3,2010,241,124,284,101,365,385,459.5,397.5,352,394,32,29,23,27
2010_03_DET_MIN,MIN,DET,3,2010,201,183,237,63,384,300,321.5,319,274,397,15,13,5,28
2010_03_GB_CHI,CHI,GB,3,2010,221,77,316,63,298,379,394,333,397.5,207.5,27,17,29,1
2010_03_IND_DEN,DEN,IND,3,2010,476,47,325,40,523,365,378,446,294.5,331,26,31,10,16
2010_03_NYJ_MIA,MIA,NYJ,3,2010,363,84,256,146,447,402,274,273,321.5,338,5,4,15,19
2010_03_OAK_ARI,ARI,LV,3,2010,122,119,255,133,241,388,345.5,368.5,378,290,21,24,26,9
2010_03_PHI_JAX,JAX,PHI,3,2010,105,139,291,106,244,397,334,397,446,319,18,28,31,13
2010_03_PIT_TB,TB,PIT,3,2010,251,75,186,201,326,387,287,264,287,310,8,3,8,12
2010_03_SD_SEA,SEA,LAC,3,2010,220,68,455,89,288,544,294.5,446,378,334,10,31,26,18
2010_03_SF_KC,KC,SF,3,2010,250,207,232,43,457,275,259.5,345.5,321,310,2,21,14,12
2010_03_TEN_NYG,NYG,TEN,3,2010,386,107,118,161,493,279,331,310,446,264,16,12,31,3
2010_03_WAS_STL,LA,WAS,3,2010,235,133,236,116,368,352,290,352,368.5,459.5,9,23,24,32
2010_04_ARI_SD,LAC,ARI,4,2010,249,180,146,47,429,193,478.6666666666667,310.6666666666667,292.3333333333333,375,28,8,3,20
2010_04_BAL_PIT,PIT,BAL,4,2010,141,84,256,70,225,326,305,308.3333333333333,300,318.6666666666667,6,7,5,11
2010_04_CAR_NO,NO,CAR,4,2010,275,121,146,118,396,264,342.6666666666667,283,395.3333333333333,336,16,2,24,14
2010_04_CHI_NYG,NYG,CHI,4,2010,195,189,114,59,384,173,385,362,299.6666666666667,348.3333333333333,22,19,4,17
2010_04_CIN_CLE,CLE,CIN,4,2010,184,116,371,67,300,438,318.6666666666667,336,308.3333333333333,283,12,15,7,2
2010_04_DEN_TEN,TEN,DEN,4,2010,173,121,341,19,294,360,299.6666666666667,426.3333333333333,385,419,4,26,22,26
2010_04_DET_GB,GB,DET,4,2010,181,92,331,123,273,454,348.3333333333333,312.6666666666667,362,342.3333333333333,17,9,19,15
2010_04_HOU_OAK,LV,HOU,4,2010,278,118,192,249,396,441,375,428,310.6666666666667,393.3333333333333,20,27,8,23
2010_04_IND_JAX,JAX,IND,4,2010,163,174,352,58,337,410,304,419,397,426.3333333333333,5,25,25,27
2010_04_NE_MIA,MIA,NE,4,2010,317,95,153,119,412,272,331.6666666666667,376,316,265.3333333333333,14,21,10,1
2010_04_NYJ_BUF,BUF,NYJ,4,2010,128,114,171,273,242,444,265.3333333333333,316,376,331.6666666666667,1,11,21,13
2010_04_SEA_STL,LA,SEA,4,2010,289,88,219,64,377,283,316,292.3333333333333,352,478.6666666666667,11,3,18,28
2010_04_SF_ATL,ATL,SF,4,2010,273,98,188,81,371,269,395.3333333333333,322,342.6666666666667,325.3333333333333,23,13,16,12
2010_04_WAS_PHI,PHI,WAS,4,2010,250,110,125,169,360,294,397,352,304,316,24,18,6,10
2010_05_ATL_CLE,CLE,ATL,5,2010,246,48,187,165,294,352,314,389.25,361.5,308.75,9,23,19,8
2010_05_CHI_CAR,CAR,CHI,5,2010,96,85,51,218,181,269,278.25,314.75,356,384.75,2,10,18,21
2010_05_DEN_BAL,BAL,DEN,5,2010,196,233,314,39,429,353,312.75,409.75,285,298.25,8,25,4,6
2010_05_GB_WAS,WAS,GB,5,2010,357,51,293,157,408,450,337.5,329.5,387.75,348,14,12,22,17
2010_05_JAX_BUF,BUF,JAX,5,2010,220,110,178,216,330,394,259.5,312.25,348,416.75,1,7,17,25
2010_05_KC_IND,IND,KC,5,2010,244,97,156,113,341,269,416.75,325.3333333333333,312.25,322,26,11,9,13
2010_05_MIN_NYJ,NYJ,MIN,5,2010,191,155,264,96,346,360,348,342.3333333333333,259.5,312.6666666666667,17,15,1,10
2010_05_NO_ARI,ARI,NO,5,2010,174,41,279,85,215,364,281.25,356,466.25,278.25,3,18,28,2
2010_05_NYG_HOU,HOU,NYG,5,2010,196,24,297,117,220,414,431.25,384.75,380.25,314.75,27,21,20,12
2010_05_PHI_SF,SF,PHI,5,2010,309,74,253,125,383,378,308.75,387.75,389.25,337.5,6,22,23,15
2010_05_SD_OAK,LV,LAC,5,2010,173,111,431,91,284,522,380.25,466.25,431.25,281.25,20,28,27,3
2010_05_STL_DET,DET,LA,5,2010,238,89,215,128,327,343,348,331.25,329.5,290,17,13,14,5
2010_05_TB_CIN,CIN,TB,5,2010,209,149,284,125,358,409,361.5,300,314,305,19,5,11,7
2010_05_TEN_DAL,DAL,TEN,5,2010,406,141,173,158,547,331,393.3333333333333,298.25,428,409.75,24,4,26,24
2010_06_ATL_PHI,PHI,ATL,6,2010,326,154,250,65,480,315,385.8,381.8,323.6,310,22,21,8,5
2010_06_BAL_NE,NE,BAL,6,2010,292,127,285,99,419,384,350,336,351.75,398.4,15,11,17,26
2010_06_CLE_PIT,PIT,CLE,6,2010,257,121,281,69,378,350,285,310,312.75,381.8,1,5,6,21
2010_06_DAL_MIN,MIN,DAL,6,2010,118,95,220,94,213,314,346.75,431.75,347.5,306.4375,13,27,14,4
2010_06_DET_NYG,NYG,DET,6,2010,177,167,313,64,344,377,390.6,343.8,389,333.6,24,12,23,10
2010_06_IND_WAS,WAS,IND,6,2010,246,113,307,170,359,477,351.6,401.6,353.6,314.06666666666666,16,26,18,7
2010_06_KC_HOU,HOU,KC,6,2010,305,132,201,228,437,429,389,311.25,390.6,397.8125,23,6,24,25
2010_06_MIA_GB,GB,MIA,6,2010,313,76,231,150,389,381,353.6,351.75,351.6,350,18,17,16,15
2010_06_NO_TB,TB,NO,6,2010,236,42,263,212,278,475,327.25,357.6,360.625,268,8,19,19,2
2010_06_NYJ_DEN,DEN,NYJ,6,2010,209,145,198,129,354,327,398.4,347.6,336,345.8666666666667,25,14,11,13
2010_06_OAK_SF,SF,LV,6,2010,196,158,83,110,354,193,323.6,361,385.8,477.4,7,20,22,28
2010_06_SD_STL,LA,LAC,6,2010,198,117,249,79,315,328,333.6,477.4,343.8,361,10,28,12,20
2010_06_SEA_CHI,CHI,SEA,6,2010,290,61,242,111,351,353,305.6,290,258.8,331.25,4,2,1,9
2010_06_TEN_JAX,JAX,TEN,6,2010,189,76,171,153,265,324,328.6,304.8,273.6,424.0666666666666,9,3,3,27
2010_07_ARI_SEA,SEA,ARI,7,2010,192,144,132,113,336,245,302.6,268,314.68,357.6,4,2,5,19
2010_07_BUF_BAL,BAL,BUF,7,2010,250,135,382,132,385,514,344,273.6,361.5,328.6,16,3,21,11
2010_07_CIN_ATL,ATL,CIN,7,2010,299,153,412,84,452,496,370.6666666666667,360.8,401.5,321.8,22,20,25,10
2010_07_CLE_NO,NO,CLE,7,2010,356,58,87,125,414,212,377.1666666666667,316.6666666666667,319.0416666666667,300.5,23,8,8,2
2010_07_JAX_KC,KC,JAX,7,2010,193,236,222,84,429,306,334.8,318,398.6,308,15,10,24,4
2010_07_MIN_GB,GB,MIN,7,2010,295,84,212,196,379,408,359.5,320,356.625,408.2,19,11,18,26
2010_07_NE_SD,LAC,NE,7,2010,336,38,159,51,374,210,452.5,363.8,330.5,345.6,28,21,13,16
2010_07_NYG_DAL,DAL,NYG,7,2010,226,41,306,200,267,506,408.2,382.8333333333333,320,349.3333333333333,27,24,9,17
2010_07_OAK_DEN,DEN,LV,7,2010,198,75,204,328,273,532,391,333,344.1666666666667,328.6666666666667,25,14,15,12
2010_07_PHI_TEN,TEN,PHI,7,2010,276,75,231,99,351,330,308,401.5,318,370.6666666666667,6,26,7,22
2010_07_PIT_MIA,MIA,PIT,7,2010,257,64,302,58,321,360,357.6,303.6,360.68,318,18,5,20,7
2010_07_SF_CAR,CAR,SF,7,2010,308,76,196,99,384,295,258.8,328.6666666666667,305.6,333,1,12,3,14
2010_07_STL_TB,TB,LA,7,2010,212,124,126,161,336,287,317.4,330.5,381.08000000000004,452.5,9,13,23,28
2010_07_WAS_CHI,CHI,WAS,7,2010,281,66,200,121,347,321,313.1666666666667,352.8333333333333,300.5,414.1666666666667,7,17,2,27
2010_08_BUF_KC,KC,BUF,8,2010,152,274,223,137,426,360,350.5,313.6666666666667,316,350.8333333333333,16,5,6,15
2010_08_CAR_STL,LA,CAR,8,2010,191,62,194,25,253,219,324.2857142857143,279.6666666666667,320.0571428571428,323.0555555555556,10,2,8,9
2010_08_DEN_SF,SF,DEN,8,2010,196,143,370,59,339,429,323.85714285714283,374.14285714285717,276.6857142857143,361.42857142857144,9,20,2,18
2010_08_GB_NYJ,NYJ,GB,8,2010,256,119,170,81,375,251,344.1666666666667,362.2857142857143,391,332.57142857142856,13,19,23,12
2010_08_HOU_IND,IND,HOU,8,2010,268,107,201,108,375,309,414.1666666666667,397,352.8333333333333,330.875,25,24,17,11
2010_08_JAX_DAL,DAL,JAX,8,2010,379,50,260,149,429,409,384.6666666666667,316.2857142857143,403.3611111111111,348.25714285714287,23,7,25,14
2010_08_MIA_CIN,CIN,MIA,8,2010,156,106,217,137,262,354,383.3333333333333,351.5,384.22222222222223,313,22,17,22,5
2010_08_MIN_NE,NE,MIN,8,2010,240,122,295,125,362,420,338.1666666666667,334.6666666666667,439.4166666666667,362.75,12,11,26,19
2010_08_PIT_NO,NO,PIT,8,2010,305,30,195,108,335,303,382.42857142857144,313,301.7142857142857,351.5,21,4,3,16
2010_08_SEA_OAK,LV,SEA,8,2010,310,239,163,47,549,210,361.42857142857144,308.1666666666667,374.14285714285717,264.1666666666667,18,3,20,1
2010_08_TB_ARI,ARI,TB,8,2010,305,100,278,154,405,432,264.1666666666667,320.5,308.1666666666667,323.25,1,8,4,10
2010_08_TEN_SD,LAC,TEN,8,2010,305,156,305,65,461,370,441.2857142857143,314.14285714285717,341.8285714285715,391.2857142857143,26,6,13,24
2010_08_WAS_DET,DET,WAS,8,2010,212,102,254,80,314,334,349.3333333333333,348.2857142857143,382.8333333333333,318,15,14,21,7
2010_09_ARI_MIN,MIN,ARI,9,2010,446,80,196,53,526,249,346.85714285714283,284.2857142857143,341.57142857142856,336.42857142857144,11,2,11,10
2010_09_CHI_BUF,BUF,CHI,9,2010,299,46,188,105,345,293,320.2857142857143,318,361.2857142857143,348.2857142857143,7,6,18,16
2010_09_DAL_GB,GB,DAL,9,2010,289,138,183,39,427,222,348.375,391,348.02083333333337,329.53061224489795,12,22,15,9
2010_09_IND_PHI,PHI,IND,9,2010,218,195,294,62,413,356,391.2857142857143,408.57142857142856,314.14285714285717,384.42857142857144,23,25,6,23
2010_09_KC_OAK,LV,KC,9,2010,229,112,216,104,341,320,384.875,361.2857142857143,295.89583333333337,320.2857142857143,21,16,2,7
2010_09_MIA_BAL,BAL,MIA,9,2010,279,146,231,73,425,304,349.85714285714283,351.85714285714283,307.9428571428572,366,14,15,3,19
2010_09_NE_CLE,CLE,NE,9,2010,174,230,224,68,404,292,301.7142857142857,341.57142857142856,382.42857142857144,346.85714285714283,4,9,22,14
2010_09_NO_CAR,CAR,NO,9,2010,107,127,253,165,234,418,271,376.5,314.10204081632656,311.75,1,18,5,4
2010_09_NYG_SEA,SEA,NYG,9,2010,113,49,290,197,162,487,294.14285714285717,400.42857142857144,388.2244897959184,388.0285714285714,3,24,25,24
2010_09_NYJ_DET,DET,NYJ,9,2010,240,78,336,110,318,446,344.2857142857143,348.57142857142856,346.2448979591837,346.38775510204084,10,13,12,13
2010_09_PIT_CIN,CIN,PIT,9,2010,248,54,202,121,302,323,366,311.57142857142856,351.85714285714283,375.65306122448976,17,5,17,20
2010_09_SD_HOU,HOU,LAC,9,2010,267,140,295,77,407,372,384.42857142857144,443.75,408.57142857142856,321.125,20,26,26,8
2010_09_TB_ATL,ATL,TB,9,2010,235,130,189,96,365,285,382.2857142857143,336.42857142857144,380.11428571428576,284.2857142857143,19,8,21,1
2010_10_BAL_ATL,ATL,BAL,10,2010,316,60,215,116,376,331,380.125,359.25,330,345.875,23,19,9,13
2010_10_CAR_TB,TB,CAR,10,2010,241,186,191,118,427,309,330,266.375,380.125,381.6875,12,1,20,22
2010_10_CIN_IND,IND,CIN,10,2010,185,76,292,72,261,364,402,358,394,313,27,18,24,4
2010_10_DAL_NYG,NYG,DAL,10,2010,373,107,327,100,480,427,411.25,369.875,277.625,358.203125,28,22,2,15
2010_10_DET_BUF,BUF,DET,10,2010,146,149,323,76,295,399,323.375,341,314.875,360.75,9,14,6,17
2010_10_HOU_JAX,JAX,HOU,10,2010,342,165,314,81,507,395,327.875,387.25,390.20833333333337,434.78125,11,25,23,27
2010_10_KC_DEN,DEN,KC,10,2010,299,153,469,51,452,520,381,356.125,325.75,379.390625,24,17,8,19
2010_10_MIN_CHI,CHI,MIN,10,2010,237,130,170,70,367,240,314.875,369.25,323.375,279.875,6,21,7,3
2010_10_NE_PIT,PIT,NE,10,2010,387,76,350,103,463,453,313,335.375,358,314.5,4,13,14,5
2010_10_NYJ_CLE,CLE,NYJ,10,2010,205,107,299,172,312,471,314.5,360.75,335.375,341,5,20,10,11
2010_10_PHI_WAS,WAS,PHI,10,2010,295,105,333,260,400,593,346.5,394,344.91666666666663,402,16,26,12,25
2010_10_SEA_ARI,ARI,SEA,10,2010,322,41,386,110,363,496,279.875,277.625,369.25,411.25,3,2,18,26
2010_10_STL_SF,SF,LA,10,2010,356,98,251,104,454,355,325.75,315.375,381,272.08333333333337,10,7,21,1
2010_10_TEN_MIA,MIA,TEN,10,2010,323,88,143,135,411,278,345.875,321.125,359.25,443.75,15,8,16,28
2010_11_ARI_KC,KC,ARI,11,2010,193,159,295,101,352,396,374.3333333333333,289.1111111111111,388.8888888888889,301.8888888888889,22,2,30,4
2010_11_ATL_STL,LA,ATL,11,2010,233,71,253,138,304,391,319.77777777777777,379.6666666666667,340,356.1111111111111,6,24,11,19
2010_11_BAL_CAR,CAR,BAL,11,2010,173,120,301,100,293,401,271.1111111111111,356.1111111111111,340.77777777777777,379.6666666666667,1,18,12,26
2010_11_BUF_CIN,CIN,BUF,11,2010,248,133,316,141,381,457,358.6666666666667,320.22222222222223,386.3333333333333,347.44444444444446,20,7,27,13
2010_11_CHI_MIA,MIA,CHI,11,2010,187,36,156,135,223,291,353.1111111111111,320.6666666666667,316.3333333333333,354.8888888888889,16,8,6,18
2010_11_CLE_JAX,JAX,CLE,11,2010,254,145,241,88,399,329,347.77777777777777,314.22222222222223,388.1111111111111,373,13,4,29,23
2010_11_DEN_SD,LAC,DEN,11,2010,261,147,217,63,408,280,435.77777777777777,388.8888888888889,386.93650793650795,374.3333333333333,32,29,28,24
2010_11_DET_DAL,DAL,DET,11,2010,147,134,289,75,281,364,376.22222222222223,347.44444444444446,418.8888888888889,320.22222222222223,23,12,32,8
2010_11_GB_MIN,MIN,GB,11,2010,208,93,306,91,301,397,354.8888888888889,357.1111111111111,320.6666666666667,372.22222222222223,17,19,9,22
2010_11_HOU_NYJ,NYJ,HOU,11,2010,315,103,254,97,418,351,373,388.1111111111111,314.22222222222223,347.77777777777777,21,28,5,14
2010_11_IND_NE,NE,IND,11,2010,186,168,396,71,354,467,348.44444444444446,386.3333333333333,329.6666666666667,358.6666666666667,14,27,10,21
2010_11_NYG_PHI,PHI,NYG,11,2010,258,148,147,61,406,208,416.1111111111111,418.8888888888889,352.44444444444446,376.22222222222223,30,31,16,25
2010_11_OAK_PIT,PIT,LV,11,2010,275,162,168,61,437,229,329.6666666666667,380,348.44444444444446,356.6984126984127,9,25,15,20
2010_11_SEA_NO,NO,SEA,11,2010,382,112,366,58,494,424,381.1111111111111,301.8888888888889,266.8888888888889,289.1111111111111,26,3,1,3
2010_11_TB_SF,SF,TB,11,2010,148,71,143,162,219,305,340,340.77777777777777,319.77777777777777,271.1111111111111,10,11,7,2
2010_11_WAS_TEN,TEN,WAS,11,2010,227,151,376,107,378,483,316.3333333333333,352.44444444444446,353.1111111111111,416.1111111111111,5,15,17,31
2010_12_CAR_CLE,CLE,CAR,12,2010,245,152,195,151,397,346,315.7,273.3,352.9,360.6,4,1,16,17
2010_12_CIN_NYJ,NYJ,CIN,12,2010,166,170,135,46,336,181,377.5,360.9,384.4,333.9,24,18,27,9
2010_12_GB_ATL,ATL,GB,12,2010,197,117,344,77,314,421,380.8,361.1,318.2,349.5,26,19,6,15
2010_12_JAX_NYG,NYG,JAX,12,2010,226,135,162,207,361,369,397.8,352.9,415.1,315.7,30,16,31,4
2010_12_KC_SEA,SEA,KC,12,2010,282,20,233,270,302,503,314.1,372.1,392.4,299.8,3,23,28,2
2010_12_MIA_OAK,LV,MIA,12,2010,252,16,307,186,268,493,364.9,340.1,340.4,317.7,20,11,12,5
2010_12_MIN_WAS,WAS,MIN,12,2010,211,29,172,137,240,309,365.5,349.5,322.5,361.1,21,15,7,19
2010_12_NE_DET,DET,NE,12,2010,285,129,341,109,414,450,349.1,349,366.7,394.4,14,13,22,29
2010_12_NO_DAL,DAL,NO,12,2010,313,144,352,81,457,433,366.7,392.4,349.1,314.1,22,28,14,3
2010_12_PHI_CHI,CHI,PHI,12,2010,247,131,333,105,378,438,317.7,415.1,340.1,397.8,5,31,11,30
2010_12_PIT_BUF,BUF,PIT,12,2010,265,74,246,206,339,452,333.9,340.4,360.9,364.9,9,12,18,20
2010_12_SD_IND,IND,LAC,12,2010,285,24,185,129,309,314,394.4,433,349,378,29,32,13,25
2010_12_SF_ARI,ARI,SF,12,2010,196,13,129,261,209,390,299.8,327.9,372.1,337.2,2,8,23,10
2010_12_STL_DEN,DEN,LA,12,2010,347,119,308,123,466,431,378,318.2,433,380.8,25,6,32,26
2010_12_TB_BAL,BAL,TB,12,2010,289,92,162,101,381,263,360.6,337.2,273.3,327.9,17,10,1,8
2010_12_TEN_HOU,HOU,TEN,12,2010,178,188,138,24,366,162,384.4,322.5,377.5,365.5,27,7,24,21
2010_13_ATL_TB,TB,ATL,13,2010,183,151,205,85,334,290,330.45454545454544,374.72727272727275,362.45454545454544,366.54545454545456,8,23,20,21
2010_13_BUF_MIN,MIN,BUF,13,2010,187,210,158,84,397,242,345.8181818181818,334.3636363636364,354.09090909090907,350.54545454545456,12,10,15,13
2010_13_CAR_SEA,SEA,CAR,13,2010,229,161,169,131,390,300,313,279.90909090909093,384,323.09090909090907,4,1,26,5
2010_13_CHI_DET,DET,CHI,13,2010,178,134,234,114,312,348,355,323.1818181818182,358.1818181818182,417.1818181818182,17,6,19,31
2010_13_CLE_MIA,MIA,CLE,13,2010,174,114,217,52,288,269,354,323.09090909090907,356.09090909090907,279.90909090909093,14,5,18,1
2010_13_DAL_IND,IND,DAL,13,2010,365,40,167,217,405,384,386.6363636363636,374.90909090909093,422.1818181818182,396.09090909090907,28,24,32,30
2010_13_DEN_KC,KC,DEN,13,2010,196,185,117,161,381,278,384,386,313,328.45454545454544,26,27,4,7
2010_13_HOU_PHI,PHI,HOU,13,2010,302,115,337,108,417,445,417.1818181818182,382.72727272727275,323.1818181818182,307.90909090909093,31,25,6,3
2010_13_JAX_TEN,TEN,JAX,13,2010,169,57,126,258,226,384,307.90909090909093,354.3636363636364,382.72727272727275,394.45454545454544,3,16,25,29
2010_13_NO_CIN,CIN,NO,13,2010,249,96,313,146,345,459,344.54545454545456,396.09090909090907,373.72727272727275,374.90909090909093,11,30,22,24
2010_13_NYJ_NE,NE,NYJ,13,2010,326,101,164,152,427,316,358.1818181818182,373.72727272727275,355,344.54545454545456,19,22,17,11
2010_13_OAK_SD,LAC,LV,13,2010,280,21,117,251,301,368,422.1818181818182,356.09090909090907,386.6363636363636,354,32,18,28,14
2010_13_PIT_BAL,BAL,PIT,13,2010,266,43,253,54,309,307,362.45454545454544,350.54545454545456,330.45454545454544,334.3636363636364,20,13,8,10
2010_13_SF_GB,GB,SF,13,2010,298,136,194,97,434,291,366.54545454545456,333.54545454545456,374.72727272727275,291.54545454545456,21,9,23,2
2010_13_STL_ARI,ARI,LA,13,2010,148,105,187,119,253,306,291.54545454545456,328.45454545454544,333.54545454545456,386,2,7,9,27
2010_13_WAS_NYG,NYG,WAS,13,2010,161,197,296,74,358,370,394.45454545454544,354.09090909090907,354.3636363636364,345.8181818181818,29,15,16,12
2010_14_ATL_CAR,CAR,ATL,14,2010,107,212,227,127,319,354,281.58333333333337,367.6666666666667,319.4166666666667,330.75,1,21,5,10
2010_14_BAL_HOU,HOU,BAL,14,2010,393,111,235,63,504,298,387.9166666666667,358,417.1666666666667,346.9166666666667,27,19,32,12
2010_14_CIN_PIT,PIT,CIN,14,2010,258,123,178,34,381,212,346.9166666666667,344.5833333333333,358,401.3333333333333,12,11,19,30
2010_14_CLE_BUF,BUF,CLE,14,2010,142,192,86,105,334,191,326.6666666666667,318.5833333333333,350.0833333333333,348.5,8,4,14,13
2010_14_DEN_ARI,ARI,DEN,14,2010,146,211,166,132,357,298,288.3333333333333,377,326.5833333333333,383.75,2,25,7,26
2010_14_GB_DET,DET,GB,14,2010,117,190,223,66,307,289,351.4166666666667,372.1666666666667,325.25,330,15,23,6,9
2010_14_IND_TEN,TEN,IND,14,2010,244,121,319,87,365,406,301.08333333333337,388.1666666666667,356.8333333333333,375.6666666666667,3,28,17,24
2010_14_KC_SD,LAC,KC,14,2010,226,207,48,48,433,96,412.0833333333333,383.75,357.0833333333333,377,31,26,18,25
2010_14_MIA_NYJ,NYJ,MIA,14,2010,216,87,55,101,303,156,368.9166666666667,348.5,363.9166666666667,318.5833333333333,22,13,20,4
2010_14_NE_CHI,CHI,NE,14,2010,152,47,369,124,199,493,325.25,363.9166666666667,351.4166666666667,368.9166666666667,6,20,15,22
2010_14_NYG_MIN,MIN,NYG,14,2010,126,61,187,213,187,400,350.0833333333333,391.4166666666667,326.6666666666667,355.4166666666667,14,29,8,16
2010_14_OAK_JAX,JAX,LV,14,2010,159,234,344,153,393,497,356.8333333333333,357.0833333333333,301.08333333333337,412.0833333333333,17,18,3,31
2010_14_PHI_DAL,DAL,PHI,14,2010,242,110,270,171,352,441,375.6666666666667,417.1666666666667,388.1666666666667,387.9166666666667,24,32,28,27
2010_14_SEA_SF,SF,SEA,14,2010,255,95,285,84,350,369,330,319.4166666666667,372.1666666666667,281.58333333333337,9,5,23,1
2010_14_STL_NO,NO,LA,14,2010,221,132,231,136,353,367,401.3333333333333,326.5833333333333,344.5833333333333,288.3333333333333,30,7,11,2
2010_14_TB_WAS,WAS,TB,14,2010,228,188,266,103,416,369,355.4166666666667,330.75,391.4166666666667,367.6666666666667,16,10,29,21
2010_15_ARI_CAR,CAR,ARI,15,2010,141,177,196,43,318,239,284.4615384615385,293.61538461538464,366.61538461538464,370.9230769230769,1,2,22,24
2010_15_ATL_SEA,SEA,ATL,15,2010,154,91,174,98,245,272,323.2307692307692,366.61538461538464,331.53846153846155,284.4615384615385,6,22,9,1
2010_15_BUF_MIA,MIA,BUF,15,2010,276,65,223,71,341,294,333.6923076923077,327.2307692307692,363.84615384615387,308.7692307692308,11,7,20,4
2010_15_CHI_MIN,MIN,CHI,15,2010,192,114,194,104,306,298,337.53846153846155,315.53846153846155,392.0769230769231,373.84615384615387,13,5,28,26
2010_15_CLE_CIN,CIN,CLE,15,2010,209,188,243,59,397,302,334.38461538461536,308.7692307692308,349.53846153846155,327.2307692307692,12,4,15,7
2010_15_DEN_OAK,LV,DEN,15,2010,238,264,138,106,502,244,367.84615384615387,370.9230769230769,359.61538461538464,293.61538461538464,23,24,17,2
2010_15_DET_TB,TB,DET,15,2010,252,176,252,181,428,433,333.6923076923077,348,360.0769230769231,365.7692307692308,11,14,18,21
2010_15_GB_NE,NE,GB,15,2010,163,113,251,143,276,394,373.84615384615387,365.7692307692308,315.53846153846155,348,26,21,5,14
2010_15_HOU_TEN,TEN,HOU,15,2010,237,147,325,30,384,355,306.00000000000006,396.84615384615387,389.53846153846155,353.38461538461536,3,29,27,16
2010_15_JAX_IND,IND,JAX,15,2010,229,155,294,67,384,361,389.53846153846155,359.61538461538464,306.00000000000006,367.84615384615387,27,17,3,23
2010_15_KC_STL,LA,KC,15,2010,181,69,184,210,250,394,329.6923076923077,361.61538461538464,397.61538461538464,413.6923076923077,8,19,30,31
2010_15_NO_BAL,BAL,NO,15,2010,172,208,267,27,380,294,353.38461538461536,397.61538461538464,396.84615384615387,329.6923076923077,16,30,29,8
2010_15_NYJ_PIT,PIT,NYJ,15,2010,264,146,170,106,410,276,349.53846153846155,363.84615384615387,334.38461538461536,333.6923076923077,15,20,12,11
2010_15_PHI_NYG,NYG,PHI,15,2010,289,100,242,197,389,439,392.0769230769231,419,337.53846153846155,373.84615384615387,28,32,13,26
2010_15_SF_SD,LAC,SF,15,2010,273,108,165,61,381,226,413.6923076923077,331.53846153846155,361.61538461538464,323.2307692307692,31,9,19,6
2010_15_WAS_DAL,DAL,WAS,15,2010,305,134,322,55,439,377,373.84615384615387,360.0769230769231,419,333.6923076923077,26,18,32,11
2010_16_BAL_CLE,CLE,BAL,16,2010,178,102,102,161,280,263,308.2857142857143,355.2857142857143,338.85714285714283,390.2142857142857,3,16,12,28
2010_16_CAR_PIT,PIT,CAR,16,2010,320,115,72,74,435,146,353.85714285714283,286.8571428571429,357.57142857142856,289.7142857142857,14,1,17,2
2010_16_DAL_ARI,ARI,DAL,16,2010,183,93,226,183,276,409,289.7142857142857,378.5,286.8571428571429,361.2857142857143,2,26,1,20
2010_16_DET_MIA,MIA,DET,16,2010,278,154,222,67,432,289,334.2142857142857,354.07142857142856,324.85714285714283,340.42857142857144,10,15,9,13
2010_16_HOU_DEN,DEN,HOU,16,2010,308,126,310,91,434,401,361.85714285714283,393.85714285714283,377.42857142857144,311.5714285714286,21,30,25,4
2010_16_IND_OAK,LV,IND,16,2010,231,80,179,191,311,370,377.42857142857144,389.14285714285717,361.85714285714283,359.7142857142857,25,27,21,18
2010_16_MIN_PHI,PHI,MIN,16,2010,263,107,195,161,370,356,420.42857142857144,335.2857142857143,391.85714285714283,314.2857142857143,32,11,29,5
2010_16_NE_BUF,BUF,NE,16,2010,251,125,140,217,376,357,324.85714285714283,366.85714285714283,334.2142857142857,367.7857142857143,9,23,10,24
2010_16_NO_ATL,ATL,NO,16,2010,148,75,302,72,223,374,359.85714285714283,390.2142857142857,317.64285714285717,355.2857142857143,19,28,6,16
2010_16_NYG_GB,GB,NYG,16,2010,404,119,301,90,523,391,367.7857142857143,391.85714285714283,366.85714285714283,420.42857142857144,24,29,23,32
2010_16_NYJ_CHI,CHI,NYJ,16,2010,215,120,269,124,335,393,314.2857142857143,357.57142857142856,335.2857142857143,353.85714285714283,5,17,11,14
2010_16_SD_CIN,CIN,LAC,16,2010,269,102,256,64,371,320,338.85714285714283,411.35714285714283,308.2857142857143,324,12,31,3,8
2010_16_SEA_TB,TB,SEA,16,2010,252,208,90,90,460,180,340.42857142857144,317.64285714285717,354.07142857142856,359.85714285714283,13,6,15,19
2010_16_SF_STL,LA,SF,16,2010,292,60,273,85,352,358,324,324,363.92857142857144,411.35714285714283,8,8,22,31
2010_16_TEN_KC,KC,TEN,16,2010,312,152,235,57,464,292,363.92857142857144,311.5714285714286,324,393.85714285714283,22,4,8,30
2010_16_WAS_JAX,JAX,WAS,16,2010,299,78,182,79,377,261,359.7142857142857,361.2857142857143,389.14285714285717,378.5,18,20,27,26
2010_17_ARI_SF,SF,ARI,17,2010,276,100,242,78,376,320,326.26666666666665,288.8,325.8666666666667,380.53333333333336,8,2,7,26
2010_17_BUF_NYJ,NYJ,BUF,17,2010,119,276,130,37,395,167,359.93333333333334,328.26666666666665,315.6666666666667,366.2,19,9,6,21
2010_17_CAR_ATL,ATL,CAR,17,2010,256,99,182,137,355,319,350.73333333333335,277.46666666666664,389.1333333333333,359.26666666666665,16,1,28,18
2010_17_CHI_GB,GB,CHI,17,2010,229,60,168,110,289,278,378.1333333333333,315.6666666666667,391.8,359.93333333333334,25,6,29,19
2010_17_CIN_BAL,BAL,CIN,17,2010,125,98,305,90,223,395,349.1333333333333,341,306.4,405.26666666666665,14,12,3,31
2010_17_DAL_PHI,PHI,DAL,17,2010,162,121,127,159,283,286,417.06666666666666,380.53333333333336,336.6666666666667,288.8,32,26,10,2
2010_17_JAX_HOU,HOU,JAX,17,2010,253,244,140,198,497,338,394.3333333333333,360.8666666666667,366.6666666666667,354.6,30,20,22,17
2010_17_MIA_NE,NE,MIA,17,2010,321,181,240,44,502,284,366.2,340.73333333333335,328.26666666666665,349.73333333333335,21,11,9,15
2010_17_MIN_DET,DET,MIN,17,2010,258,107,145,74,365,219,349.73333333333335,336.6666666666667,340.73333333333335,417.06666666666666,15,10,11,32
2010_17_NYG_WAS,WAS,NYG,17,2010,336,67,243,82,403,325,354.6,391.8,360.8666666666667,378.1333333333333,17,29,20,25
2010_17_OAK_KC,KC,LV,17,2010,142,115,160,209,257,369,370.6,373,310.2666666666667,387.8666666666667,23,24,5,27
2010_17_PIT_CLE,CLE,PIT,17,2010,210,43,325,100,253,425,306.4,359.26666666666665,349.1333333333333,277.46666666666664,3,18,14,1
2010_17_SD_DEN,DEN,LAC,17,2010,205,146,313,164,351,477,366.6666666666667,405.26666666666665,394.3333333333333,341,22,31,30,12
2010_17_STL_SEA,SEA,LA,17,2010,192,141,155,47,333,202,308.46666666666664,325.8666666666667,348.4,326.26666666666665,4,7,13,8
2010_17_TB_NO,NO,TB,17,2010,212,106,255,84,318,339,389.1333333333333,348.4,350.73333333333335,308.46666666666664,28,13,16,4
2010_17_TEN_IND,IND,TEN,17,2010,264,101,300,51,365,351,387.8666666666667,310.2666666666667,373,370.6,27,5,24,23
2010_18_BAL_KC,KC,BAL,18,2010,70,108,265,142,178,407,363.5,341.25,372.75,344.375,4,2,7,5
2010_18_GB_PHI,PHI,GB,18,2010,292,81,180,138,373,318,408.6875,372.5625,374.625,313.3125,8,5,8,2
2010_18_NO_SEA,SEA,NO,18,2010,272,150,404,77,422,481,310,384.6875,318.125,347.8125,1,6,3,6
2010_18_NYJ_IND,IND,NYJ,18,2010,225,93,189,169,318,358,386.4375,362.125,312.81250000000006,318.1875,7,3,1,4
2010_19_BAL_PIT,PIT,BAL,19,2010,226,71,125,35,297,160,363.375,345.11764705882354,303.0625,352.5882352941176,6,3,2,4
2010_19_GB_ATL,ATL,GB,19,2010,186,45,366,96,231,462,351,369.3529411764706,280.0625,406.5882352941176,4,7,1,8
2010_19_NYJ_NE,NE,NYJ,19,2010,299,113,194,120,412,314,374.6875,361.88235294117646,337.1875,382.4117647058824,8,5,3,6
2010_19_SEA_CHI,CHI,SEA,19,2010,274,176,258,34,450,292,313.3125,316.5882352941176,372.5625,390.3529411764706,1,2,5,7
2010_20_GB_CHI,CHI,GB,20,2010,233,83,244,120,316,364,321.3529411764706,374.5,315.1418685121107,344.3333333333333,1,4,1,3
2010_20_NYJ_PIT,PIT,NYJ,20,2010,133,166,233,70,299,303,359.47058823529414,359.22222222222223,334.2283737024222,376.7604166666667,3,2,2,4
2010_21_PIT_GB,GB,PIT,21,2010,304,50,263,126,354,389,373.94736842105266,356.1111111111111,321.07120743034056,356.0987654320988,2,1,1,2
2011_01_ATL_CHI,CHI,ATL,1,2011,312,88,319,110,400,429,0,0,0,0,32,32,32,32
2011_01_BUF_KC,KC,BUF,1,2011,119,108,208,163,227,371,0,0,0,0,32,32,32,32
2011_01_CAR_ARI,ARI,CAR,1,2011,309,99,422,74,408,496,0,0,0,0,32,32,32,32
2011_01_CIN_CLE,CLE,CIN,1,2011,213,83,173,139,296,312,0,0,0,0,32,32,32,32
2011_01_DAL_NYJ,NYJ,DAL,1,2011,335,45,342,64,380,406,0,0,0,0,32,32,32,32
2011_01_DET_TB,TB,DET,1,2011,266,56,305,126,322,431,0,0,0,0,32,32,32,32
2011_01_IND_HOU,HOU,IND,1,2011,220,167,197,64,387,261,0,0,0,0,32,32,32,32
2011_01_MIN_SD,LAC,MIN,1,2011,335,77,39,159,412,198,0,0,0,0,32,32,32,32
2011_01_NE_MIA,MIA,NE,1,2011,416,98,517,106,514,623,0,0,0,0,32,32,32,32
2011_01_NO_GB,GB,NO,1,2011,312,103,419,81,415,500,0,0,0,0,32,32,32,32
2011_01_NYG_WAS,WAS,NYG,1,2011,305,74,268,75,379,343,0,0,0,0,32,32,32,32
2011_01_OAK_DEN,DEN,LV,1,2011,304,38,105,190,342,295,0,0,0,0,32,32,32,32
2011_01_PHI_STL,LA,PHI,1,2011,209,154,187,236,363,423,0,0,0,0,32,32,32,32
2011_01_PIT_BAL,BAL,PIT,1,2011,224,170,280,66,394,346,0,0,0,0,32,32,32,32
2011_01_SEA_SF,SF,SEA,1,2011,124,85,197,64,209,261,0,0,0,0,32,32,32,32
2011_01_TEN_JAX,JAX,TEN,1,2011,175,163,263,43,338,306,0,0,0,0,32,32,32,32
2011_02_ARI_WAS,WAS,ARI,2,2011,291,172,251,93,463,344,379,408,343,496,17,23,13,29
2011_02_BAL_TEN,TEN,BAL,2,2011,358,74,197,45,432,242,306,394,338,346,8,20,11,14
2011_02_CHI_NO,NO,CHI,2,2011,270,118,244,60,388,304,500,400,415,429,30,21,25,27
2011_02_CIN_DEN,DEN,CIN,2,2011,195,131,332,72,326,404,342,312,295,296,12,9,6,7
2011_02_CLE_IND,IND,CLE,2,2011,191,109,211,106,300,317,261,296,387,312,5,7,19,9
2011_02_DAL_SF,SF,DAL,2,2011,179,74,432,45,253,477,209,406,261,380,2,22,5,18
2011_02_GB_CAR,CAR,GB,2,2011,432,71,308,124,503,432,496,415,408,500,29,25,23,30
2011_02_HOU_MIA,MIA,HOU,2,2011,170,153,230,138,323,368,514,387,623,261,31,19,32,5
2011_02_JAX_NYJ,NYJ,JAX,2,2011,182,101,111,112,283,223,380,338,406,306,18,11,22,8
2011_02_KC_DET,DET,KC,2,2011,322,89,133,151,411,284,431,227,322,371,28,3,10,16
2011_02_OAK_BUF,BUF,LV,2,2011,264,223,323,131,487,454,371,295,227,342,16,6,3,12
2011_02_PHI_ATL,ATL,PHI,2,2011,195,138,314,133,333,447,429,423,400,363,27,26,21,15
2011_02_SD_NE,NE,LAC,2,2011,423,94,378,98,517,476,623,412,514,198,32,24,31,1
2011_02_SEA_PIT,PIT,SEA,2,2011,313,124,159,31,437,190,346,261,394,209,14,5,20,2
2011_02_STL_NYG,NYG,LA,2,2011,223,119,331,59,342,390,343,363,379,423,13,15,17,26
2011_02_TB_MIN,MIN,TB,2,2011,228,186,243,105,414,348,198,322,412,431,1,10,24,28
2011_03_ARI_SEA,SEA,ARI,3,2011,171,122,252,90,293,342,225.5,376,391.5,421,1,17,21,24
2011_03_ATL_TB,TB,ATL,3,2011,180,115,330,30,295,360,335,381,306,435,11,20,6,27
2011_03_BAL_STL,LA,BAL,3,2011,166,112,389,168,278,557,376.5,318,342.5,369,18,8,12,15
2011_03_DEN_TEN,TEN,DEN,3,2011,311,17,173,59,328,232,369,334,318,358,15,10,8,14
2011_03_DET_MIN,MIN,DET,3,2011,211,132,378,20,343,398,306,421,335,255.5,6,24,11,3
2011_03_GB_CHI,CHI,GB,3,2011,302,4,297,100,306,397,352,423.5,444,499.5,13,25,30,31
2011_03_HOU_NO,NO,HOU,3,2011,370,100,373,109,470,482,444,377.5,352,418.5,30,19,13,22
2011_03_JAX_CAR,CAR,JAX,3,2011,158,107,139,128,265,267,499.5,280.5,423.5,331.5,31,5,25,9
2011_03_KC_SD,LAC,KC,3,2011,266,117,176,81,383,257,444,255.5,570,421,30,3,32,24
2011_03_MIA_CLE,CLE,MIA,3,2011,210,70,255,138,280,393,306.5,418.5,280.5,377.5,7,22,5,19
2011_03_NE_BUF,BUF,NE,3,2011,369,79,387,108,448,495,429,570,374.5,444,26,32,16,30
2011_03_NYG_PHI,PHI,NYG,3,2011,211,177,254,102,388,356,435,342.5,381,376.5,27,12,20,18
2011_03_NYJ_OAK,LV,NYJ,3,2011,156,234,369,100,390,469,374.5,331.5,429,280.5,16,9,26,5
2011_03_PIT_IND,IND,PIT,3,2011,153,97,364,67,250,431,280.5,391.5,306.5,225.5,5,21,7,1
2011_03_SF_CIN,CIN,SF,3,2011,157,79,201,50,236,251,358,231,334,441.5,14,2,10,28
2011_03_WAS_DAL,DAL,WAS,3,2011,255,125,250,65,380,315,441.5,421,231,376,28,24,2,17
2011_04_ATL_SEA,SEA,ATL,4,2011,319,53,291,121,372,412,248,374,364.6666666666667,321.6666666666667,2,16,15,10
2011_04_BUF_CIN,CIN,BUF,4,2011,298,171,199,83,469,282,317.3333333333333,435.3333333333333,237.66666666666666,545,8,30,1,32
2011_04_CAR_CHI,CHI,CAR,4,2011,102,224,374,169,326,543,336.6666666666667,421.3333333333333,414.6666666666667,276,11,28,25,5
2011_04_DEN_GB,GB,DEN,4,2011,408,111,273,119,519,392,414.6666666666667,300,336.6666666666667,355.3333333333333,25,7,11,14
2011_04_DET_DAL,DAL,DET,4,2011,331,113,240,63,444,303,421,413.3333333333333,385.6666666666667,318.3333333333333,27,24,19,9
2011_04_IND_TB,TB,IND,4,2011,287,192,281,62,479,343,321.6666666666667,270.3333333333333,374,404.6666666666667,10,4,16,21
2011_04_MIA_SD,LAC,MIA,4,2011,307,116,194,72,423,266,423.6666666666667,410,256,297.6666666666667,29,22,3,6
2011_04_MIN_KC,KC,MIN,4,2011,260,103,202,151,363,353,256,318.3333333333333,423.6666666666667,413.3333333333333,3,9,29,24
2011_04_NE_OAK,LV,NE,4,2011,344,160,226,183,504,409,379.6666666666667,545,377.3333333333333,435.3333333333333,18,32,17,30
2011_04_NO_JAX,JAX,NO,4,2011,196,104,351,177,300,528,276,452.6666666666667,421.3333333333333,412.3333333333333,5,31,28,23
2011_04_NYG_ARI,ARI,NYG,4,2011,237,156,321,54,393,375,364.6666666666667,347,248,419.3333333333333,15,13,2,26
2011_04_NYJ_BAL,BAL,NYJ,4,2011,163,112,119,38,275,157,397.6666666666667,377.3333333333333,343.6666666666667,379.6666666666667,20,17,12,18
2011_04_PIT_HOU,HOU,PIT,4,2011,138,180,206,118,318,324,412.3333333333333,404.6666666666667,452.6666666666667,270.3333333333333,23,21,31,4
2011_04_SF_PHI,PHI,SF,4,2011,416,108,291,164,524,455,419.3333333333333,237.66666666666666,347,317.3333333333333,26,1,13,8
2011_04_TEN_CLE,CLE,TEN,4,2011,350,84,220,112,434,332,297.6666666666667,355.3333333333333,410,300,6,14,22,7
2011_04_WAS_STL,LA,WAS,4,2011,164,45,143,196,209,339,343.6666666666667,385.6666666666667,397.6666666666667,421,12,19,20,27
2011_05_ARI_MIN,MIN,ARI,5,2011,169,172,254,77,341,331,327,371.75,282.75,354,8,14,3,10
2011_05_CHI_DET,DET,CHI,5,2011,219,181,249,122,400,371,385.75,334,426.75,451.75,17,9,21,24
2011_05_CIN_JAX,JAX,CIN,5,2011,221,96,179,77,317,256,282,355.25,471.5,397,2,12,25,19
2011_05_GB_ATL,ATL,GB,5,2011,167,95,396,57,262,453,383.5,440.75,279,323,15,22,1,6
2011_05_KC_IND,IND,KC,5,2011,277,78,257,194,355,451,288.5,282.75,361,327,4,3,12,7
2011_05_NO_CAR,CAR,NO,5,2011,224,162,359,101,386,460,451.75,471.5,334,282,24,25,9,2
2011_05_NYJ_NE,NE,NYJ,5,2011,321,152,166,97,473,263,511,322.25,410.75,367,26,6,20,13
2011_05_OAK_HOU,HOU,LV,5,2011,416,70,190,94,486,284,388.75,410.75,384.5,511,18,20,17,26
2011_05_PHI_BUF,BUF,PHI,5,2011,193,143,315,174,336,489,397,445.5,355.25,292,19,23,11,5
2011_05_SD_DEN,DEN,LAC,5,2011,113,162,250,206,275,456,323,423.5,440.75,374,7,21,22,15
2011_05_SEA_NYG,NYG,SEA,5,2011,420,69,315,145,489,460,354,279,371.75,383.5,11,1,14,16
2011_05_TB_SF,SF,TB,5,2011,205,213,194,86,418,280,292,361,445.5,288.5,5,13,23,4
2011_05_TEN_PIT,PIT,TEN,5,2011,261,174,262,66,435,328,384.5,349.5,388.75,331.75,16,10,18,8
2011_06_BUF_NYG,NYG,BUF,6,2011,292,122,244,155,414,399,381,384.8,315.2,454.2,15,16,4,24
2011_06_CAR_ATL,ATL,CAR,6,2011,163,166,237,139,329,376,359.2,438.6,443.2,469.2,11,22,23,25
2011_06_CLE_OAK,LV,CLE,6,2011,187,151,215,65,338,280,385.4,331.75,408.2,349.5,17,7,20,12
2011_06_DAL_NE,NE,DAL,6,2011,289,101,317,77,390,394,503.4,426.75,310.4,385.75,26,21,3,18
2011_06_HOU_BAL,BAL,HOU,6,2011,305,113,220,93,418,313,367,408.2,322.25,385.4,12,20,7,17
2011_06_IND_CIN,CIN,IND,6,2011,264,94,188,94,358,282,335.4,301.8,289,316.4,8,2,1,5
2011_06_JAX_PIT,PIT,JAX,6,2011,200,185,109,133,385,242,394.6,289,345.2,335.4,19,1,11,8
2011_06_MIA_NYJ,NYJ,MIA,6,2011,201,104,204,118,305,322,310.4,374,503.4,423.5,4,14,26,21
2011_06_MIN_CHI,CHI,MIN,6,2011,267,119,276,53,386,329,341.4,329.8,388.6,363.6,9,6,19,14
2011_06_NO_TB,TB,NO,6,2011,303,117,383,70,420,453,344.8,469.2,317.2,438.6,10,25,6,22
2011_06_PHI_WAS,WAS,PHI,6,2011,260,42,237,192,302,429,374,454.2,310,384.8,14,24,2,16
2011_06_SF_DET,DET,SF,6,2011,293,66,125,203,359,328,388.6,317.2,341.4,344.8,18,5,9,10
2011_06_STL_GB,GB,LA,6,2011,316,90,328,118,406,446,443.2,310,359.2,374,23,3,13,15
2011_07_ATL_DET,DET,ATL,7,2011,183,104,218,129,287,347,383.6666666666667,354.1666666666667,319,428.1666666666667,19,12,5,21
2011_07_BAL_JAX,JAX,BAL,7,2011,93,132,137,34,225,171,281.1666666666667,377.2,393,389.15999999999997,1,17,19,18
2011_07_CHI_TB,TB,CHI,7,2011,264,30,226,177,294,403,357.3333333333333,348.8333333333333,466.5,329.6666666666667,13,11,25,7
2011_07_DEN_MIA,MIA,DEN,7,2011,197,94,161,177,291,338,363.6,313.4,309.32,430,16,4,3,22
2011_07_GB_MIN,MIN,GB,7,2011,219,218,335,114,437,449,329.6666666666667,437,348.8333333333333,332.6666666666667,8,25,11,9
2011_07_HOU_TEN,TEN,HOU,7,2011,116,53,296,222,169,518,345.2,392.3333333333333,394.6,375.5,10,20,20,15
2011_07_IND_NO,NO,IND,7,2011,325,236,102,155,561,257,466.5,298.5,357.3333333333333,339.1666666666667,26,2,13,10
2011_07_KC_OAK,LV,KC,7,2011,177,155,161,139,332,300,377.5,316.4,323.125,301.8,18,6,6,2
2011_07_PIT_ARI,ARI,PIT,7,2011,272,73,361,91,345,452,363.6,393,329.8,281.1666666666667,16,21,8,1
2011_07_SD_NYJ,NYJ,LAC,7,2011,173,162,179,96,335,275,309.5,430,365.3333333333333,313.4,3,24,14,4
2011_07_SEA_CLE,CLE,SEA,7,2011,178,139,97,68,317,165,321.4,315.2,375.91999999999996,381,7,5,16,17
2011_07_STL_DAL,DAL,LA,7,2011,166,294,196,70,460,266,420.2,337.2,480.71999999999997,435.76000000000005,22,9,26,23
2011_07_WAS_CAR,CAR,WAS,7,2011,256,170,279,92,426,371,428.1666666666667,359.6,354.1666666666667,449.16,23,14,12,24
2011_08_ARI_BAL,BAL,ARI,8,2011,336,107,153,109,443,262,342.8333333333333,360.5,271.8055555555556,402.8333333333333,11,14,1,20
2011_08_CIN_SEA,SEA,CIN,8,2011,375,61,168,92,436,260,290.1666666666667,339.1666666666667,320.6666666666667,298.5,2,10,8,4
2011_08_CLE_SF,SF,CLE,8,2011,177,174,241,66,351,307,319,320.6666666666667,383.6666666666667,290.1666666666667,7,8,17,2
2011_08_DAL_PHI,PHI,DAL,8,2011,279,239,203,85,518,288,450,426.8333333333333,362,325.3333333333333,24,22,15,9
2011_08_DET_DEN,DEN,DET,8,2011,172,195,272,113,367,385,317.5,369.85714285714283,351.5,353.14285714285717,6,16,11,12
2011_08_IND_TEN,TEN,IND,8,2011,224,96,250,158,320,408,315.8333333333333,292.57142857142856,413.27777777777777,480,5,3,21,26
2011_08_JAX_HOU,HOU,JAX,8,2011,225,156,97,84,381,181,410.2857142857143,273.14285714285717,320.0285714285714,347.74285714285713,21,1,7,10
2011_08_MIA_NYG,NYG,MIA,8,2011,349,58,138,145,407,283,386.5,351.5,387.1666666666667,317.5,17,13,19,6
2011_08_MIN_CAR,CAR,MIN,8,2011,290,140,236,132,430,368,427.85714285714283,345,361.22857142857146,438.7142857142857,23,12,14,25
2011_08_NE_PIT,PIT,NE,8,2011,365,98,198,43,463,241,401.42857142857144,484.5,360.9428571428572,421.2916666666667,19,26,13,22
2011_08_NO_STL,LA,NO,8,2011,175,183,269,56,358,325,325.3333333333333,480,426.8333333333333,292.57142857142856,9,25,23,3
2011_08_SD_KC,KC,LAC,8,2011,261,94,369,102,355,471,313.6666666666667,404.1666666666667,369.9166666666667,313.75,4,20,16,5
2011_08_WAS_BUF,BUF,WAS,8,2011,262,138,208,26,400,234,387.1666666666667,361.5,386.5,427.8055555555556,18,15,18,24
2011_09_ATL_IND,IND,ATL,9,2011,118,83,275,163,201,438,307,353.14285714285717,316.35416666666663,369.85714285714283,1,15,5,18
2011_09_BAL_PIT,PIT,BAL,9,2011,330,70,300,67,400,367,409.125,357.14285714285717,454.0625,346.42857142857144,23,17,26,14
2011_09_CHI_PHI,PHI,CHI,9,2011,213,119,208,164,332,372,459.7142857142857,356.57142857142856,407,348.2857142857143,27,16,22,15
2011_09_CIN_TEN,TEN,CIN,9,2011,272,78,217,109,350,326,316.42857142857144,327.85714285714283,309.06122448979596,311,4,9,2,3
2011_09_CLE_HOU,HOU,CLE,9,2011,119,261,146,44,380,190,406.625,318.7142857142857,261.625,323.57142857142856,21,5,1,8
2011_09_DEN_OAK,LV,DEN,9,2011,332,100,124,299,432,423,371,324.57142857142856,314.0571428571428,372.02040816326524,18,8,4,19
2011_09_GB_SD,LAC,GB,9,2011,385,85,247,136,470,383,413.7142857142857,438.7142857142857,319.57142857142856,345,24,25,7,13
2011_09_MIA_KC,KC,MIA,9,2011,253,116,244,107,369,351,319.57142857142856,341.7142857142857,413.7142857142857,389.42857142857144,6,11,25,21
2011_09_NYG_NE,NE,NYG,9,2011,342,106,250,111,448,361,449.7142857142857,389.42857142857144,410.2244897959184,341.7142857142857,26,20,24,11
2011_09_NYJ_BUF,BUF,NYJ,9,2011,191,96,230,126,287,356,389,313.14285714285717,343.2857142857143,407.85714285714283,19,3,12,23
2011_09_SEA_DAL,DAL,SEA,9,2011,279,163,221,162,442,383,407,311,459.7142857142857,327.85714285714283,22,2,28,9
2011_09_SF_WAS,WAS,SF,9,2011,254,52,200,138,306,338,343.2857142857143,323.57142857142856,389,318.7142857142857,12,7,20,6
2011_09_STL_ARI,ARI,LA,9,2011,222,70,255,150,292,405,346.42857142857144,330,357.14285714285717,457.85714285714283,13,10,17,27
2011_09_TB_NO,NO,TB,9,2011,258,195,281,84,453,365,460.625,348.2857142857143,329.41666666666663,356.57142857142856,28,14,10,16
2011_10_ARI_PHI,PHI,ARI,10,2011,128,166,315,88,294,403,443.75,339.625,358.5,339.375,30,13,18,12
2011_10_BAL_SEA,SEA,BAL,10,2011,217,119,256,75,336,331,320,358.375,411.375,407.984375,5,17,26,25
2011_10_BUF_DAL,DAL,BUF,10,2011,270,163,146,135,433,281,411.375,376.25,320,318.5,26,21,4,3
2011_10_DEN_KC,KC,DEN,10,2011,140,134,69,244,274,313,325.75,336.875,342.875,378.625,8,10,14,21
2011_10_DET_CHI,CHI,DET,10,2011,123,109,329,80,232,409,358.5,371.75,443.75,323.6875,18,20,30,6
2011_10_HOU_TB,TB,HOU,10,2011,170,90,242,185,260,427,350.375,403.6666666666667,459.671875,304.41269841269843,16,24,32,2
2011_10_JAX_IND,IND,JAX,10,2011,161,84,118,141,245,259,295.22222222222223,261.625,362.5714285714286,406.625,2,1,19,24
2011_10_MIN_GB,GB,MIN,10,2011,288,90,190,104,378,294,431.75,347.875,420.75,428.125,29,15,27,28
2011_10_NE_NYJ,NYJ,NE,10,2011,306,110,329,60,416,389,318.5,449.5,376.25,385.875,4,31,20,22
2011_10_NO_ATL,ATL,NO,10,2011,351,138,322,41,489,363,363.75,459.77777777777777,293.75,350.1428571428571,19,32,1,16
2011_10_NYG_SF,SF,NYG,10,2011,242,77,311,93,319,404,325.375,385.875,338.625,449.5,7,23,11,31
2011_10_OAK_SD,LAC,LV,10,2011,274,75,299,191,349,490,420.75,378.625,431.75,336.875,27,22,29,10
2011_10_PIT_CIN,CIN,PIT,10,2011,170,109,245,105,279,350,327.625,408.1111111111111,320.625,358.23809523809524,9,25,5,17
2011_10_STL_CLE,CLE,LA,10,2011,218,126,155,133,344,288,302.625,339.375,403.296875,339.625,3,12,23,13
2011_10_TEN_CAR,CAR,TEN,10,2011,212,113,219,172,325,391,428.125,320.625,347.875,327.625,28,6,15,9
2011_10_WAS_MIA,MIA,WAS,10,2011,209,103,215,61,312,276,342.875,338.625,325.75,325.375,14,11,8,7
2011_11_ARI_SF,SF,ARI,11,2011,267,164,163,80,431,243,324.6666666666667,346.6666666666667,387.8888888888889,427.1111111111111,6,16,18,26
2011_11_BUF_MIA,MIA,BUF,11,2011,160,95,215,41,255,256,339.44444444444446,365.6666666666667,331.6666666666667,413.77777777777777,12,18,8,23
2011_11_CAR_DET,DET,CAR,11,2011,335,169,280,137,504,417,375.8888888888889,416.6666666666667,344.44444444444446,328.44444444444446,19,25,13,6
2011_11_CIN_BAL,BAL,CIN,11,2011,270,105,373,119,375,492,355.3333333333333,322.22222222222223,321.77777777777777,401.6543209876543,17,5,4,20
2011_11_DAL_WAS,WAS,DAL,11,2011,292,60,292,89,352,381,331.6666666666667,413.77777777777777,339.44444444444446,365.6666666666667,9,24,11,16
2011_11_JAX_CLE,CLE,JAX,11,2011,199,148,210,108,347,318,307.22222222222223,261.3333333333333,333.6666666666667,289.641975308642,2,1,9,1
2011_11_KC_NE,NE,KC,11,2011,234,157,230,125,391,355,442.77777777777777,320,329.3333333333333,334.22222222222223,28,3,7,10
2011_11_NYJ_DEN,DEN,NYJ,11,2011,104,125,252,83,229,335,334.22222222222223,329.3333333333333,320,442.77777777777777,11,8,3,27
2011_11_OAK_MIN,MIN,LV,11,2011,211,124,164,162,335,326,341.8888888888889,391,425.77777777777777,412.77777777777777,14,22,25,22
2011_11_PHI_NYG,NYG,PHI,11,2011,264,29,258,136,293,394,387.8888888888889,427.1111111111111,324.6666666666667,346.6666666666667,21,27,5,14
2011_11_SD_CHI,CHI,LAC,11,2011,286,92,280,52,378,332,344.44444444444446,412.77777777777777,375.8888888888889,391,15,23,17,19
2011_11_SEA_STL,LA,SEA,11,2011,181,42,203,126,223,329,333.6666666666667,321.77777777777777,307.22222222222223,355.3333333333333,10,4,2,15
2011_11_TB_GB,GB,TB,11,2011,299,91,342,121,390,463,425.77777777777777,340.3333333333333,341.8888888888889,406.2592592592593,26,13,12,21
2011_11_TEN_ATL,ATL,TEN,11,2011,316,116,264,41,432,305,377.6666666666667,328.44444444444446,449.0246913580247,416.6666666666667,20,7,28,24
2011_12_ARI_STL,LA,ARI,12,2011,203,86,114,268,289,382,322.6,336.3,322.5,335.3,5,13,4,13
2011_12_BUF_NYJ,NYJ,BUF,12,2011,180,138,264,86,318,350,329.9,354.7,323.7,331,9,18,8,11
2011_12_CAR_IND,IND,CAR,12,2011,226,105,208,201,331,409,290.2,416.7,261.3625,388.7,2,28,1,26
2011_12_CHI_OAK,LV,CHI,12,2011,301,73,254,172,374,426,384.5,347.8,341.2,404.7,22,16,16,27
2011_12_CLE_CIN,CIN,CLE,12,2011,270,132,151,134,402,285,339.2,311.2,357.3,267,14,3,21,2
2011_12_DEN_SD,LAC,DEN,12,2011,188,185,143,208,373,351,404.7,323.7,347.8,329.9,25,7,18,10
2011_12_GB_DET,DET,GB,12,2011,276,136,307,53,412,360,388.7,422.2,416.7,352.6,23,29,29,19
2011_12_HOU_JAX,JAX,HOU,12,2011,198,105,127,88,303,215,267,406,311.2,341.3375,1,26,3,17
2011_12_MIA_DAL,DAL,MIA,12,2011,226,85,288,89,311,377,410.5,331,333.7,354.7,27,10,12,20
2011_12_MIN_ATL,ATL,MIN,12,2011,262,89,186,64,351,250,383.1,341.2,326.1,384.5,21,15,9,25
2011_12_NE_PHI,PHI,NE,12,2011,400,73,361,104,473,465,423.8,437.6,378.4,323.5,30,31,23,7
2011_12_NYG_NO,NO,NYG,12,2011,372,205,406,73,577,479,450.1,378.4,376.275,423.8,32,20,22,31
2011_12_PIT_KC,KC,PIT,12,2011,167,90,193,108,257,301,323.5,402.3,437.6,322.7625,6,24,32,6
2011_12_SF_BAL,BAL,SF,12,2011,161,92,140,74,253,214,357.3,335.3,339.2,336.3,19,12,15,14
2011_12_TB_TEN,TEN,TB,12,2011,160,202,199,122,362,321,326.1,352.6,383.1,422.2,8,17,24,30
2011_12_WAS_SEA,SEA,WAS,12,2011,144,124,314,110,268,424,322.5,333.7,322.6,410.5,4,11,5,28
2011_13_ATL_HOU,HOU,ATL,13,2011,188,162,267,70,350,337,388.6363636363636,380.1818181818182,270.27272727272725,332.90909090909093,23,20,1,11
2011_13_BAL_CLE,CLE,BAL,13,2011,196,59,158,290,255,448,308.8181818181818,347.8181818181818,344.90909090909093,324.27272727272725,3,16,15,7
2011_13_CAR_TB,TB,CAR,13,2011,229,78,231,163,307,394,349.72727272727275,416,329.3636363636364,293.90909090909093,17,28,10,2
2011_13_CIN_PIT,PIT,CIN,13,2011,176,136,152,104,312,256,393.09090909090907,344.90909090909093,317.45454545454544,308.8181818181818,25,15,4,3
2011_13_DAL_ARI,ARI,DAL,13,2011,247,103,299,75,350,374,340.45454545454544,401.45454545454544,319.54545454545456,335.1818181818182,13,26,6,12
2011_13_DEN_MIN,MIN,DEN,13,2011,389,129,202,150,518,352,332.90909090909093,326.1818181818182,380.1818181818182,401.8181818181818,11,8,20,27
2011_13_DET_NO,NO,DET,13,2011,342,100,408,87,442,495,461.6363636363636,390.8181818181818,387.54545454545456,416.54545454545456,32,24,22,29
2011_13_GB_NYG,NYG,GB,13,2011,347,100,369,89,447,458,387.54545454545456,416.54545454545456,461.6363636363636,390.8181818181818,22,29,32,24
2011_13_IND_NE,NE,IND,13,2011,289,73,353,99,362,452,440.09090909090907,293.90909090909093,428.27272727272725,416,31,2,30,28
2011_13_KC_CHI,CHI,KC,13,2011,133,93,157,113,226,270,354.90909090909093,317.45454545454544,383.54545454545456,393.09090909090907,19,4,21,25
2011_13_NYJ_WAS,WAS,NYJ,13,2011,221,100,165,101,321,266,341.90909090909093,328.8181818181818,317.54545454545456,354.27272727272725,14,9,5,18
2011_13_OAK_MIA,MIA,LV,13,2011,162,209,273,46,371,319,335.1818181818182,383.54545454545456,401.45454545454544,354.90909090909093,12,21,26,19
2011_13_PHI_SEA,SEA,PHI,13,2011,190,174,208,132,364,340,317.54545454545456,428.27272727272725,341.90909090909093,440.09090909090907,5,30,14,31
2011_13_SD_JAX,JAX,LAC,13,2011,195,129,294,139,324,433,270.27272727272725,401.8181818181818,388.6363636363636,326.1818181818182,1,27,23,8
2011_13_STL_SF,SF,LA,13,2011,274,144,156,31,418,187,324.27272727272725,319.54545454545456,347.8181818181818,340.45454545454544,7,6,16,13
2011_13_TEN_BUF,BUF,TEN,13,2011,288,104,140,187,392,327,354.27272727272725,329.3636363636364,328.8181818181818,349.72727272727275,18,10,9,17
2011_14_ATL_CAR,CAR,ATL,14,2011,276,157,320,86,433,406,414.1666666666667,376.5833333333333,346.1666666666667,385.4166666666667,28,20,16,22
2011_14_BUF_SD,LAC,BUF,14,2011,240,150,195,96,390,291,404.4166666666667,357.4166666666667,274.75,329.1666666666667,27,19,1,9
2011_14_CHI_DEN,DEN,CHI,14,2011,236,124,115,159,360,274,328.3333333333333,344.1666666666667,348.3333333333333,313.5,8,15,17,5
2011_14_CLE_PIT,PIT,CLE,14,2011,280,147,222,98,427,320,386.3333333333333,304.3333333333333,337.50000000000006,356.1666666666667,23,2,11,18
2011_14_HOU_CIN,CIN,HOU,14,2011,189,101,300,144,290,444,337.50000000000006,385.4166666666667,386.3333333333333,376.5833333333333,11,22,23,20
2011_14_IND_BAL,BAL,IND,14,2011,227,146,136,50,373,186,356.1666666666667,307.08333333333337,304.3333333333333,433.5833333333333,18,3,2,31
2011_14_KC_NYJ,NYJ,KC,14,2011,181,159,195,65,340,260,323.5833333333333,313.5,340.1666666666667,344.1666666666667,7,5,13,15
2011_14_MIN_DET,DET,MIN,14,2011,227,72,199,269,299,468,399.5,348.3333333333333,460,328.3333333333333,26,17,32,8
2011_14_NE_WAS,WAS,NE,14,2011,301,170,357,79,471,436,340.1666666666667,433.5833333333333,323.5833333333333,307.08333333333337,13,31,7,3
2011_14_NO_TEN,TEN,NO,14,2011,326,59,337,114,385,451,329.1666666666667,460,357.4166666666667,399.5,9,32,19,26
2011_14_NYG_DAL,DAL,NYG,14,2011,321,139,400,110,460,510,399.1666666666667,392.5,341.25,420,25,24,14,29
2011_14_OAK_GB,GB,LV,14,2011,281,136,247,117,417,364,420,378.1666666666667,392.5,338.1666666666667,29,21,24,12
2011_14_PHI_MIA,MIA,PHI,14,2011,155,109,208,51,264,259,338.1666666666667,420.9166666666667,378.1666666666667,321.4166666666667,12,30,21,6
2011_14_SF_ARI,ARI,SF,14,2011,284,55,175,90,339,265,341.25,332.0833333333333,399.1666666666667,308.5,14,10,25,4
2011_14_STL_SEA,SEA,LA,14,2011,224,145,193,114,369,307,321.4166666666667,308.5,420.9166666666667,332.0833333333333,6,4,30,10
2011_14_TB_JAX,JAX,TB,14,2011,217,116,184,110,333,294,274.75,346.1666666666667,404.4166666666667,414.1666666666667,1,16,27,28
2011_15_BAL_SD,LAC,BAL,15,2011,270,145,244,89,415,333,403.3076923076923,357.46153846153845,352.3076923076923,297.76923076923083,26,18,17,2
2011_15_CAR_HOU,HOU,CAR,15,2011,212,150,160,166,362,326,389.9230769230769,415.61538461538464,333.8461538461539,378.84615384615387,23,29,12,21
2011_15_CIN_STL,LA,CIN,15,2011,229,95,179,110,324,289,308.38461538461536,333.8461538461539,325.0769230769231,389.9230769230769,4,12,7,23
2011_15_CLE_ARI,ARI,CLE,15,2011,313,74,226,120,387,346,341.0769230769231,305.53846153846155,326.9230769230769,389.46153846153845,14,3,8,22
2011_15_DAL_TB,TB,DAL,15,2011,148,58,249,160,206,409,342.15384615384613,403.84615384615387,279.2307692307692,401.53846153846155,15,27,1,25
2011_15_DET_OAK,LV,DET,15,2011,367,132,391,57,499,448,377.0769230769231,391.7692307692308,419.7692307692308,357.53846153846155,20,24,30,19
2011_15_GB_KC,KC,GB,15,2011,299,139,235,102,438,337,309.38461538461536,419.7692307692308,324.84615384615387,377.0769230769231,5,30,6,20
2011_15_JAX_ATL,ATL,JAX,15,2011,280,97,141,116,377,257,378.84615384615387,279.2307692307692,415.61538461538464,342.15384615384613,21,1,29,15
2011_15_MIA_BUF,BUF,MIA,15,2011,316,113,217,254,429,471,352.3076923076923,332.46153846153845,403.3076923076923,408.46153846153845,17,10,26,28
2011_15_NE_DEN,DEN,NE,15,2011,194,252,320,141,446,461,330.7692307692308,433.7692307692308,338.7692307692308,350.2307692307692,9,31,13,16
2011_15_NO_MIN,MIN,NO,15,2011,120,105,412,161,225,573,357.53846153846155,459.3076923076923,391.7692307692308,333.46153846153845,19,32,24,11
2011_15_NYJ_PHI,PHI,NYJ,15,2011,274,160,177,94,434,271,408.46153846153845,324.84615384615387,332.46153846153845,309.38461538461536,28,6,10,5
2011_15_PIT_SF,SF,PIT,15,2011,187,100,330,84,287,414,326.9230769230769,389.46153846153845,341.0769230769231,305.53846153846155,8,22,14,3
2011_15_SEA_CHI,CHI,SEA,15,2011,123,132,227,60,255,287,338.7692307692308,325.0769230769231,330.7692307692308,308.38461538461536,13,7,9,4
2011_15_TEN_IND,IND,TEN,15,2011,82,205,331,66,287,397,297.76923076923083,333.46153846153845,357.46153846153845,459.3076923076923,2,11,18,32
2011_15_WAS_NYG,NYG,WAS,15,2011,257,91,185,123,348,308,401.53846153846155,350.2307692307692,403.84615384615387,433.7692307692308,25,16,27,31
2011_16_ARI_CIN,CIN,ARI,16,2011,154,165,297,59,319,356,330.6428571428572,344.35714285714283,309.5,308.42857142857144,9,15,4,3
2011_16_ATL_NO,NO,ATL,16,2011,307,164,434,35,471,469,467.42857142857144,378.7142857142857,348.07142857142856,277.64285714285717,32,20,17,1
2011_16_CHI_GB,GB,CHI,16,2011,283,81,242,199,364,441,413.85714285714283,332.7857142857143,318.57142857142856,322.35714285714283,30,11,5,7
2011_16_CLE_BAL,BAL,CLE,16,2011,132,162,147,117,294,264,355.7142857142857,308.42857142857144,404.14285714285717,344.35714285714283,18,3,26,15
2011_16_DEN_BUF,BUF,DEN,16,2011,196,160,185,133,356,318,357.7857142857143,339,342.35714285714283,435.7142857142857,19,13,14,31
2011_16_HOU_IND,IND,HOU,16,2011,244,95,132,171,339,303,297.00000000000006,387.92857142857144,338,409.2142857142857,2,22,12,28
2011_16_JAX_TEN,TEN,JAX,16,2011,350,65,198,113,415,311,338,277.64285714285717,297.00000000000006,378.7142857142857,12,1,2,20
2011_16_MIA_NE,NE,MIA,16,2011,304,119,281,121,423,402,435.7142857142857,342.35714285714283,339,357.7857142857143,31,14,13,19
2011_16_MIN_WAS,WAS,MIN,16,2011,284,141,152,241,425,393,347.2142857142857,348.07142857142856,397.7142857142857,467.42857142857144,16,17,25,32
2011_16_NYG_NYJ,NYJ,NYG,16,2011,258,105,225,115,363,340,321,397.7142857142857,410.2857142857143,347.2142857142857,6,25,29,16
2011_16_OAK_KC,KC,LV,16,2011,300,135,237,71,435,308,318.57142857142856,385.7857142857143,413.85714285714283,395.7857142857143,5,21,30,24
2011_16_PHI_DAL,DAL,PHI,16,2011,182,81,293,105,263,398,404.2142857142857,410.2857142857143,332.42857142857144,321,27,29,10,6
2011_16_SD_DET,DET,LAC,16,2011,373,87,299,68,460,367,395.7857142857143,404.14285714285717,385.7857142857143,355.7142857142857,24,26,21,18
2011_16_SF_SEA,SEA,SF,16,2011,163,124,179,178,287,357,322.35714285714283,324.07142857142856,332.7857142857143,391.2142857142857,7,8,11,23
2011_16_STL_PIT,PIT,LA,16,2011,208,169,91,164,377,255,391.2142857142857,309.5,324.07142857142856,330.6428571428572,23,4,8,9
2011_16_TB_CAR,CAR,TB,16,2011,171,270,274,59,441,333,409.2142857142857,332.42857142857144,387.92857142857144,404.2142857142857,28,10,22,27
2011_17_BAL_CIN,CIN,BAL,17,2011,232,105,130,221,337,351,329.86666666666673,351.6,345.1333333333333,305.46666666666664,9,17,14,3
2011_17_BUF_NE,NE,BUF,17,2011,360,138,307,106,498,413,434.8666666666667,357.6666666666667,346.3333333333333,337.6,31,19,15,11
2011_17_CAR_NO,NO,CAR,17,2011,409,208,158,164,617,322,467.6666666666667,411.3333333333333,384.73333333333335,332.46666666666664,32,30,22,10
2011_17_CHI_MIN,MIN,CHI,17,2011,228,79,160,92,307,252,351.06666666666666,340,352.4,410.53333333333336,16,12,18,29
2011_17_DAL_NYG,NYG,DAL,17,2011,346,106,289,49,452,338,393.8666666666667,394.8,323.8,409.46666666666664,24,25,6,28
2011_17_DET_GB,GB,DET,17,2011,480,81,520,73,561,593,410.53333333333336,400.06666666666666,340,401.6666666666667,29,26,12,27
2011_17_IND_JAX,JAX,IND,17,2011,92,190,264,56,282,320,279.8666666666667,299.80000000000007,343.1333333333333,382.26666666666665,1,2,13,21
2011_17_KC_DEN,DEN,KC,17,2011,60,216,180,106,276,286,337.6,326.3333333333333,357.6666666666667,380.6,11,8,19,20
2011_17_NYJ_MIA,MIA,NYJ,17,2011,135,82,248,129,217,377,346.3333333333333,323.8,434.8666666666667,393.8666666666667,15,6,31,24
2011_17_PIT_CLE,CLE,PIT,17,2011,177,72,221,161,249,382,305.46666666666664,390.26666666666665,351.6,305.8666666666667,3,23,17,4
2011_17_SD_OAK,LV,LAC,17,2011,417,103,310,153,520,463,380.6,401.6666666666667,326.3333333333333,400.06666666666666,20,27,8,26
2011_17_SEA_ARI,ARI,SEA,17,2011,271,131,222,178,402,400,345.1333333333333,320,329.86666666666673,326.26666666666665,14,5,9,7
2011_17_SF_STL,LA,SF,17,2011,226,111,227,116,337,343,305.8666666666667,326.26666666666665,390.26666666666665,320,4,7,23,5
2011_17_TB_ATL,ATL,TB,17,2011,177,251,274,35,428,309,384.73333333333335,332.46666666666664,467.6666666666667,411.3333333333333,22,10,32,30
2011_17_TEN_HOU,HOU,TEN,17,2011,258,152,297,86,410,383,382.26666666666665,343.1333333333333,299.80000000000007,279.8666666666667,21,13,2,1
2011_17_WAS_PHI,PHI,WAS,17,2011,335,75,256,130,410,386,409.46666666666664,352.4,394.8,351.06666666666666,28,18,25,16
2011_18_ATL_NYG,NYG,ATL,18,2011,277,172,199,64,449,263,397.5,387.4375,391.25,331,6,4,6,3
2011_18_CIN_HOU,HOU,CIN,18,2011,159,188,257,76,347,333,384,330.31250000000006,345.625,351.5625,3,1,4,5
2011_18_DET_NO,NO,DET,18,2011,466,167,380,32,633,412,477,412.125,405.75,419.9375,8,7,7,8
2011_18_PIT_DEN,DEN,PIT,18,2011,316,131,289,156,447,445,333.75,389.75,323.8125,301.9375,2,5,2,1
2011_19_DEN_NE,NE,DEN,19,2011,363,146,136,144,509,280,438.8125,340.4117647058824,361.125,393,7,2,4,6
2011_19_HOU_BAL,BAL,HOU,19,2011,176,87,184,131,263,315,351.5625,381.8235294117647,330.31250000000006,330.47058823529414,3,4,2,3
2011_19_NO_SF,SF,NO,19,2011,299,143,462,37,442,499,327.3125,486.1764705882353,307.8125,412.11764705882354,1,8,1,7
2011_19_NYG_GB,GB,NYG,19,2011,264,147,330,95,411,425,419.9375,400.52941176470586,412.125,380.11764705882354,6,5,8,5
2011_20_BAL_NE,NE,BAL,20,2011,239,96,306,116,335,422,442.94117647058823,346.3529411764706,336.8581314878893,377.89273356401384,4,2,1,2
2011_20_NYG_SF,SF,NYG,20,2011,196,150,316,85,346,401,334.05882352941177,401.8888888888889,486.9307958477509,419.44097222222223,1,3,4,3
2011_21_NYG_NE,NE,NYG,21,2011,276,83,296,114,359,410,436.94444444444446,401.8421052631579,350.55555555555554,334.687306501548,2,1,2,1
2012_01_ATL_KC,KC,ATL,1,2012,258,152,299,84,410,383,0,0,0,0,32,32,32,32
2012_01_BUF_NYJ,NYJ,BUF,1,2012,266,118,195,195,384,390,0,0,0,0,32,32,32,32
2012_01_CAR_TB,TB,CAR,1,2012,138,130,303,10,268,313,0,0,0,0,32,32,32,32
2012_01_CIN_BAL,BAL,CIN,1,2012,329,122,221,129,451,350,0,0,0,0,32,32,32,32
2012_01_DAL_NYG,NYG,DAL,1,2012,213,82,307,143,295,450,0,0,0,0,32,32,32,32
2012_01_IND_CHI,CHI,IND,1,2012,333,114,309,63,447,372,0,0,0,0,32,32,32,32
2012_01_JAX_MIN,MIN,JAX,1,2012,270,123,260,113,393,373,0,0,0,0,32,32,32,32
2012_01_MIA_HOU,HOU,MIA,1,2012,266,83,219,76,349,295,0,0,0,0,32,32,32,32
2012_01_NE_TEN,TEN,NE,1,2012,272,20,236,162,292,398,0,0,0,0,32,32,32,32
2012_01_PHI_CLE,CLE,PHI,1,2012,118,99,317,150,217,467,0,0,0,0,32,32,32,32
2012_01_PIT_DEN,DEN,PIT,1,2012,253,94,245,75,347,320,0,0,0,0,32,32,32,32
2012_01_SD_OAK,LV,LAC,1,2012,297,45,231,32,342,263,0,0,0,0,32,32,32,32
2012_01_SEA_ARI,ARI,SEA,1,2012,215,43,153,115,258,268,0,0,0,0,32,32,32,32
2012_01_SF_GB,GB,SF,1,2012,303,45,211,186,348,397,0,0,0,0,32,32,32,32
2012_01_STL_DET,DET,LA,1,2012,355,83,198,77,438,275,0,0,0,0,32,32,32,32
2012_01_WAS_NO,NO,WAS,1,2012,339,32,320,153,371,473,0,0,0,0,32,32,32,32
2012_02_ARI_NE,NE,ARI,2,2012,316,90,140,102,406,242,398,258,292,268,25,2,7,5
2012_02_BAL_PHI,PHI,BAL,2,2012,371,129,232,111,500,343,467,451,217,350,31,30,1,16
2012_02_CHI_GB,GB,CHI,2,2012,246,106,126,94,352,220,348,447,397,372,14,28,24,18
2012_02_CLE_CIN,CIN,CLE,2,2012,318,80,322,130,398,452,350,217,451,467,16,1,30,31
2012_02_DAL_SEA,SEA,DAL,2,2012,151,182,251,49,333,300,268,450,258,295,5,29,2,9
2012_02_DEN_ATL,ATL,DEN,2,2012,219,67,241,118,286,359,383,347,410,320,20,13,26,11
2012_02_DET_SF,SF,DET,2,2012,226,148,230,82,374,312,397,438,348,275,24,27,14,6
2012_02_HOU_JAX,JAX,HOU,2,2012,76,65,195,216,141,411,373,349,393,295,19,15,23,9
2012_02_KC_BUF,BUF,KC,2,2012,178,201,301,150,379,451,390,410,384,383,22,26,21,20
2012_02_MIN_IND,IND,MIN,2,2012,224,84,245,95,308,340,372,393,447,373,18,23,28,19
2012_02_NO_CAR,CAR,NO,2,2012,253,219,325,163,472,488,313,371,268,473,10,17,5,32
2012_02_NYJ_PIT,PIT,NYJ,2,2012,275,66,138,90,341,228,320,384,347,390,11,21,13,22
2012_02_OAK_MIA,MIA,LV,2,2012,200,263,373,23,463,396,295,342,349,263,9,12,15,3
2012_02_TB_NYG,NYG,TB,2,2012,510,94,243,79,604,322,295,268,450,313,9,5,29,10
2012_02_TEN_SD,LAC,TEN,2,2012,284,148,174,38,432,212,263,292,342,398,3,7,12,25
2012_02_WAS_STL,LA,WAS,2,2012,310,151,206,176,461,382,275,473,438,371,6,32,27,17
2012_03_ATL_SD,LAC,ATL,3,2012,173,116,275,119,289,394,347.5,334.5,252,353,12,10,2,14
2012_03_BUF_CLE,CLE,BUF,3,2012,237,33,208,138,270,346,334.5,384.5,374,430.5,10,23,18,30
2012_03_CIN_WAS,WAS,CIN,3,2012,221,202,401,93,423,494,427.5,374,368,334.5,28,18,16,10
2012_03_DET_TEN,TEN,DET,3,2012,378,59,450,141,437,591,252,375,347.5,385.5,2,20,12,24
2012_03_GB_SEA,SEA,GB,3,2012,130,127,223,84,257,307,300.5,350,375,333.5,5,13,20,8
2012_03_HOU_DEN,DEN,HOU,3,2012,330,59,290,152,389,442,353,380,334.5,257,14,22,10,3
2012_03_JAX_IND,IND,JAX,3,2012,313,124,155,185,437,340,340,257,366.5,380,11,3,15,22
2012_03_KC_NO,NO,KC,3,2012,240,83,248,273,323,521,429.5,430.5,392.5,384.5,29,30,25,23
2012_03_NE_BAL,BAL,NE,3,2012,382,121,335,77,503,412,397,402,483.5,250,26,27,32,1
2012_03_NYG_CAR,CAR,NYG,3,2012,288,60,292,125,348,417,392.5,449.5,429.5,295,25,31,29,4
2012_03_NYJ_MIA,MIA,NYJ,3,2012,196,185,306,93,381,399,379,306,369,330.5,21,6,17,7
2012_03_PHI_ARI,ARI,PHI,3,2012,222,99,217,113,321,330,250,483.5,402,397,1,32,27,26
2012_03_PIT_OAK,LV,PIT,3,2012,209,119,384,54,328,438,369,330.5,379,306,17,7,21,6
2012_03_SF_MIN,MIN,SF,3,2012,198,146,204,89,344,293,366.5,385.5,340,375,15,24,11,20
2012_03_STL_CHI,CHI,LA,3,2012,183,103,152,59,286,211,333.5,368,350,427.5,8,16,13,28
2012_03_TB_DAL,DAL,TB,3,2012,283,38,110,75,321,185,375,295,300.5,449.5,20,4,5,31
2012_04_CAR_ATL,ATL,CAR,4,2012,369,121,215,199,490,414,354.3333333333333,377.6666666666667,328,438.6666666666667,12,19,8,28
2012_04_CHI_DAL,DAL,CHI,4,2012,396,41,275,93,437,368,357,317.6666666666667,258.3333333333333,315.6666666666667,15,8,1,6
2012_04_CIN_JAX,JAX,CIN,4,2012,186,69,244,138,255,382,284.6666666666667,414,372.3333333333333,426,3,24,18,25
2012_04_CLE_BAL,BAL,CLE,4,2012,356,101,320,43,457,363,432.3333333333333,313,405.3333333333333,371.6666666666667,27,5,23,17
2012_04_MIA_ARI,ARI,MIA,4,2012,324,28,431,86,352,517,273.6666666666667,379.6666666666667,432.3333333333333,337,2,20,27,10
2012_04_MIN_DET,DET,MIN,4,2012,319,55,111,127,374,238,447,359,313.6666666666667,354.6666666666667,29,16,5,12
2012_04_NE_BUF,BUF,NE,4,2012,350,98,340,247,448,587,371.6666666666667,405.3333333333333,313,432.3333333333333,18,23,4,27
2012_04_NO_GB,GB,NO,4,2012,319,102,446,45,421,491,335.6666666666667,394,286,460.6666666666667,10,21,3,30
2012_04_NYG_PHI,PHI,NYG,4,2012,241,191,309,57,432,366,432.3333333333333,438.6666666666667,273.6666666666667,377.6666666666667,27,28,2,19
2012_04_OAK_DEN,DEN,LV,4,2012,338,165,202,56,503,258,365,355.3333333333333,400.6666666666667,366.3333333333333,17,14,22,16
2012_04_SD_KC,KC,LAC,4,2012,251,115,209,104,366,313,460.6666666666667,328,394,354.3333333333333,30,9,21,11
2012_04_SEA_STL,LA,SEA,4,2012,223,75,160,179,298,339,315.6666666666667,286,317.6666666666667,335.6666666666667,7,4,7,9
2012_04_SF_NYJ,NYJ,SF,4,2012,112,45,143,247,157,390,337,354.6666666666667,379.6666666666667,359,11,13,20,14
2012_04_TEN_HOU,HOU,TEN,4,2012,202,95,193,158,297,351,400.6666666666667,313.6666666666667,365,447,22,6,15,29
2012_04_WAS_TB,TB,WAS,4,2012,299,80,323,153,379,476,258.3333333333333,426,357,414,1,25,13,24
2012_05_ARI_STL,LA,ARI,5,2012,141,111,289,45,252,334,311.25,293.25,299.25,414,5,3,6,21
2012_05_ATL_WAS,WAS,ATL,5,2012,202,129,345,83,331,428,438.5,388.25,288.5,386.75,27,17,3,17
2012_05_BAL_KC,KC,BAL,5,2012,124,214,187,133,338,320,437,438.5,324.25,325.5,25,27,9,10
2012_05_BUF_SF,SF,BUF,5,2012,310,311,126,89,621,215,363.5,390.75,292,450.75,12,18,4,28
2012_05_CHI_JAX,JAX,CHI,5,2012,142,60,292,214,202,506,277.25,330.25,406,377,1,10,20,16
2012_05_CLE_NYG,NYG,CLE,5,2012,259,243,291,84,502,375,420.5,325.5,432.25,438.5,23,8,25,27
2012_05_DEN_NE,NE,DEN,5,2012,223,251,337,70,474,407,450.75,399.5,390.75,331,28,19,19,11
2012_05_GB_IND,IND,GB,5,2012,362,119,235,149,481,384,372.3333333333333,357,284.6666666666667,418.25,14,11,2,22
2012_05_HOU_NYJ,NYJ,HOU,5,2012,230,69,209,169,299,378,292,374.75,363.5,323,2,15,14,8
2012_05_MIA_CIN,CIN,MIA,5,2012,234,80,223,68,314,291,406,414,277.25,293.25,20,21,1,5
2012_05_PHI_PIT,PIT,PHI,5,2012,220,123,175,78,343,253,366.3333333333333,432.25,355.3333333333333,420.5,13,24,12,23
2012_05_SD_NO,NO,LAC,5,2012,370,53,354,117,423,471,418.25,324.25,357,437,22,7,13,26
2012_05_SEA_CAR,CAR,SEA,5,2012,141,70,221,98,211,319,386.75,299.25,388.25,311.25,16,4,18,7
2012_05_TEN_MIN,MIN,TEN,5,2012,258,175,234,52,433,286,328.75,323,428.75,374.75,9,6,24,15
2012_06_BUF_ARI,ARI,BUF,6,2012,173,182,153,165,355,318,301.4,355.6,299.4,415,4,11,2,22
2012_06_CIN_CLE,CLE,CIN,6,2012,231,110,381,76,341,457,335.4,387.6,436.8,389.4,8,16,26,16
2012_06_DAL_BAL,BAL,DAL,6,2012,234,86,261,227,320,488,414.8,377,417.2,330.25,22,15,24,6
2012_06_DEN_SD,LAC,DEN,6,2012,241,90,309,56,331,365,353.6,401,419.2,455.4,10,21,25,28
2012_06_DET_PHI,PHI,DET,6,2012,311,71,311,138,382,449,396.4,428.75,361.66666666666663,328.75,19,26,11,5
2012_06_GB_HOU,HOU,GB,6,2012,255,90,338,99,345,437,375.4,362.4,293.4,394.06666666666666,14,13,1,17
2012_06_IND_NYJ,NYJ,IND,6,2012,105,252,280,41,357,321,293.4,399.5,375.4,363.75,2,20,13,12
2012_06_KC_TB,TB,KC,6,2012,328,145,180,80,473,260,288.5,417.2,438.5,414.8,1,25,27,21
2012_06_MIN_WAS,WAS,MIN,6,2012,182,183,352,94,365,446,417,349.6,396.2,315.6,24,9,18,4
2012_06_NE_SEA,SEA,NE,6,2012,293,85,395,87,378,482,303.2,455.4,351.6,401,5,28,9,20
2012_06_NYG_SF,SF,NYG,6,2012,282,80,193,149,362,342,415,436.8,355.6,335.4,23,27,10,7
2012_06_OAK_ATL,ATL,LV,6,2012,249,45,353,149,294,502,396.2,331,417,399.5,18,7,23,19
2012_06_PIT_TEN,TEN,PIT,6,2012,290,94,363,56,384,419,315.6,360.5,349.6,387.4375,6,12,8,14
2012_06_STL_MIA,MIA,LA,6,2012,185,36,315,162,221,477,389.4,299.4,387.6,301.4,17,3,15,3
2012_07_ARI_MIN,MIN,ARI,7,2012,58,166,262,126,224,388,365.6666666666667,310.3333333333333,408.3333333333333,349.3333333333333,13,3,24,8
2012_07_BAL_HOU,HOU,BAL,7,2012,256,181,147,55,437,202,370.3333333333333,399,374.8333333333333,395.5,14,18,15,20
2012_07_CLE_IND,IND,CLE,7,2012,186,148,264,55,334,319,383.8,336.3333333333333,306.12,399.1666666666667,17,8,3,22
2012_07_DAL_CAR,CAR,DAL,7,2012,233,112,227,85,345,312,351.6,399.2,303.2,395.84000000000003,10,20,2,21
2012_07_DET_CHI,CHI,DET,7,2012,150,171,263,97,321,360,365.4,432.8,262.2,393.52,12,25,1,19
2012_07_GB_STL,LA,GB,7,2012,255,108,342,70,363,412,329,374.8333333333333,361.3333333333333,370.3333333333333,7,16,10,14
2012_07_JAX_OAK,LV,JAX,7,2012,298,69,181,54,367,235,365.2,262.2,375.76,365.4,11,1,16,11
2012_07_NO_TB,TB,NO,7,2012,420,102,377,81,522,458,325.4,419.2,385.76,353.6,5,23,17,9
2012_07_NYJ_NE,NE,NYJ,7,2012,259,131,328,106,390,434,459.8333333333333,304,315.6666666666667,386.4166666666667,26,2,5,18
2012_07_PIT_CIN,CIN,PIT,7,2012,105,80,278,167,185,445,399.1666666666667,372.2,336.3333333333333,329.28000000000003,19,15,7,6
2012_07_SEA_SF,SF,SEA,7,2012,140,175,122,136,315,258,406.1666666666667,315.6666666666667,421,459.8333333333333,21,4,25,26
2012_07_TEN_BUF,BUF,TEN,7,2012,225,166,205,197,391,402,349.3333333333333,327,310.3333333333333,370.25,9,6,4,13
2012_07_WAS_NYG,NYG,WAS,7,2012,337,64,258,248,401,506,421,408.3333333333333,406.1666666666667,365.6666666666667,24,22,23,12
2012_08_ATL_PHI,PHI,ATL,8,2012,191,92,262,146,283,408,394,379.1666666666667,432.125,359.5,22,16,27,15
2012_08_CAR_CHI,CHI,CAR,8,2012,186,79,314,119,265,433,358,350.5,420.6666666666667,384.6666666666667,11,10,24,20
2012_08_IND_TEN,TEN,IND,8,2012,236,112,297,171,348,468,337.7142857142857,375.5,355.2857142857143,333.4444444444444,7,15,12,7
2012_08_JAX_GB,GB,JAX,8,2012,186,66,303,62,252,365,380.14285714285717,257.6666666666667,333.85714285714283,365.5,17,1,8,17
2012_08_MIA_NYJ,NYJ,MIA,8,2012,283,105,149,97,388,246,322.57142857142856,361.3333333333333,449.85714285714283,329,4,13,28,6
2012_08_NE_STL,LA,NE,8,2012,244,107,321,152,351,473,333.85714285714283,449.85714285714283,380.14285714285717,322.57142857142856,6,28,19,5
2012_08_NO_DEN,DEN,NO,8,2012,305,225,213,51,530,264,395,425.6666666666667,349.8333333333333,358.1666666666667,23,27,10,14
2012_08_NYG_DAL,DAL,NYG,8,2012,437,19,192,103,456,295,384.6666666666667,418.14285714285717,350.5,422.2857142857143,19,24,11,25
2012_08_OAK_KC,KC,LV,8,2012,219,102,209,135,321,344,391,365.5,319.25,257.6666666666667,20,14,3,1
2012_08_SD_CLE,CLE,LAC,8,2012,129,133,154,117,262,271,333.85714285714283,349.8333333333333,376.6857142857143,395,6,9,18,22
2012_08_SEA_DET,DET,SEA,8,2012,352,84,236,133,436,369,420.6666666666667,307.42857142857144,358,393.14285714285717,25,2,13,21
2012_08_SF_ARI,ARI,SF,8,2012,290,7,232,113,297,345,321.42857142857144,393.14285714285717,345.42857142857144,307.42857142857144,3,21,9,2
2012_08_TB_MIN,MIN,TB,8,2012,251,140,262,159,391,421,345.42857142857144,358.1666666666667,321.42857142857144,425.6666666666667,8,12,4,26
2012_08_WAS_PIT,PIT,WAS,8,2012,222,140,177,86,362,263,384.3333333333333,422.2857142857143,363.47222222222223,418.14285714285717,18,26,16,23
2012_09_ARI_GB,GB,ARI,9,2012,218,176,306,54,394,360,364.125,318.375,271.08333333333337,387.125,13,3,1,22
2012_09_BAL_CLE,CLE,BAL,9,2012,176,116,153,137,292,290,324.875,370.85714285714283,339.97916666666663,379.85714285714283,4,16,7,16
2012_09_BUF_HOU,HOU,BUF,9,2012,268,118,239,74,386,313,379.85714285714283,355.2857142857143,370.85714285714283,337.7142857142857,18,10,14,5
2012_09_CAR_WAS,WAS,CAR,9,2012,215,151,201,129,366,330,402.375,362.2857142857143,381.54166666666663,344.7142857142857,24,11,18,8
2012_09_CHI_TEN,TEN,CHI,9,2012,200,159,229,160,359,389,339,344.7142857142857,387.0625,362.2857142857143,6,7,21,11
2012_09_DAL_ATL,ATL,DAL,9,2012,342,123,321,65,465,386,383.2857142857143,394.85714285714283,378.14285714285717,400.5510204081633,21,23,15,25
2012_09_DEN_CIN,CIN,DEN,9,2012,299,91,291,68,390,359,368.57142857142856,414.2857142857143,382.59999999999997,402.57142857142856,15,27,19,26
2012_09_DET_JAX,JAX,DET,9,2012,220,64,285,149,284,434,273,422.85714285714283,361.8367346938776,316.2244897959184,1,28,10,2
2012_09_KC_SD,LAC,KC,9,2012,220,123,181,113,343,294,338.57142857142856,381,323.59183673469386,362.42857142857144,5,19,3,12
2012_09_MIA_IND,IND,MIA,9,2012,433,97,290,84,530,374,388.7142857142857,344.85714285714283,339.18367346938777,331.9183673469388,22,8,6,4
2012_09_MIN_SEA,SEA,MIN,9,2012,198,195,63,243,393,306,315.125,351.125,422.58333333333337,366.02083333333337,2,9,28,13
2012_09_PHI_NO,NO,PHI,9,2012,239,140,272,221,379,493,402.57142857142856,378.14285714285717,414.2857142857143,383.2857142857143,25,17,27,20
2012_09_PIT_NYG,NYG,PIT,9,2012,125,68,216,158,193,374,402.75,381.14285714285717,393.58333333333337,399.53061224489795,26,20,23,24
2012_09_TB_OAK,LV,TB,9,2012,418,22,247,278,440,525,362.42857142857144,367.14285714285717,381,351.93877551020404,12,14,17,9
2012_10_ATL_NO,NO,ATL,10,2012,298,148,411,46,446,457,399.625,393.5,392.5,393.75,24,22,20,22
2012_10_BUF_NE,NE,BUF,10,2012,237,117,337,162,354,499,452.75,350,336,380.625,28,9,5,18
2012_10_DAL_PHI,PHI,DAL,10,2012,289,91,209,101,380,310,392.5,393.75,399.625,393.5,21,23,24,21
2012_10_DEN_CAR,CAR,DEN,10,2012,241,52,301,65,293,366,358.25,407.375,397.828125,371.25,11,26,23,14
2012_10_DET_MIN,MIN,DET,10,2012,221,196,329,60,417,389,346.1111111111111,424.25,323.77777777777777,274.375,7,27,4,1
2012_10_HOU_CHI,CHI,HOU,10,2012,134,115,95,127,249,222,350.25,380.625,341.5,350,10,18,7,12
2012_10_IND_JAX,JAX,IND,10,2012,330,37,227,138,367,365,274.375,406.375,424.25,348.5,1,25,27,10
2012_10_KC_PIT,PIT,KC,10,2012,157,95,154,142,252,296,380.25,370.125,376.53125,339.125,17,13,16,6
2012_10_NYG_CIN,CIN,NYG,10,2012,199,76,215,129,275,344,371.25,379.44444444444446,407.375,380.3492063492064,14,16,26,17
2012_10_NYJ_SEA,SEA,NYJ,10,2012,211,174,132,84,385,216,323.77777777777777,330.75,346.1111111111111,346.91666666666663,2,3,8,9
2012_10_OAK_BAL,BAL,LV,10,2012,341,78,368,72,419,440,360.75,372.125,320.765625,386.875,12,15,3,19
2012_10_SD_TB,TB,LAC,10,2012,210,74,337,103,284,440,386.875,339.125,372.125,370.125,19,5,15,13
2012_10_STL_SF,SF,LA,10,2012,189,183,315,159,372,474,387.125,336,318.375,452.75,20,4,2,28
2012_10_TEN_MIA,MIA,TEN,10,2012,217,54,122,177,271,299,348.5,341.22222222222223,406.375,349.63492063492066,8,6,25,11
2012_11_ARI_ATL,ATL,ARI,11,2012,301,58,70,137,359,207,400.55555555555554,323,404.77777777777777,367.44444444444446,23,4,27,17
2012_11_BAL_PIT,PIT,BAL,11,2012,199,134,164,47,333,211,366,367.22222222222223,361.8888888888889,379.6666666666667,13,15,12,20
2012_11_CHI_SF,SF,CHI,11,2012,243,121,107,85,364,192,385.44444444444446,339,351.3333333333333,363,20,5,8,13
2012_11_CIN_KC,KC,CIN,11,2012,188,113,230,189,301,419,361.8888888888889,360.55555555555554,366,375.5061728395062,11,10,14,19
2012_11_CLE_DAL,DAL,CLE,11,2012,313,63,210,119,376,329,384.44444444444446,321.22222222222223,391.1111111111111,361.87301587301585,19,3,23,11
2012_11_GB_DET,DET,GB,11,2012,266,110,236,95,376,331,420.3333333333333,367.44444444444446,353.98765432098764,323,27,16,9,2
2012_11_IND_NE,NE,IND,11,2012,331,115,334,119,446,453,441.77777777777777,401.77777777777777,366.55555555555554,284.6666666666667,28,24,15,1
2012_11_JAX_HOU,HOU,JAX,11,2012,527,149,378,86,676,464,363,284.6666666666667,339,401.77777777777777,12,1,5,25
2012_11_MIA_BUF,BUF,MIA,11,2012,168,120,141,60,288,201,366.55555555555554,339.8888888888889,441.77777777777777,336.5308641975309,14,6,28,4
2012_11_NO_OAK,LV,NO,11,2012,312,120,229,151,432,380,379.6666666666667,404.77777777777777,367.22222222222223,400.55555555555554,18,26,16,24
2012_11_NYJ_STL,LA,NYJ,11,2012,170,114,177,124,284,301,351.3333333333333,318,385.44444444444446,330.58024691358025,9,2,22,3
2012_11_PHI_WAS,WAS,PHI,11,2012,200,169,204,80,369,284,398.3333333333333,391.1111111111111,358.6984126984127,384.44444444444446,22,21,10,21
2012_11_SD_DEN,DEN,LAC,11,2012,270,133,258,53,403,311,402.77777777777777,350.3333333333333,351,375.44444444444446,25,7,7,18
2012_11_TB_CAR,CAR,TB,11,2012,252,97,248,167,349,415,351,375.44444444444446,402.77777777777777,350.3333333333333,8,17,26,6
2012_12_ATL_TB,TB,ATL,12,2012,284,50,353,79,334,432,379.4,396.4,350.8,311.4,20,27,11,2
2012_12_BAL_SD,LAC,BAL,12,2012,228,91,355,127,319,482,346.4,351.6,402.8,362.7,10,12,28,16
2012_12_BUF_IND,IND,BUF,12,2012,240,87,180,135,327,315,406.9,358.7,442.2,326,30,15,32,7
2012_12_CAR_PHI,PHI,CAR,12,2012,119,204,306,109,323,415,380.4,350.8,395.4,379.4,21,11,25,19
2012_12_DEN_KC,KC,DEN,12,2012,126,148,285,95,274,380,355.8,402.8,366.4,346.4,14,29,18,10
2012_12_GB_NYG,NYG,GB,12,2012,249,147,230,116,396,346,375.9,363.8,361.625,415.9,19,17,15,30
2012_12_HOU_DET,DET,HOU,12,2012,441,106,315,205,547,520,415.9,394.3,363.8,302.6,31,25,17,1
2012_12_MIN_CHI,CHI,MIN,12,2012,188,113,159,114,301,273,324.3,353.2,383.3,420.725,5,13,21,31
2012_12_NE_NYJ,NYJ,NE,12,2012,301,119,323,152,420,475,316.3,442.2,344.6,406.9,3,32,9,29
2012_12_OAK_CIN,CIN,LV,12,2012,210,221,146,99,431,245,366.4,384.9,355.8,402.3,18,24,13,27
2012_12_PIT_CLE,CLE,PIT,12,2012,158,108,199,49,266,248,322,362.7,383.6,351.6,4,16,22,12
2012_12_SEA_MIA,MIA,SEA,12,2012,253,189,224,96,442,320,326,329.9,358.7,319.275,6,7,14,4
2012_12_SF_NO,NO,SF,12,2012,267,59,231,144,326,375,402.3,383.3,384.9,324.3,28,22,23,6
2012_12_STL_ARI,ARI,LA,12,2012,312,74,205,173,386,378,311.4,344.6,396.4,316.3,2,9,26,3
2012_12_TEN_JAX,JAX,TEN,12,2012,261,100,261,110,361,371,302.6,337,394.3,340.75,1,8,24,8
2012_12_WAS_DAL,DAL,WAS,12,2012,441,35,304,149,476,453,383.6,395.4,322,380.4,23,26,5,20
2012_13_ARI_NYJ,NYJ,ARI,13,2012,126,177,72,81,303,153,325.72727272727275,318.1818181818182,445.1818181818182,347.6363636363636,5,3,32,11
2012_13_CAR_KC,KC,CAR,13,2012,201,158,232,165,359,397,348.3636363636364,356.6363636363636,400.72727272727275,375.1818181818182,12,15,29,20
2012_13_CIN_SD,LAC,CIN,13,2012,280,46,211,128,326,339,343.90909090909093,372.27272727272725,363.45454545454544,372.1818181818182,9,19,17,18
2012_13_CLE_OAK,LV,CLE,13,2012,351,85,364,122,436,486,372.1818181818182,316.90909090909093,372.27272727272725,352.27272727272725,18,2,19,13
2012_13_HOU_TEN,TEN,HOU,13,2012,309,89,207,124,398,331,340.09090909090907,405.72727272727275,307.90909090909093,427.8181818181818,8,30,1,31
2012_13_IND_DET,DET,IND,13,2012,313,138,391,87,451,478,427.8181818181818,399.6363636363636,405.72727272727275,354.72727272727275,31,27,30,14
2012_13_JAX_BUF,BUF,JAX,13,2012,112,232,202,50,344,252,354.72727272727275,307.90909090909093,399.6363636363636,340.09090909090907,14,1,27,8
2012_13_MIN_GB,GB,MIN,13,2012,286,152,119,240,438,359,362.1818181818182,345.90909090909093,377.72727272727275,322.1818181818182,16,10,22,4
2012_13_NE_MIA,MIA,NE,13,2012,186,101,238,108,287,346,336.54545454545456,445.1818181818182,329,325.72727272727275,7,32,6,5
2012_13_NO_ATL,ATL,NO,13,2012,165,124,341,101,289,442,399.6363636363636,395.3636363636364,375.27272727272725,382.54545454545456,27,25,21,23
2012_13_NYG_WAS,WAS,NYG,13,2012,163,207,280,117,370,397,400.6363636363636,377.72727272727275,392,362.1818181818182,28,22,24,16
2012_13_PHI_DAL,DAL,PHI,13,2012,303,123,251,183,426,434,392,375.1818181818182,400.6363636363636,356.6363636363636,24,20,28,15
2012_13_PIT_BAL,BAL,PIT,13,2012,188,111,276,96,299,372,363.45454545454544,352.27272727272725,343.90909090909093,316.90909090909093,17,13,9,2
2012_13_SEA_CHI,CHI,SEA,13,2012,233,132,293,176,365,469,322.1818181818182,329,345.90909090909093,336.54545454545456,4,6,10,7
2012_13_SF_STL,LA,SF,13,2012,221,85,208,148,306,356,347.6363636363636,382.54545454545456,318.1818181818182,395.3636363636364,11,23,3,25
2012_13_TB_DEN,DEN,TB,13,2012,242,91,242,71,333,313,400.72727272727275,375.27272727272725,348.3636363636364,399.6363636363636,29,21,12,27
2012_14_ARI_SEA,SEA,ARI,14,2012,216,284,133,43,500,176,340.6666666666667,304.4166666666667,325.75,323.8333333333333,7,2,4,3
2012_14_ATL_CAR,CAR,ATL,14,2012,287,195,342,35,482,377,360,390.4166666666667,349.25,399.25,16,24,12,28
2012_14_BAL_WAS,WAS,BAL,14,2012,268,179,182,186,447,368,398.0833333333333,358.0833333333333,379.3333333333333,353.9166666666667,27,15,21,14
2012_14_CHI_MIN,MIN,CHI,14,2012,91,171,324,118,262,442,347,325.75,368.5,340.6666666666667,11,4,17,7
2012_14_DAL_CIN,CIN,DAL,14,2012,206,146,268,49,352,317,369.5,394.8333333333333,342.4166666666667,380.0833333333333,18,25,8,22
2012_14_DEN_OAK,LV,DEN,14,2012,273,61,310,140,334,450,377.5,395.0833333333333,331.00000000000006,370.0833333333333,20,26,5,19
2012_14_DET_GB,GB,DET,14,2012,173,140,264,135,313,399,368.5,429.75,347,406.1666666666667,17,31,11,30
2012_14_HOU_NE,NE,HOU,14,2012,296,130,247,100,426,347,436.9166666666667,399.5,332.4166666666667,344.9166666666667,32,29,6,10
2012_14_KC_CLE,CLE,KC,14,2012,217,154,159,180,371,339,331.00000000000006,349.25,377.5,360,5,12,20,16
2012_14_MIA_SF,SF,MIA,14,2012,185,155,150,94,340,244,380.3333333333333,332.4166666666667,344.1666666666667,436.9166666666667,23,6,9,32
2012_14_NO_NYG,NYG,NO,14,2012,259,135,354,142,394,496,379.3333333333333,399.25,398.0833333333333,390.4166666666667,21,28,27,24
2012_14_NYJ_JAX,JAX,NYJ,14,2012,185,123,111,166,308,277,303.25000000000006,323.8333333333333,353.8333333333333,304.4166666666667,1,3,13,2
2012_14_PHI_TB,TB,PHI,14,2012,189,136,381,29,325,410,370.0833333333333,380.0833333333333,395.0833333333333,394.8333333333333,19,22,26,25
2012_14_SD_PIT,PIT,LAC,14,2012,285,69,200,94,354,294,353.9166666666667,342.4166666666667,358.0833333333333,369.5,14,8,15,18
2012_14_STL_BUF,BUF,LA,14,2012,247,61,209,78,308,287,353.8333333333333,344.1666666666667,303.25000000000006,380.3333333333333,13,9,1,23
2012_14_TEN_IND,IND,TEN,14,2012,196,98,262,97,294,359,406.1666666666667,344.9166666666667,429.75,399.5,30,10,31,29
2012_15_CAR_SD,LAC,CAR,15,2012,121,70,231,155,191,386,338.6923076923077,369.38461538461536,353.9230769230769,389.38461538461536,7,19,14,25
2012_15_CIN_PHI,PHI,CIN,15,2012,180,42,127,157,222,284,382.38461538461536,368.15384615384613,366.61538461538464,388.84615384615387,23,18,17,24
2012_15_DEN_BAL,BAL,DEN,15,2012,254,56,204,163,310,367,358.84615384615387,399.3076923076923,401.84615384615387,374.15384615384613,15,28,29,20
2012_15_DET_ARI,ARI,DET,15,2012,104,99,246,84,203,330,294.53846153846155,427.38461538461536,352.9230769230769,364.2307692307692,1,31,13,16
2012_15_GB_CHI,CHI,GB,15,2012,135,83,291,113,218,404,334.6923076923077,364.2307692307692,340.46153846153845,427.38461538461536,6,16,9,31
2012_15_IND_HOU,HOU,IND,15,2012,261,178,186,124,439,310,395.46153846153845,397.53846153846155,436.0769230769231,346,26,27,32,10
2012_15_JAX_MIA,MIA,JAX,15,2012,220,180,221,86,400,307,325.61538461538464,303.6153846153847,377.2307692307692,320.2307692307692,4,2,21,3
2012_15_KC_OAK,LV,KC,15,2012,182,203,136,10,385,146,374.15384615384613,348.46153846153845,399.3076923076923,334.07692307692315,20,11,28,5
2012_15_MIN_STL,LA,MIN,15,2012,377,87,131,213,464,344,339.7692307692308,340.46153846153845,350.3076923076923,334.6923076923077,8,9,12,6
2012_15_NYG_ATL,ATL,NYG,15,2012,270,129,161,97,399,258,389.38461538461536,380.46153846153845,369.38461538461536,406.6923076923077,25,22,19,30
2012_15_NYJ_TEN,TEN,NYJ,15,2012,149,167,131,146,316,277,346,320.2307692307692,397.53846153846155,303.6153846153847,10,3,27,2
2012_15_PIT_DAL,DAL,PIT,15,2012,341,87,339,69,428,408,388.84615384615387,353.9230769230769,368.15384615384613,338.6923076923077,24,14,18,7
2012_15_SEA_BUF,BUF,SEA,15,2012,247,118,205,270,365,475,350.3076923076923,352.9230769230769,339.7692307692308,294.53846153846155,12,13,8,1
2012_15_SF_NE,NE,SF,15,2012,443,95,221,180,538,401,436.0769230769231,377.2307692307692,395.46153846153845,325.61538461538464,32,21,26,4
2012_15_TB_NO,NO,TB,15,2012,307,149,330,67,456,397,406.6923076923077,366.61538461538464,380.46153846153845,382.38461538461536,30,17,22,23
2012_15_WAS_CLE,CLE,WAS,15,2012,244,58,329,122,302,451,334.07692307692315,401.84615384615387,348.46153846153845,358.84615384615387,5,29,11,15
2012_16_ATL_DET,DET,ATL,16,2012,443,79,279,73,522,352,420.42857142857144,390.07142857142856,288,371.7142857142857,31,24,1,21
2012_16_BUF_MIA,MIA,BUF,16,2012,130,182,240,154,312,394,330.92857142857144,351.35714285714283,303.85714285714295,361.64285714285717,6,12,2,15
2012_16_CHI_ARI,ARI,CHI,16,2012,246,29,146,152,275,298,288,326.35714285714283,420.42857142857144,367.07142857142856,1,4,31,17
2012_16_CIN_PIT,PIT,CIN,16,2012,220,95,278,14,315,292,357.7857142857143,362.14285714285717,391.64285714285717,370.92857142857144,14,16,26,20
2012_16_CLE_DEN,DEN,CLE,16,2012,339,118,183,91,457,274,397,331.78571428571433,355.35714285714283,405.35714285714283,27,7,13,29
2012_16_IND_KC,KC,IND,16,2012,162,352,205,90,514,295,334,391.2857142857143,374.92857142857144,398.57142857142856,8,25,22,28
2012_16_MIN_HOU,HOU,MIN,16,2012,178,34,174,174,212,348,398.57142857142856,340.7142857142857,391.2857142857143,348.64285714285717,28,9,25,11
2012_16_NE_JAX,JAX,NE,16,2012,348,93,267,103,441,370,303.85714285714295,443.35714285714283,330.92857142857144,378.92857142857144,2,32,6,23
2012_16_NO_DAL,DAL,NO,16,2012,416,40,446,116,456,562,391.64285714285717,410.2142857142857,357.7857142857143,368.7857142857143,26,30,14,18
2012_16_NYG_BAL,BAL,NYG,16,2012,309,224,150,67,533,217,355.35714285714283,371.7142857142857,397,390.07142857142856,13,21,27,24
2012_16_OAK_CAR,CAR,LV,16,2012,170,98,151,47,268,198,370.57142857142856,374.92857142857144,328.14285714285717,334,19,22,5,8
2012_16_SD_NYJ,NYJ,LAC,16,2012,227,69,165,87,296,252,317.14285714285717,328.14285714285717,343.85714285714283,370.57142857142856,3,5,10,19
2012_16_SF_SEA,SEA,SF,16,2012,171,176,244,82,347,326,361.64285714285717,378.92857142857144,351.35714285714283,443.35714285714283,15,23,12,32
2012_16_STL_TB,TB,LA,16,2012,372,80,196,89,452,285,368.7857142857143,348.64285714285717,410.2142857142857,340.7142857142857,18,11,30,9
2012_16_TEN_GB,GB,TEN,16,2012,351,117,140,79,468,219,367.07142857142856,343.85714285714283,326.35714285714283,317.14285714285717,17,10,4,3
2012_16_WAS_PHI,PHI,WAS,16,2012,345,90,198,128,435,326,370.92857142857144,405.35714285714283,362.14285714285717,331.78571428571433,20,29,16,7
2012_17_ARI_SF,SF,ARI,17,2012,282,129,225,55,411,280,375.4,287.1333333333333,360.6666666666667,324.46666666666664,23,1,15,5
2012_17_BAL_CIN,CIN,BAL,17,2012,143,47,183,206,190,389,357.46666666666664,367.2,354.93333333333334,361.4,14,19,13,16
2012_17_CAR_NO,NO,CAR,17,2012,396,63,260,273,459,533,420.3333333333333,363.73333333333335,395.93333333333334,363.1333333333333,30,18,27,17
2012_17_CHI_DET,DET,CHI,17,2012,272,72,257,144,344,401,427.2,324.46666666666664,387.53333333333336,287.1333333333333,31,5,26,1
2012_17_CLE_PIT,PIT,CLE,17,2012,134,91,204,138,225,342,354.93333333333334,327.9333333333334,357.46666666666664,401,13,6,14,29
2012_17_DAL_WAS,WAS,DAL,17,2012,100,274,218,100,374,318,400.06666666666666,395.93333333333334,375.2,420.3333333333333,28,27,22,30
2012_17_GB_MIN,MIN,GB,17,2012,234,217,365,72,451,437,341.2,373.8,386.1333333333333,335.53333333333336,9,20,25,8
2012_17_HOU_IND,IND,HOU,17,2012,191,81,275,102,272,377,384.8666666666667,386.1333333333333,346,341.2,24,25,11,9
2012_17_JAX_TEN,TEN,JAX,17,2012,152,79,298,122,231,420,335.53333333333336,313.00000000000006,373.8,438.46666666666664,8,2,20,32
2012_17_KC_DEN,DEN,KC,17,2012,316,172,49,93,488,142,401,346,327.9333333333334,384.8666666666667,29,11,6,24
2012_17_MIA_NE,NE,MIA,17,2012,284,167,235,47,451,282,438.46666666666664,329.6666666666667,313.00000000000006,354.2,32,7,2,12
2012_17_NYJ_BUF,BUF,NYJ,17,2012,225,109,205,133,334,338,354.2,315.73333333333335,329.6666666666667,323.06666666666666,12,3,7,4
2012_17_OAK_SD,LAC,LV,17,2012,151,70,150,115,221,265,323.06666666666666,363.1333333333333,315.73333333333335,363.73333333333335,4,17,3,18
2012_17_PHI_NYG,NYG,PHI,17,2012,223,185,211,110,408,321,361.4,375.2,367.2,400.06666666666666,16,22,19,28
2012_17_STL_SEA,SEA,LA,17,2012,250,153,252,79,403,331,360.6666666666667,344.4,375.4,374.3333333333333,15,10,23,21
2012_17_TB_ATL,ATL,TB,17,2012,238,65,222,144,303,366,387.53333333333336,374.3333333333333,427.2,344.4,26,21,31,10
2012_18_CIN_HOU,HOU,CIN,18,2012,262,158,127,80,420,207,385.5625,347,377.8125,368.5625,7,1,6,4
2012_18_IND_BAL,BAL,IND,18,2012,282,170,288,152,452,440,368.5625,377.8125,347,385.5625,4,6,2,7
2012_18_MIN_GB,GB,MIN,18,2012,274,76,180,167,350,347,377.75,348.0625,348.0625,377.75,5,2,3,5
2012_18_SEA_WAS,WAS,SEA,18,2012,115,104,187,224,219,411,398.4375,363.3125,391.0625,343.5625,8,3,8,1
2012_19_BAL_DEN,DEN,BAL,19,2012,290,125,331,155,415,486,406.4375,373.47058823529414,333.25,381.47058823529414,7,2,3,7
2012_19_GB_SF,SF,GB,19,2012,263,323,257,104,586,361,377.625,376.11764705882354,286.6875,348,4,3,1,5
2012_19_HOU_NE,NE,HOU,19,2012,344,122,343,91,466,434,439.25,387.5882352941176,326.6875,338.7647058823529,8,6,2,4
2012_19_SEA_ATL,ATL,SEA,19,2012,250,167,385,123,417,508,382.25,366.11764705882354,373.8125,387.88235294117646,5,1,6,8
2012_20_BAL_NE,NE,BAL,20,2012,320,108,240,121,428,361,440.8235294117647,379.72222222222223,390.318339100346,406.91319444444446,4,1,3,4
2012_20_SF_ATL,ATL,SF,20,2012,396,81,233,149,477,382,384.29411764705884,389.88235294117646,374.4636678200692,375.2283737024222,2,3,1,2
2012_21_BAL_SF,SF,BAL,21,2012,302,182,287,93,484,380,389.44444444444446,378.7368421052632,389.44444444444446,440.14860681114556,2,1,1,2
2013_01_ARI_STL,LA,ARI,1,2013,299,67,327,86,366,413,0,0,0,0,32,32,32,32
2013_01_ATL_NO,NO,ATL,1,2013,357,78,304,88,435,392,0,0,0,0,32,32,32,32
2013_01_BAL_DEN,DEN,BAL,1,2013,462,65,362,58,527,420,0,0,0,0,32,32,32,32
2013_01_CIN_CHI,CHI,CIN,1,2013,242,81,282,63,323,345,0,0,0,0,32,32,32,32
2013_01_GB_SF,SF,GB,1,2013,412,90,333,63,502,396,0,0,0,0,32,32,32,32
2013_01_HOU_SD,LAC,HOU,1,2013,195,80,346,120,275,466,0,0,0,0,32,32,32,32
2013_01_KC_JAX,JAX,KC,1,2013,157,71,173,121,228,294,0,0,0,0,32,32,32,32
2013_01_MIA_CLE,CLE,MIA,1,2013,289,47,272,20,336,292,0,0,0,0,32,32,32,32
2013_01_MIN_DET,DET,MIN,1,2013,357,112,236,105,469,341,0,0,0,0,32,32,32,32
2013_01_NE_BUF,BUF,NE,1,2013,150,136,288,158,286,446,0,0,0,0,32,32,32,32
2013_01_NYG_DAL,DAL,NYG,1,2013,263,87,450,50,350,500,0,0,0,0,32,32,32,32
2013_01_OAK_IND,IND,LV,1,2013,178,127,217,171,305,388,0,0,0,0,32,32,32,32
2013_01_PHI_WAS,WAS,PHI,1,2013,329,74,203,263,403,466,0,0,0,0,32,32,32,32
2013_01_SEA_CAR,CAR,SEA,1,2013,125,134,320,70,259,390,0,0,0,0,32,32,32,32
2013_01_TB_NYJ,NYJ,TB,1,2013,256,90,210,65,346,275,0,0,0,0,32,32,32,32
2013_01_TEN_PIT,PIT,TEN,1,2013,191,31,125,112,222,237,0,0,0,0,32,32,32,32
2013_02_CAR_BUF,BUF,CAR,2,2013,296,149,229,125,445,354,286,259,446,390,7,4,26,19
2013_02_CLE_BAL,BAL,CLE,2,2013,211,99,233,65,310,298,420,336,527,292,24,12,32,8
2013_02_DAL_KC,KC,DAL,2,2013,223,114,298,37,337,335,294,350,228,500,9,16,2,30
2013_02_DEN_NYG,NYG,DEN,2,2013,362,23,307,107,385,414,500,527,350,420,30,32,16,24
2013_02_DET_ARI,ARI,DET,2,2013,265,87,278,49,352,327,413,469,366,341,23,29,17,13
2013_02_JAX_OAK,LV,JAX,2,2013,126,226,241,34,352,275,388,228,305,294,18,2,10,9
2013_02_MIA_IND,IND,MIA,2,2013,321,133,319,101,454,420,305,292,388,336,10,8,18,12
2013_02_MIN_CHI,CHI,MIN,2,2013,292,127,227,123,419,350,323,341,345,469,11,13,14,29
2013_02_NO_TB,TB,NO,2,2013,125,160,322,75,285,397,275,435,346,392,6,25,15,20
2013_02_NYJ_NE,NE,NYJ,2,2013,185,54,214,129,239,343,446,346,286,275,26,15,7,6
2013_02_PIT_CIN,CIN,PIT,2,2013,280,127,251,44,407,295,345,222,323,237,14,1,11,3
2013_02_SD_PHI,PHI,LAC,2,2013,428,100,419,126,528,545,466,275,403,466,28,6,22,28
2013_02_SF_SEA,SEA,SF,2,2013,142,172,127,100,314,227,390,502,259,396,19,31,4,21
2013_02_STL_ATL,ATL,LA,2,2013,374,36,352,69,410,421,392,366,435,413,20,17,25,23
2013_02_TEN_HOU,HOU,TEN,2,2013,298,172,148,119,470,267,466,237,275,222,28,3,6,1
2013_02_WAS_GB,GB,WAS,2,2013,480,139,320,108,619,428,396,403,502,466,21,22,31,28
2013_03_ARI_NO,NO,ARI,3,2013,342,104,187,86,446,273,416,382.5,280,398,27,21,4,23
2013_03_ATL_MIA,MIA,ATL,3,2013,236,90,231,146,326,377,356,401,379.5,393.5,13,24,20,22
2013_03_BUF_NYJ,NYJ,BUF,3,2013,331,182,243,120,513,363,344.5,365.5,342.5,306.5,10,16,9,5
2013_03_CHI_PIT,PIT,CHI,3,2013,406,80,159,107,486,266,258.5,371,376,345.5,3,18,19,11
2013_03_CLE_MIN,MIN,CLE,3,2013,228,134,332,103,362,435,345.5,317,371,365,11,7,18,15
2013_03_DET_WAS,WAS,DET,3,2013,326,120,385,63,446,448,415.5,398,507.5,382.5,26,23,32,21
2013_03_GB_CIN,CIN,GB,3,2013,235,82,244,182,317,426,376,507.5,258.5,415.5,19,32,3,26
2013_03_HOU_BAL,BAL,HOU,3,2013,171,75,194,94,246,288,365,468,317,252,15,29,7,2
2013_03_IND_SF,SF,IND,3,2013,150,115,159,184,265,343,364.5,379.5,352,356,14,20,12,13
2013_03_JAX_SEA,SEA,JAX,3,2013,331,156,235,51,487,286,352,251.5,364.5,370,12,1,14,17
2013_03_KC_PHI,PHI,KC,3,2013,201,264,273,146,465,419,497,315.5,410,342.5,31,6,25,9
2013_03_NYG_CAR,CAR,NYG,3,2013,223,194,135,60,417,195,306.5,442.5,365.5,470.5,5,28,16,30
2013_03_OAK_DEN,DEN,LV,3,2013,374,164,316,49,538,365,470.5,370,442.5,251.5,30,17,28,1
2013_03_SD_TEN,TEN,LAC,3,2013,299,170,184,102,469,286,252,410,468,497,2,25,29,31
2013_03_STL_DAL,DAL,LA,3,2013,210,193,240,35,403,275,342.5,393.5,315.5,401,9,22,6,24
2013_03_TB_NE,NE,TB,3,2013,225,156,236,97,381,333,342.5,280,344.5,416,9,4,10,27
2013_04_ARI_TB,TB,ARI,4,2013,193,80,248,56,273,304,297.6666666666667,346,355.3333333333333,426,2,9,14,27
2013_04_BAL_BUF,BUF,BAL,4,2013,167,203,347,24,370,371,364.6666666666667,325.3333333333333,400.6666666666667,408,18,4,23,24
2013_04_CHI_DET,DET,CHI,4,2013,242,159,317,131,401,448,414.6666666666667,336,425.6666666666667,334.3333333333333,26,7,26,6
2013_04_CIN_CLE,CLE,CIN,4,2013,269,89,206,63,358,269,356.3333333333333,356.3333333333333,351,480.3333333333333,15,15,12,28
2013_04_DAL_SD,LAC,DAL,4,2013,401,112,246,92,513,338,368.6666666666667,362.6666666666667,324.3333333333333,354,21,17,3,13
2013_04_IND_JAX,JAX,IND,4,2013,179,40,294,157,219,451,263,367.3333333333333,397,331.3333333333333,1,19,22,5
2013_04_MIA_NO,NO,MIA,4,2013,413,68,249,115,481,364,426,346,346,393,28,9,10,21
2013_04_NE_ATL,ATL,NE,4,2013,421,58,316,132,479,448,393,355.3333333333333,346,297.6666666666667,22,13,10,2
2013_04_NYG_KC,KC,NYG,4,2013,288,102,217,98,390,315,350,360,486.3333333333333,343.3333333333333,10,16,29,8
2013_04_NYJ_TEN,TEN,NYJ,4,2013,257,78,289,91,335,380,324.3333333333333,400.6666666666667,368.6666666666667,364.6666666666667,3,24,20,17
2013_04_PHI_DEN,DEN,PHI,4,2013,337,141,297,166,478,463,493,486.3333333333333,368.3333333333333,350,30,29,19,11
2013_04_PIT_MIN,MIN,PIT,4,2013,248,145,383,77,393,460,351,334.3333333333333,356.3333333333333,336,11,6,15,7
2013_04_SEA_HOU,HOU,SEA,4,2013,355,151,123,179,506,302,408,397,325.3333333333333,263,25,23,4,1
2013_04_SF_STL,LA,SF,4,2013,202,18,167,219,220,386,354,331.3333333333333,362.6666666666667,367.3333333333333,12,5,16,18
2013_04_WAS_OAK,LV,WAS,4,2013,227,104,227,122,331,349,368.3333333333333,425.6666666666667,493,414.6666666666667,20,27,30,25
2013_05_BAL_MIA,MIA,BAL,5,2013,307,22,269,133,329,402,350.5,336.75,439.75,366,10,6,26,16
2013_05_BUF_CLE,CLE,BUF,5,2013,222,91,209,155,313,364,356.75,366,334.5,336.75,12,16,5,6
2013_05_CAR_ARI,ARI,CAR,5,2013,175,90,308,95,265,403,335.5,343.3333333333333,291.5,360,5,7,2,14
2013_05_DEN_DAL,DAL,DEN,5,2013,506,52,414,103,558,517,356.5,489.25,404.75,480.5,11,28,21,27
2013_05_DET_GB,GB,DET,5,2013,274,180,262,64,454,326,480.3333333333333,411.25,356.3333333333333,364,26,22,10,15
2013_05_HOU_SF,SF,HOU,5,2013,113,177,188,131,290,319,345,432.5,320.5,373.25,8,24,3,17
2013_05_JAX_STL,LA,JAX,5,2013,222,143,270,96,365,366,320.5,252,345,388.25,2,1,7,19
2013_05_KC_TEN,TEN,KC,5,2013,247,105,245,120,352,365,327,360,395.5,348.75,3,14,20,8
2013_05_NE_CIN,CIN,NE,5,2013,212,162,197,82,374,279,334.5,378.5,356.75,414.5,4,18,12,24
2013_05_NO_CHI,CHI,NO,5,2013,358,94,288,64,452,352,364,439.75,411.25,350.5,15,25,23,9
2013_05_NYJ_ATL,ATL,NYJ,5,2013,311,64,199,118,375,317,414.5,395.5,378.5,327,23,20,18,4
2013_05_PHI_NYG,NYG,PHI,5,2013,334,53,302,140,387,442,348.75,480.5,360,489.25,9,27,14,28
2013_05_SD_OAK,LV,LAC,5,2013,221,104,411,36,325,447,359,404.75,406.5,356.5,13,21,22,11
2013_05_SEA_IND,IND,SEA,5,2013,229,109,210,218,338,428,388.25,373.25,252,432.5,19,17,1,25
2013_06_ARI_SF,SF,ARI,6,2013,252,149,298,109,401,407,334,321.4,409.8,355.26666666666665,6,3,25,11
2013_06_CAR_MIN,MIN,CAR,6,2013,241,75,242,131,316,373,361.5,358.25,365.75,317.875,15,12,18,2
2013_06_CIN_BUF,BUF,CIN,6,2013,216,130,337,165,346,502,365.6,342.4,348,358.6,16,7,9,13
2013_06_DET_CLE,CLE,DET,6,2013,292,126,248,118,418,366,348,394.2,365.6,475.0666666666666,8,22,17,29
2013_06_GB_BAL,BAL,GB,6,2013,342,47,315,140,389,455,349.8,473.75,346.2,389.9375,9,29,8,22
2013_06_IND_SD,LAC,IND,6,2013,237,147,202,74,384,276,413.2,378.2,352.2,384.2,26,18,10,21
2013_06_JAX_DEN,DEN,JAX,6,2013,295,112,303,71,407,374,494.8,274.8,396.8,329.4,30,1,23,3
2013_06_NO_NE,NE,NO,6,2013,269,141,236,131,410,367,358.6,422.2,342.4,381.6,13,27,7,20
2013_06_NYG_CHI,CHI,NYG,6,2013,262,110,239,123,372,362,381.6,356.4,422.2,472.8,20,11,27,28
2013_06_OAK_KC,KC,LV,6,2013,128,111,216,121,239,337,361,352.2,332,413.2,14,10,4,26
2013_06_PHI_TB,TB,PHI,6,2013,273,94,296,138,367,434,291.5,472.8,335.5,356.4,2,28,6,12
2013_06_PIT_NYJ,NYJ,PIT,6,2013,201,83,279,73,284,352,379.8,365.75,406.6,361.5,19,17,24,16
2013_06_STL_HOU,HOU,LA,6,2013,284,153,117,99,437,216,409.8,329.4,334,274.8,25,4,5,1
2013_06_TEN_SEA,SEA,TEN,6,2013,257,151,171,66,408,237,384.2,332,378.2,361,21,5,19,15
2013_06_WAS_DAL,DAL,WAS,6,2013,170,48,246,216,218,462,396.8,406.5,494.8,359,23,24,30,14
2013_07_BAL_PIT,PIT,BAL,7,2013,160,141,215,82,301,297,363,356.3333333333333,360.64,470.625,16,10,13,29
2013_07_BUF_MIA,MIA,BUF,7,2013,194,120,202,90,314,292,346.2,362.3333333333333,349.8,369,8,15,8,19
2013_07_CHI_WAS,WAS,CHI,7,2013,298,209,232,140,507,372,417.6,380,361.04,357.3333333333333,27,21,14,10
2013_07_CIN_DET,DET,CIN,7,2013,357,77,372,57,434,429,389.5,369,359.6666666666667,362.3333333333333,23,20,12,17
2013_07_CLE_GB,GB,CLE,7,2013,260,104,149,83,364,232,470,359.6666666666667,357.64,389.5,29,12,11,23
2013_07_DAL_PHI,PHI,DAL,7,2013,209,84,317,74,293,391,466.3333333333333,367,304.0833333333333,415.75,28,18,2,27
2013_07_DEN_IND,IND,DEN,7,2013,228,121,386,64,349,450,361.1666666666667,480.1666666666667,408.3333333333333,291.3333333333333,13,30,24,1
2013_07_HOU_KC,KC,HOU,7,2013,240,126,271,73,366,344,340.6666666666667,414.3333333333333,349.6666666666667,310.5,6,26,7,3
2013_07_MIN_NYG,NYG,MIN,7,2013,200,64,190,30,264,220,357.3333333333333,352.4,380,361.2,11,9,21,16
2013_07_NE_NYJ,NYJ,NE,7,2013,233,177,228,90,410,318,363.8333333333333,367.1666666666667,363.4583333333333,413,17,19,18,25
2013_07_SD_JAX,JAX,LAC,7,2013,318,78,285,158,396,443,291.3333333333333,408.3333333333333,480.1666666666667,361.1666666666667,1,25,30,15
2013_07_SEA_ARI,ARI,SEA,7,2013,258,30,235,135,288,370,335.6666666666667,388.1666666666667,345.1666666666667,316.1666666666667,5,22,6,4
2013_07_SF_TEN,TEN,SF,7,2013,326,70,199,153,396,352,316.1666666666667,345.1666666666667,388.1666666666667,335.6666666666667,4,7,22,5
2013_07_STL_CAR,CAR,LA,7,2013,204,102,274,63,306,337,361.2,310.5,352.4,414.3333333333333,14,3,9,26
2013_07_TB_ATL,ATL,TB,7,2013,273,18,256,111,291,367,406.6,306.6,379.8,465.03999999999996,24,2,20,28
2013_08_ATL_ARI,ARI,ATL,8,2013,172,201,301,27,373,328,328.85714285714283,387.3333333333333,385.57142857142856,316.6666666666667,4,20,20,2
2013_08_BUF_NO,NO,BUF,8,2013,332,77,234,88,409,322,413,352.2857142857143,367.1666666666667,341.59999999999997,22,13,15,8
2013_08_CAR_TB,TB,CAR,8,2013,275,48,221,129,323,350,316.6666666666667,352,387.3333333333333,314.9166666666667,3,12,21,1
2013_08_CLE_KC,KC,CLE,8,2013,225,136,293,57,361,350,344.2857142857143,341.42857142857144,404.2857142857143,454.85714285714283,9,7,23,26
2013_08_DAL_DET,DET,DAL,8,2013,488,143,206,62,631,268,395.85714285714283,370.42857142857144,377.57142857142856,441.57142857142856,21,17,18,25
2013_08_GB_MIN,MIN,GB,8,2013,145,111,285,182,256,467,330.3333333333333,452.3333333333333,341.77777777777777,338.3888888888889,5,25,9,6
2013_08_MIA_NE,NE,MIA,8,2013,116,152,192,156,268,348,360.14285714285717,340.8333333333333,370.42857142857144,350.6111111111111,15,6,17,11
2013_08_NYG_PHI,PHI,NYG,8,2013,188,48,246,88,236,334,441.57142857142856,344,370.42857142857144,333.4857142857142,24,8,17,5
2013_08_NYJ_CIN,CIN,NYJ,8,2013,325,79,176,93,404,269,377.57142857142856,370.42857142857144,395.85714285714283,360.14285714285717,18,17,22,14
2013_08_PIT_OAK,LV,PIT,8,2013,88,197,275,35,285,310,349.6666666666667,352.6666666666667,340.6666666666667,346.4444444444444,11,14,7,10
2013_08_SEA_STL,LA,SEA,8,2013,158,200,139,44,358,183,314.2857142857143,385.57142857142856,353.3142857142857,328.85714285714283,2,19,12,4
2013_08_SF_JAX,JAX,SF,8,2013,228,90,177,221,318,398,306.2857142857143,346.14285714285717,413.2857142857143,327.57142857142856,1,10,24,3
2013_08_WAS_DEN,DEN,WAS,8,2013,354,107,180,112,461,292,475.85714285714283,432.5,359.42857142857144,378.6666666666667,26,23,13,19
2013_09_ATL_CAR,CAR,ATL,9,2013,249,131,219,78,380,297,351.7142857142857,378.85714285714283,317.57142857142856,335.1632653061224,13,19,2,5
2013_09_BAL_CLE,CLE,BAL,9,2013,260,73,250,55,333,305,342.5,347.85714285714283,346.375,354.14285714285717,7,10,12,17
2013_09_CHI_GB,GB,CHI,9,2013,141,199,272,171,340,443,454.42857142857144,378.85714285714283,319.7142857142857,430.3714285714286,26,19,3,23
2013_09_CIN_MIA,MIA,CIN,9,2013,208,157,338,163,365,501,341.85714285714283,380.875,346.97959183673476,357.75,6,20,14,18
2013_09_IND_HOU,HOU,IND,9,2013,350,143,271,69,493,340,404.2857142857143,359.42857142857144,344.2857142857143,475.85714285714283,21,16,10,26
2013_09_KC_BUF,BUF,KC,9,2013,229,241,124,95,470,219,348.5,346.375,412.5,342.5,11,8,21,8
2013_09_MIN_DAL,DAL,MIN,9,2013,337,36,236,169,373,405,357.625,319.7142857142857,425.25,454.42857142857144,14,2,22,24
2013_09_NO_NYJ,NYJ,NO,9,2013,140,198,382,41,338,423,357.75,412.42857142857144,380.875,347.9591836734694,15,23,20,15
2013_09_PHI_OAK,LV,PHI,9,2013,375,210,419,106,585,525,340.42857142857144,415.875,346.57142857142856,342.75,5,25,13,9
2013_09_PIT_NE,NE,PIT,9,2013,432,197,400,108,629,508,348.625,346.57142857142856,341.72916666666663,340.42857142857144,12,9,7,6
2013_09_SD_WAS,WAS,LAC,9,2013,291,209,341,69,500,410,412.42857142857144,413.2857142857143,473.73469387755097,306.2857142857143,23,24,25,1
2013_09_TB_SEA,SEA,TB,9,2013,217,198,170,205,415,375,360.25,317.57142857142856,319.75,351.7142857142857,17,1,4,16
2013_09_TEN_STL,LA,TEN,9,2013,210,160,185,198,370,383,319.75,327.57142857142856,360.25,346.14285714285717,3,4,19,11
2013_10_BUF_PIT,PIT,BUF,10,2013,204,136,155,95,340,250,366.75,362,383.671875,332.22222222222223,16,14,19,5
2013_10_CAR_SF,SF,CAR,10,2013,91,105,169,109,196,278,352.625,355.25,307.75,368.625,10,11,1,17
2013_10_CIN_BAL,BAL,CIN,10,2013,140,85,274,120,225,394,342.5,394.22222222222223,341.3125,344.4285714285714,7,20,7,8
2013_10_DAL_NO,NO,DAL,10,2013,392,242,128,89,634,217,413.75,359.3333333333333,355.28125,329.1904761904762,22,13,11,4
2013_10_DEN_SD,LAC,DEN,10,2013,218,131,330,84,349,414,412.875,474,423.375,414.9375,21,28,26,23
2013_10_DET_CHI,CHI,DET,10,2013,312,38,219,145,350,364,386.875,425.25,440.125,357.625,19,25,28,13
2013_10_HOU_ARI,ARI,HOU,10,2013,241,97,201,76,338,277,334.375,415.375,379.91666666666663,357,5,23,18,12
2013_10_JAX_TEN,TEN,JAX,10,2013,288,83,180,54,371,234,334.5,307.75,326.03125,352.625,6,1,3,9
2013_10_MIA_TB,TB,MIA,10,2013,139,140,229,2,279,231,324.75,344.75,367.09375,395.890625,2,9,15,21
2013_10_OAK_NYG,NYG,LV,10,2013,140,133,122,107,273,229,342.75,371,415.875,429.515625,8,18,25,27
2013_10_PHI_GB,GB,PHI,10,2013,305,99,228,204,404,432,440.125,428,386.875,367.60317460317464,27,26,20,16
2013_10_SEA_ATL,ATL,SEA,10,2013,172,64,287,211,236,498,368.625,366.3333333333333,355.25,323.95238095238096,17,15,10,2
2013_10_STL_IND,IND,LA,10,2013,421,18,247,140,439,387,357,325.3333333333333,415.375,333.73015873015873,12,3,24,6
2013_10_WAS_MIN,MIN,WAS,10,2013,221,91,281,191,312,472,330.375,423.375,359.546875,412.875,4,24,14,22
2013_11_ARI_JAX,JAX,ARI,11,2013,255,32,419,14,287,433,299.55555555555554,334.77777777777777,338.55555555555554,400,1,7,10,23
2013_11_ATL_TB,TB,ATL,11,2013,231,186,288,152,417,440,319.6666666666667,353.8888888888889,332.1111111111111,380.96296296296293,2,14,5,20
2013_11_BAL_CHI,CHI,BAL,11,2013,216,104,162,174,320,336,382.77777777777777,329.44444444444446,418.44444444444446,394.1975308641975,21,4,26,22
2013_11_CLE_CIN,CIN,CLE,11,2013,118,106,248,102,224,350,394.2,341.44444444444446,330.75,343.0952380952381,22,11,4,11
2013_11_DET_PIT,PIT,DET,11,2013,367,40,362,107,407,469,363.77777777777777,418.44444444444446,349.55555555555554,382.77777777777777,17,25,14,21
2013_11_GB_NYG,NYG,GB,11,2013,279,78,339,55,357,394,335,436.1111111111111,355.22222222222223,428.44444444444446,8,28,15,27
2013_11_IND_TEN,TEN,IND,11,2013,222,122,232,137,344,369,338.55555555555554,366.1111111111111,299.55555555555554,332.18518518518516,10,18,1,6
2013_11_KC_DEN,DEN,KC,11,2013,323,104,230,144,427,374,467.3333333333333,332.22222222222223,405.77777777777777,362,30,6,24,17
2013_11_MIN_SEA,SEA,MIN,11,2013,236,93,207,132,329,339,379.5,328.3333333333333,355.3625,428.77777777777777,19,3,16,28
2013_11_NE_CAR,CAR,NE,11,2013,209,103,296,107,312,403,346.6666666666667,379.77777777777777,335.22222222222223,364.5079365079365,12,20,9,19
2013_11_NYJ_BUF,BUF,NYJ,11,2013,245,68,163,134,313,297,350.8,355.55555555555554,364.075,413.60317460317464,13,16,18,25
2013_11_OAK_HOU,HOU,LV,11,2013,325,90,197,165,415,362,400,355.22222222222223,334.77777777777777,335,23,15,7,8
2013_11_SD_MIA,MIA,LAC,11,2013,268,104,298,154,372,452,332.1111111111111,405.77777777777777,319.6666666666667,467.3333333333333,5,24,2,30
2013_11_SF_NO,NO,SF,11,2013,305,92,127,81,397,208,438.22222222222223,335.22222222222223,343.5185185185185,346.6666666666667,29,9,12,13
2013_11_WAS_PHI,PHI,WAS,11,2013,298,126,264,191,424,455,428.4,428.77777777777777,436.5125,328.3333333333333,26,27,29,3
2013_12_CAR_MIA,MIA,CAR,12,2013,310,52,174,136,362,310,336.1,343.2,410.4,382.1,7,12,22,20
2013_12_CHI_STL,LA,CHI,12,2013,167,258,352,80,425,432,331.5,376.5,365.2,330.1,6,20,14,4
2013_12_DAL_NYG,NYG,DAL,12,2013,174,202,234,107,376,341,337.2,345.1,431.9,435.775,9,14,25,27
2013_12_DEN_NE,NE,DEN,12,2013,344,116,150,280,460,430,382.1,463.3,343.2,336.4,21,28,9,6
2013_12_IND_ARI,ARI,IND,12,2013,314,120,163,80,434,243,344.6,366.4,298.3,339.1,13,18,1,8
2013_12_JAX_HOU,HOU,JAX,12,2013,169,77,239,118,246,357,401.5,298.3,355.9,344.6,22,1,12,10
2013_12_MIN_GB,GB,MIN,12,2013,316,196,233,232,512,465,431.9,329.4,337.2,374.45,26,4,7,17
2013_12_NO_ATL,ATL,NO,12,2013,292,91,278,103,383,381,362.5,434.1,329.4,322.5,17,27,3,2
2013_12_NYJ_BAL,BAL,NYJ,12,2013,273,67,140,102,340,242,330.1,349.7,376.5,347.02000000000004,5,15,18,11
2013_12_PIT_CLE,CLE,PIT,12,2013,333,55,217,85,388,302,342.3,368.1,377.17999999999995,423.5,11,19,19,23
2013_12_SD_KC,KC,LAC,12,2013,294,114,392,104,408,496,336.4,410.4,463.3,336.1,8,23,28,5
2013_12_SF_WAS,WAS,SF,12,2013,118,114,235,76,232,311,431.4,322.5,427.96000000000004,434.1,25,2,24,26
2013_12_TB_DET,DET,TB,12,2013,297,104,247,22,401,269,423.5,329.4,368.1,362.5,24,4,16,13
2013_12_TEN_OAK,LV,TEN,12,2013,260,93,320,114,353,434,355.9,339.1,401.5,366.4,16,10,21,15
2013_13_ARI_PHI,PHI,ARI,13,2013,237,105,302,90,342,392,428,352.72727272727275,431.1616161616161,355.1818181818182,29,16,30,19
2013_13_ATL_BUF,BUF,ATL,13,2013,210,195,311,151,405,462,347.3636363636364,364.3636363636364,350.23232323232327,429.27272727272725,14,20,17,29
2013_13_CHI_MIN,MIN,CHI,13,2013,283,246,355,135,529,490,341.72727272727275,381.54545454545456,439.1818181818182,340,10,23,31,8
2013_13_CIN_SD,LAC,CIN,13,2013,252,91,190,164,343,354,418.1818181818182,378.72727272727275,342.90909090909093,342.22222222222223,27,22,13,12
2013_13_DEN_KC,KC,DEN,13,2013,293,159,403,132,452,535,342.90909090909093,460.27272727272725,418.1818181818182,389.1818181818182,11,32,27,25
2013_13_GB_DET,DET,GB,13,2013,330,241,139,24,571,163,421.45454545454544,439.1818181818182,323.90909090909093,341.72727272727275,28,31,3,11
2013_13_JAX_CLE,CLE,JAX,13,2013,370,97,203,112,467,315,346.45454545454544,303.6363636363636,362.09090909090907,387.3636363636364,13,1,21,24
2013_13_MIA_NYJ,NYJ,MIA,13,2013,108,99,331,125,207,456,339.90909090909093,338.45454545454544,331,340.1818181818182,6,5,5,9
2013_13_NE_HOU,HOU,NE,13,2013,272,121,371,88,393,459,387.3636363636364,389.1818181818182,303.6363636363636,460.27272727272725,24,25,1,32
2013_13_NO_SEA,SEA,NO,13,2013,310,127,147,44,437,191,374.90909090909093,429.27272727272725,329.30303030303025,364.3636363636364,21,30,4,22
2013_13_NYG_WAS,WAS,NYG,13,2013,207,139,235,80,346,315,413.27272727272725,340.72727272727275,321.45454545454544,344.72727272727275,26,9,2,14
2013_13_OAK_DAL,DAL,LV,13,2013,225,144,255,50,369,305,344.72727272727275,355.6363636363636,340.72727272727275,347.72727272727275,12,18,10,16
2013_13_PIT_BAL,BAL,PIT,13,2013,251,74,257,72,325,329,331,362.09090909090907,339.90909090909093,346.45454545454544,4,19,7,15
2013_13_STL_SF,SF,LA,13,2013,275,83,218,114,358,332,321.45454545454544,340,413.27272727272725,381.54545454545456,2,7,26,23
2013_13_TB_CAR,CAR,TB,13,2013,263,163,180,66,426,246,340.1818181818182,323.90909090909093,338.45454545454544,421.45454545454544,8,3,6,28
2013_13_TEN_IND,IND,TEN,13,2013,200,104,201,162,304,363,355.1818181818182,347.72727272727275,352.72727272727275,355.6363636363636,17,15,18,20
2013_14_ATL_GB,GB,ATL,14,2013,258,112,206,83,370,289,416.1666666666667,372.5,433.9166666666667,352.1666666666667,29,20,31,15
2013_14_BUF_TB,TB,BUF,14,2013,90,165,184,67,255,251,317.4166666666667,352.1666666666667,347.3333333333333,372.5,2,15,9,20
2013_14_CAR_NO,NO,CAR,14,2013,313,69,160,128,382,288,409.4166666666667,347.3333333333333,380.0833333333333,317.4166666666667,27,9,22,2
2013_14_CLE_NE,NE,CLE,14,2013,418,87,391,108,505,499,395,356.5,387.8333333333333,304.5833333333333,25,17,23,1
2013_14_DAL_CHI,CHI,DAL,14,2013,348,149,144,198,497,342,390.5833333333333,346.75,357.3333333333333,351.4166666666667,24,8,18,13
2013_14_DET_PHI,PHI,DET,14,2013,179,299,151,80,478,231,420.8333333333333,433.9166666666667,356,416.1666666666667,30,31,16,29
2013_14_HOU_JAX,JAX,HOU,14,2013,138,149,357,83,287,440,304.5833333333333,387.8333333333333,356.5,395,1,23,17,25
2013_14_IND_CIN,CIN,IND,14,2013,275,155,326,63,430,389,376.6666666666667,350.9166666666667,411.9166666666667,349,21,12,28,11
2013_14_KC_WAS,WAS,KC,14,2013,223,65,154,192,288,346,407.6666666666667,352,338.5833333333333,466.5,26,14,6,32
2013_14_MIA_PIT,PIT,MIA,14,2013,349,84,200,181,433,381,359.3333333333333,348.25,330.5,328.83333333333337,19,10,5,4
2013_14_MIN_BAL,BAL,MIN,14,2013,245,97,265,114,342,379,330.5,357.3333333333333,359.3333333333333,390.5833333333333,5,18,19,24
2013_14_NYG_SD,LAC,NYG,14,2013,249,144,259,92,393,351,411.9166666666667,338.5833333333333,376.6666666666667,407.6666666666667,28,6,21,26
2013_14_OAK_NYJ,NYJ,LV,14,2013,219,143,265,150,362,415,328.83333333333337,351.4166666666667,348.25,346.75,4,13,10,8
2013_14_SEA_SF,SF,SEA,14,2013,175,163,199,86,338,285,324.5,380.0833333333333,339.3333333333333,409.4166666666667,3,22,7,27
2013_14_STL_ARI,ARI,LA,14,2013,269,107,181,100,376,281,356,339.3333333333333,420.8333333333333,324.5,16,7,30,3
2013_14_TEN_DEN,DEN,TEN,14,2013,397,154,172,96,551,268,466.5,349,352,350.9166666666667,32,11,14,12
2013_15_ARI_TEN,TEN,ARI,15,2013,402,66,231,145,468,376,342.7692307692308,357.53846153846155,473,334.84615384615387,9,16,32,6
2013_15_BAL_DET,DET,BAL,15,2013,235,119,222,90,354,312,418.3076923076923,331.38461538461536,425.2307692307692,359,30,5,31,17
2013_15_BUF_JAX,JAX,BUF,15,2013,237,159,193,198,396,391,303.2307692307692,344.38461538461536,391.84615384615387,312.61538461538464,1,10,23,2
2013_15_CHI_CLE,CLE,CHI,15,2013,273,93,265,179,366,444,367.46153846153845,398.7692307692308,403.46153846153845,346.38461538461536,20,25,26,11
2013_15_CIN_PIT,PIT,CIN,15,2013,191,106,230,57,297,287,365,380.7692307692308,350.7692307692308,353.84615384615387,18,22,12,14
2013_15_GB_DAL,DAL,GB,15,2013,358,134,299,150,492,449,346.38461538461536,412.61538461538464,398.7692307692308,366.0769230769231,11,29,25,19
2013_15_HOU_IND,IND,HOU,15,2013,180,152,168,107,332,275,353.84615384615387,391.84615384615387,380.7692307692308,303.2307692307692,14,23,22,1
2013_15_KC_OAK,LV,KC,15,2013,331,130,318,78,461,396,356.3076923076923,351.53846153846155,331.38461538461536,398.46153846153845,15,13,5,24
2013_15_NE_MIA,MIA,NE,15,2013,312,89,364,96,401,460,350.7692307692308,403.46153846153845,365,367.46153846153845,12,26,18,20
2013_15_NO_STL,LA,NO,15,2013,158,144,393,61,302,454,334.84615384615387,407.3076923076923,357.53846153846155,342.7692307692308,6,27,16,9
2013_15_NYJ_CAR,CAR,NYJ,15,2013,273,131,167,157,404,324,342.7692307692308,331.38461538461536,407.3076923076923,356.3076923076923,9,5,27,15
2013_15_PHI_MIN,MIN,PHI,15,2013,382,85,428,79,467,507,359,425.2307692307692,331.38461538461536,418.3076923076923,17,31,5,30
2013_15_SD_DEN,DEN,LAC,15,2013,289,18,166,177,307,343,473,410.46153846153845,342.7692307692308,339.53846153846155,32,28,9,7
2013_15_SEA_NYG,NYG,SEA,15,2013,186,25,222,134,211,356,339.53846153846155,372.7692307692308,410.46153846153845,325.53846153846155,7,21,28,3
2013_15_SF_TB,TB,SF,15,2013,179,39,203,187,218,390,312.61538461538464,325.53846153846155,344.38461538461536,372.7692307692308,2,3,10,21
2013_15_WAS_ATL,ATL,WAS,15,2013,210,54,381,103,264,484,366.0769230769231,398.46153846153845,412.61538461538464,351.53846153846155,19,24,29,13
2013_16_ARI_SEA,SEA,ARI,16,2013,108,103,178,139,211,317,371.57142857142856,358.85714285714283,330.35714285714283,351.7142857142857,21,16,5,10
2013_16_ATL_SF,SF,ATL,16,2013,197,199,348,61,396,409,330.14285714285717,358.7857142857143,305.85714285714283,404.57142857142856,4,15,1,25
2013_16_CHI_PHI,PHI,CHI,16,2013,230,289,242,61,519,303,431.07142857142856,402,366.7142857142857,367.35714285714283,31,24,19,20
2013_16_CLE_NYJ,NYJ,CLE,16,2013,214,208,178,115,422,293,330.85714285714283,367.35714285714283,347.14285714285717,402,6,20,8,24
2013_16_DAL_WAS,WAS,DAL,16,2013,197,100,226,95,297,321,404.57142857142856,356.7857142857143,358.7857142857143,415.2142857142857,25,14,15,30
2013_16_DEN_HOU,HOU,DEN,16,2013,176,87,400,114,263,514,383.5,461.14285714285717,352.2857142857143,405.64285714285717,23,32,11,26
2013_16_IND_KC,KC,IND,16,2013,153,155,241,135,308,376,354.7142857142857,352.2857142857143,363.7857142857143,383.5,13,11,18,23
2013_16_MIA_BUF,BUF,MIA,16,2013,193,203,135,14,396,149,347.7142857142857,354.35714285714283,309.85714285714283,407.5,9,12,2,27
2013_16_MIN_CIN,CIN,MIN,16,2013,363,81,114,115,444,229,374.07142857142856,366.7142857142857,360.14285714285717,431.07142857142856,22,19,17,31
2013_16_NE_BAL,BAL,NE,16,2013,262,121,172,142,383,314,330,407.5,413.7142857142857,354.35714285714283,3,27,29,12
2013_16_NO_CAR,CAR,NO,16,2013,181,81,281,126,262,407,347.14285714285717,410.64285714285717,330.85714285714283,332.5,8,28,6,7
2013_16_NYG_DET,DET,NYG,16,2013,222,148,256,41,370,297,413.7142857142857,330.35714285714283,330,371.57142857142856,29,5,3,21
2013_16_OAK_SD,LAC,LV,16,2013,201,148,206,59,349,265,405.64285714285717,363.7857142857143,461.14285714285717,354.7142857142857,26,18,32,13
2013_16_PIT_GB,GB,PIT,16,2013,232,151,197,151,383,348,415.2142857142857,360.14285714285717,356.7857142857143,374.07142857142856,30,17,14,22
2013_16_TB_STL,LA,TB,16,2013,158,129,158,59,287,217,332.5,305.85714285714283,410.64285714285717,330.14285714285717,7,1,28,4
2013_16_TEN_JAX,JAX,TEN,16,2013,237,63,181,182,300,363,309.85714285714283,351.7142857142857,347.7142857142857,358.85714285714283,2,10,9,16
2013_17_BAL_CIN,CIN,BAL,17,2013,281,111,192,47,392,239,378.73333333333335,333.53333333333336,357.53333333333336,401.26666666666665,23,5,17,26
2013_17_BUF_NE,NE,BUF,17,2013,122,267,247,169,389,416,401.26666666666665,350.93333333333334,333.53333333333336,340.6666666666667,26,10,5,8
2013_17_CAR_ATL,ATL,CAR,17,2013,280,76,149,134,356,283,362.1333333333333,341.46666666666664,334.53333333333336,410.4,20,9,6,28
2013_17_CLE_PIT,PIT,CLE,17,2013,179,120,240,79,299,319,359.3333333333333,362.4,413.06666666666666,336.93333333333334,18,21,30,7
2013_17_DEN_OAK,LV,DEN,17,2013,207,64,351,124,271,475,357.2,464.6666666666667,401.8666666666667,375.46666666666664,16,32,27,22
2013_17_DET_MIN,MIN,DET,17,2013,189,174,217,63,363,280,357.53333333333336,410.8,378.73333333333335,328.1333333333333,17,29,23,3
2013_17_GB_CHI,CHI,GB,17,2013,226,121,318,160,347,478,395.4,413.06666666666666,436.93333333333334,359.3333333333333,24,30,31,18
2013_17_HOU_TEN,TEN,HOU,17,2013,166,151,229,65,317,294,352.46666666666664,375.46666666666664,309.2,464.6666666666667,12,22,2,32
2013_17_JAX_IND,IND,JAX,17,2013,307,80,331,42,387,373,353.8666666666667,309.2,351.6,352.46666666666664,13,2,11,12
2013_17_KC_SD,LAC,KC,17,2013,229,186,200,143,415,343,401.8666666666667,351.6,357.2,353.8666666666667,27,11,16,13
2013_17_NYJ_MIA,MIA,NYJ,17,2013,204,92,220,154,296,374,340.6666666666667,336.93333333333334,350.93333333333334,362.4,8,7,10,21
2013_17_PHI_DAL,DAL,PHI,17,2013,358,56,263,137,414,400,354.4,436.93333333333334,397.4,395.4,14,31,25,24
2013_17_SF_ARI,ARI,SF,17,2013,407,83,310,83,490,393,356.06666666666666,334.53333333333336,360.8666666666667,362.1333333333333,15,6,19,20
2013_17_STL_SEA,SEA,LA,17,2013,172,111,157,13,283,170,360.8666666666667,329.46666666666664,356.06666666666666,299.93333333333334,19,4,15,1
2013_17_TB_NO,NO,TB,17,2013,381,98,219,75,479,294,410.4,299.93333333333334,341.46666666666664,329.46666666666664,28,1,9,4
2013_17_WAS_NYG,NYG,WAS,17,2013,163,122,169,91,285,260,328.1333333333333,397.4,410.8,354.4,3,25,29,14
2013_18_KC_IND,IND,KC,18,2013,443,100,378,150,543,528,355.9375,351.0625,313.1875,402.6875,3,2,2,8
2013_18_NO_PHI,PHI,NO,18,2013,195,80,250,185,275,435,434.625,414.6875,358.125,299.5625,8,6,5,1
2013_18_SD_CIN,CIN,LAC,18,2013,334,113,128,196,447,324,379.5625,402.6875,327.625,351.0625,4,5,3,4
2013_18_SF_GB,GB,SF,18,2013,177,124,227,167,301,394,417.125,338.1875,392.375,364.4375,7,1,7,6
2013_19_IND_NE,NE,IND,19,2013,198,234,331,69,432,400,400.5,366.94117647058823,355,361.47058823529414,6,4,3,4
2013_19_NO_SEA,SEA,NO,19,2013,103,174,309,108,277,417,356,415.88235294117646,319.5,425.2352941176471,3,7,1,8
2013_19_SD_DEN,DEN,LAC,19,2013,230,133,217,65,363,282,465.3125,398.05882352941177,351.8125,383.52941176470586,8,5,2,6
2013_19_SF_CAR,CAR,SF,19,2013,267,93,196,126,360,322,337.8125,341.47058823529414,361.75,410.29411764705884,1,2,5,7
2013_20_NE_DEN,DEN,NE,20,2013,400,107,277,64,507,341,459.29411764705884,402.3529411764706,391.2318339100346,368.88581314878894,4,3,3,2
2013_20_SF_SEA,SEA,SF,20,2013,215,115,153,161,330,314,351.3529411764706,340.3888888888889,415.94809688581313,339.0451388888889,2,1,4,1
2013_21_SEA_DEN,DEN,SEA,21,2013,280,27,206,135,307,341,461.94444444444446,350.1666666666667,398.94444444444446,338.92283950617286,2,1,2,1
2014_01_BUF_CHI,CHI,BUF,1,2014,349,86,173,193,435,366,0,0,0,0,32,32,32,32
2014_01_CAR_TB,TB,CAR,1,2014,183,102,230,113,285,343,0,0,0,0,32,32,32,32
2014_01_CIN_BAL,BAL,CIN,1,2014,345,94,301,79,439,380,0,0,0,0,32,32,32,32
2014_01_CLE_PIT,PIT,CLE,1,2014,390,127,222,191,517,413,0,0,0,0,32,32,32,32
2014_01_GB_SEA,SEA,GB,1,2014,191,207,189,80,398,269,0,0,0,0,32,32,32,32
2014_01_IND_DEN,DEN,IND,1,2014,269,102,370,54,371,424,0,0,0,0,32,32,32,32
2014_01_JAX_PHI,PHI,JAX,1,2014,322,145,266,64,467,330,0,0,0,0,32,32,32,32
2014_01_MIN_STL,LA,MIN,1,2014,273,72,170,185,345,355,0,0,0,0,32,32,32,32
2014_01_NE_MIA,MIA,NE,1,2014,178,191,249,89,369,338,0,0,0,0,32,32,32,32
2014_01_NO_ATL,ATL,NO,1,2014,448,123,333,139,571,472,0,0,0,0,32,32,32,32
2014_01_NYG_DET,DET,NYG,1,2014,346,76,163,53,422,216,0,0,0,0,32,32,32,32
2014_01_OAK_NYJ,NYJ,LV,1,2014,221,212,151,25,433,176,0,0,0,0,32,32,32,32
2014_01_SD_ARI,ARI,LAC,1,2014,304,109,238,52,413,290,0,0,0,0,32,32,32,32
2014_01_SF_DAL,DAL,SF,1,2014,281,127,201,127,408,328,0,0,0,0,32,32,32,32
2014_01_TEN_KC,KC,TEN,1,2014,202,67,266,162,269,428,0,0,0,0,32,32,32,32
2014_01_WAS_HOU,HOU,WAS,1,2014,206,115,267,131,321,398,0,0,0,0,32,32,32,32
2014_02_ARI_NYG,NYG,ARI,2,2014,277,81,167,124,358,291,216,413,422,290,2,22,23,6
2014_02_ATL_CIN,CIN,ATL,2,2014,302,170,231,97,472,328,380,571,439,472,17,32,28,30
2014_02_CHI_SF,SF,CHI,2,2014,248,127,176,46,375,222,328,435,408,366,8,27,20,14
2014_02_DAL_TEN,TEN,DAL,2,2014,234,82,176,220,316,396,428,408,269,328,25,20,4,8
2014_02_DET_CAR,CAR,DET,2,2014,281,62,291,70,343,361,343,422,285,216,11,23,5,2
2014_02_HOU_OAK,LV,HOU,2,2014,263,101,139,188,364,327,176,321,433,398,1,7,26,19
2014_02_JAX_WAS,WAS,JAX,2,2014,288,191,193,25,479,218,398,330,321,467,19,9,7,29
2014_02_KC_DEN,DEN,KC,2,2014,242,88,255,133,330,388,371,269,424,428,16,4,24,25
2014_02_MIA_BUF,BUF,MIA,2,2014,202,113,241,80,315,321,366,369,435,338,14,15,27,10
2014_02_NE_MIN,MIN,NE,2,2014,202,54,149,150,256,299,355,338,345,369,13,10,12,15
2014_02_NO_CLE,CLE,NO,2,2014,204,122,237,174,326,411,413,472,517,571,22,30,31,32
2014_02_NYJ_GB,GB,NYJ,2,2014,346,80,176,110,426,286,269,433,398,176,4,26,19,1
2014_02_PHI_IND,IND,PHI,2,2014,172,169,331,127,341,458,424,467,371,330,24,29,16,9
2014_02_PIT_BAL,BAL,PIT,2,2014,166,157,217,99,323,316,439,517,380,413,28,31,17,22
2014_02_SEA_SD,LAC,SEA,2,2014,284,101,202,108,385,310,290,398,413,269,6,19,22,4
2014_02_STL_TB,TB,LA,2,2014,179,157,235,119,336,354,285,345,343,355,5,12,11,13
2014_03_BAL_CLE,CLE,BAL,3,2014,290,85,217,160,375,377,369.5,381,441.5,416.5,21,23,30,27
2014_03_CHI_NYJ,NYJ,CHI,3,2014,316,114,225,60,430,285,359.5,328.5,347.5,351.5,20,9,14,17
2014_03_DAL_STL,LA,DAL,3,2014,327,121,217,123,448,340,349.5,402,310.5,372,15,26,5,22
2014_03_DEN_SEA,SEA,DEN,3,2014,275,129,303,36,404,339,354,350.5,337.5,328.5,19,16,10,9
2014_03_GB_DET,DET,GB,3,2014,246,115,162,76,361,238,391.5,347.5,343,359.5,25,14,12,20
2014_03_HOU_NYG,NYG,HOU,3,2014,234,193,299,119,427,418,287,324,352,270,3,7,18,1
2014_03_IND_JAX,JAX,IND,3,2014,256,105,390,144,361,534,274,382.5,438.5,462.5,2,24,29,32
2014_03_KC_MIA,MIA,KC,3,2014,205,141,186,174,346,360,345,328.5,340.5,350.5,13,9,11,16
2014_03_MIN_NO,NO,MIN,3,2014,293,108,203,59,401,262,441.5,305.5,369.5,318.5,30,4,21,6
2014_03_OAK_NE,NE,LV,3,2014,234,76,174,67,310,241,318.5,270,305.5,324,6,1,4,7
2014_03_PIT_CAR,CAR,PIT,3,2014,330,42,196,264,372,460,343,416.5,391.5,381,12,27,25,23
2014_03_SD_BUF,BUF,LAC,3,2014,238,87,256,83,325,339,340.5,337.5,345,354,11,10,13,19
2014_03_SF_ARI,ARI,SF,3,2014,254,84,245,82,338,327,352,351.5,287,328.5,18,17,3,9
2014_03_TB_ATL,ATL,TB,3,2014,350,144,179,64,494,243,449.5,310.5,426,349.5,31,5,28,15
2014_03_TEN_CIN,CIN,TEN,3,2014,184,116,185,149,300,334,426,372,449.5,402,28,22,31,26
2014_03_WAS_PHI,PHI,WAS,3,2014,325,54,427,84,379,511,462.5,438.5,382.5,274,32,29,24,2
2014_04_ATL_MIN,MIN,ATL,4,2014,317,241,298,123,558,421,291,464.3333333333333,428,288,3,26,21,2
2014_04_BUF_HOU,HOU,BUF,4,2014,268,37,225,96,305,321,355.3333333333333,335.3333333333333,333.6666666666667,338,15,9,8,10
2014_04_CAR_BAL,BAL,CAR,4,2014,327,127,268,67,454,335,379.6666666666667,352.6666666666667,371.3333333333333,431,17,14,16,22
2014_04_DET_NYJ,NYJ,DET,4,2014,209,132,293,88,341,381,383,381.3333333333333,314,311,20,19,6,5
2014_04_GB_CHI,CHI,GB,4,2014,265,235,302,56,500,358,314,311,383,381.3333333333333,6,5,19,17
2014_04_JAX_SD,LAC,JAX,4,2014,377,42,254,85,419,339,338,303,335.3333333333333,433,10,4,9,23
2014_04_MIA_OAK,LV,MIA,4,2014,275,53,278,157,328,435,260.3333333333333,345.3333333333333,315.6666666666667,339,1,13,7,11
2014_04_NE_KC,KC,NE,4,2014,248,207,229,75,455,304,339,315.6666666666667,345.3333333333333,260.3333333333333,11,7,12,1
2014_04_NO_DAL,DAL,NO,4,2014,262,190,340,104,452,444,381.3333333333333,428,382.3333333333333,291,19,21,18,3
2014_04_NYG_WAS,WAS,NYG,4,2014,257,86,300,154,343,454,462.6666666666667,333.6666666666667,434.6666666666667,355.3333333333333,25,8,24,15
2014_04_PHI_SF,SF,PHI,4,2014,218,218,195,22,436,217,343.3333333333333,434.6666666666667,347.3333333333333,462.6666666666667,12,24,13,25
2014_04_TB_PIT,PIT,TB,4,2014,331,85,302,63,416,365,431,288,352.6666666666667,464.3333333333333,22,2,14,26
2014_04_TEN_IND,IND,TEN,4,2014,393,105,194,85,498,279,433,359.3333333333333,303,384,23,16,4,20
2014_05_ARI_DEN,DEN,ARI,5,2014,479,92,199,37,571,236,346.6666666666667,347.3333333333333,370.6666666666667,343.3333333333333,8,9,18,8
2014_05_ATL_NYG,NYG,ATL,5,2014,200,124,316,90,324,406,363.75,453.5,432.75,357.75,14,30,28,11
2014_05_BAL_IND,IND,BAL,5,2014,312,127,235,90,439,325,449.25,398.25,339.25,348.25,29,24,6,10
2014_05_BUF_DET,DET,BUF,5,2014,231,69,308,49,300,357,381.25,331.75,372.5,342.75,21,5,19,7
2014_05_CHI_CAR,CAR,CHI,5,2014,255,91,289,85,346,374,348.25,360.5,398.25,322.75,10,13,24,4
2014_05_CIN_NE,NE,CIN,5,2014,292,220,249,79,512,328,312.75,384,368,359.3333333333333,3,23,17,13
2014_05_CLE_TEN,TEN,CLE,5,2014,273,149,291,176,422,467,339.25,371.3333333333333,449.25,379.6666666666667,6,18,29,20
2014_05_HOU_DAL,DAL,HOU,5,2014,324,140,154,176,464,330,399,342.75,432,331.75,25,7,27,5
2014_05_KC_SF,SF,KC,5,2014,201,171,158,107,372,265,366.5,368,380.25,312.75,15,16,21,3
2014_05_MIN_GB,GB,MIN,5,2014,178,156,222,111,334,333,322.75,357.75,360.5,453.5,4,11,14,30
2014_05_NYJ_SD,LAC,NYJ,5,2014,288,162,74,91,450,165,358.25,372.5,312,381.25,12,19,2,22
2014_05_PIT_JAX,JAX,PIT,5,2014,191,56,273,111,247,384,312,427.25,358.25,307.25,2,26,12,1
2014_05_SEA_WAS,WAS,SEA,5,2014,283,32,201,225,315,426,432.75,370.6666666666667,363.75,346.6666666666667,28,17,15,9
2014_05_STL_PHI,PHI,LA,5,2014,207,145,375,125,352,500,380.25,382.3333333333333,366.5,381.3333333333333,20,22,16,23
2014_05_TB_NO,NO,TB,5,2014,371,140,249,66,511,315,432,307.25,399,427.25,27,1,25,26
2014_06_BAL_TB,TB,BAL,6,2014,314,87,306,169,401,475,308.8,383.6,447.8,447.2,3,21,30,29
2014_06_CAR_CIN,CIN,CAR,6,2014,323,193,284,147,516,431,370,347.8,362.5625,363.2,18,9,13,14
2014_06_CHI_ATL,ATL,CHI,6,2014,271,42,381,103,313,484,444,363.2,355.8,347.8,29,14,11,9
2014_06_DAL_SEA,SEA,DAL,6,2014,126,80,250,162,206,412,384.5,412,403.3125,340.2,22,27,24,7
2014_06_DEN_NYJ,NYJ,DEN,6,2014,190,31,237,138,221,375,331,402.75,376.6,319.5,6,24,19,3
2014_06_DET_MIN,MIN,DET,6,2014,188,69,185,100,257,285,352.8,365,325,336.8,11,15,4,6
2014_06_GB_MIA,MIA,GB,6,2014,244,112,264,121,356,385,367.75,325,277.25,352.8,17,5,1,10
2014_06_IND_HOU,HOU,IND,6,2014,212,136,370,93,348,463,340.2,447.2,412,383.6,8,30,26,21
2014_06_JAX_TEN,TEN,JAX,6,2014,233,70,336,82,303,418,355.8,299,390.46666666666664,418.6,13,2,22,27
2014_06_NE_BUF,BUF,NE,6,2014,299,68,361,50,367,411,336.8,352.6,365,372.8,7,10,15,17
2014_06_NYG_PHI,PHI,NYG,6,2014,248,203,211,86,451,297,374.6,355.8,405.8666666666667,444,19,13,25,28
2014_06_PIT_CLE,CLE,PIT,6,2014,217,158,228,138,375,366,395.25,418.6,359.9375,299,23,28,12,2
2014_06_SD_OAK,LV,LAC,6,2014,282,114,313,116,396,429,277.25,376.6,367.75,331,1,20,16,5
2014_06_SF_STL,LA,SF,6,2014,236,93,343,89,329,432,411.75,367.6,373.1875,347.4,26,16,18,8
2014_06_WAS_ARI,ARI,WAS,6,2014,250,74,354,72,324,426,319.5,409.2,402.75,381.73333333333335,4,25,23,20
2014_07_ARI_OAK,LV,ARI,7,2014,173,56,253,123,229,376,301,320.4,387.08000000000004,412.56000000000006,1,4,20,28
2014_07_ATL_BAL,BAL,ATL,7,2014,258,123,228,68,381,296,398.8333333333333,422.1666666666667,324.1666666666667,383.3333333333333,23,28,6,19
2014_07_CAR_GB,GB,CAR,7,2014,255,122,248,108,377,356,335,361.6666666666667,365.7916666666667,394.3333333333333,5,14,16,23
2014_07_CIN_IND,IND,CIN,7,2014,344,171,126,32,515,158,449.8333333333333,399.2,341.5,364.44,30,24,9,15
2014_07_CLE_JAX,JAX,CLE,7,2014,159,185,215,69,344,284,318.8333333333333,391.2,347,408.08000000000004,3,20,11,26
2014_07_HOU_PIT,PIT,HOU,7,2014,268,76,262,132,344,394,409.8333333333333,341.5,391.875,449.8333333333333,25,7,22,30
2014_07_KC_SD,LAC,KC,7,2014,205,69,221,154,274,375,385.3333333333333,347.4,297.0416666666667,367.6,19,11,1,17
2014_07_MIA_CHI,CHI,MIA,7,2014,190,52,277,137,242,414,383.3333333333333,365.4,422.1666666666667,337,18,16,29,8
2014_07_MIN_BUF,BUF,MIN,7,2014,283,118,157,158,401,315,341.8333333333333,336.8333333333333,362.3333333333333,351.6666666666667,8,6,14,12
2014_07_NO_DET,DET,NO,7,2014,299,59,342,73,358,415,351.6666666666667,447.8,336.8333333333333,308.8,13,29,7,2
2014_07_NYG_DAL,DAL,NYG,7,2014,279,156,248,104,435,352,412,346,354.75,387.3333333333333,27,9,13,21
2014_07_NYJ_NE,NE,NYJ,7,2014,261,63,226,218,324,444,362.3333333333333,312.6666666666667,341.8333333333333,398.125,15,2,10,25
2014_07_SEA_STL,LA,SEA,7,2014,173,102,313,171,275,484,395.2,348.8,380.48,412,21,12,18,27
2014_07_SF_DEN,DEN,SF,7,2014,318,115,301,62,433,363,397.2,378.3333333333333,309,397.9583333333333,22,17,3,24
2014_07_TEN_WAS,WAS,TEN,7,2014,267,100,160,76,367,236,412,347,320.25,318.8333333333333,27,10,5,4
2014_08_BAL_CIN,CIN,BAL,8,2014,266,111,195,107,377,302,359,396.2857142857143,460.6944444444444,404.14285714285717,14,23,30,27
2014_08_BUF_NYJ,NYJ,BUF,8,2014,158,175,238,67,333,305,331.42857142857144,350.2857142857143,356.85714285714283,333.7142857142857,6,10,14,6
2014_08_CHI_NE,NE,CHI,8,2014,376,122,249,153,498,402,356.85714285714283,363.14285714285717,331.42857142857144,372.3428571428571,13,16,5,20
2014_08_DET_ATL,ATL,DET,8,2014,228,78,325,60,306,385,404.14285714285717,352.57142857142856,396.2857142857143,443.11428571428576,26,12,24,29
2014_08_GB_NO,NO,GB,8,2014,311,193,426,89,504,515,442.3333333333333,341,352.72222222222223,360.85714285714283,29,8,13,16
2014_08_HOU_TEN,TEN,HOU,8,2014,299,36,227,212,335,439,331.14285714285717,349,405.57142857142856,400.42857142857144,5,9,28,26
2014_08_IND_PIT,PIT,IND,8,2014,522,117,400,63,639,463,400.42857142857144,459.14285714285717,349,364.74285714285713,24,30,10,17
2014_08_MIA_JAX,JAX,MIA,8,2014,221,176,196,148,397,344,322.42857142857144,373.5,375.88571428571424,359.77777777777777,2,20,23,15
2014_08_MIN_TB,TB,MIN,8,2014,171,66,241,97,237,338,324.1666666666667,333.7142857142857,398.8333333333333,350.2857142857143,3,7,25,11
2014_08_OAK_CLE,CLE,LV,8,2014,275,39,328,76,314,404,373.3333333333333,289,323.02777777777777,329.6666666666667,19,1,2,3
2014_08_PHI_ARI,ARI,PHI,8,2014,329,71,411,110,400,521,329.6666666666667,387.3333333333333,289,346,4,22,1,8
2014_08_SD_DEN,DEN,LAC,8,2014,286,139,252,61,425,313,403.1666666666667,369.42857142857144,375.77777777777777,351.3428571428571,25,17,22,12
2014_08_SEA_CAR,CAR,SEA,8,2014,171,106,199,119,277,318,360.85714285714283,371.3333333333333,341,375.1666666666667,15,18,7,21
2014_08_STL_KC,KC,LA,8,2014,223,140,160,84,363,244,352,375.1666666666667,366.77777777777777,371.3333333333333,11,21,18,19
2014_08_WAS_DAL,DAL,WAS,8,2014,278,171,299,123,449,422,415.2857142857143,405.57142857142856,346.85714285714283,331.14285714285717,28,27,9,4
2014_09_ARI_DAL,DAL,ARI,9,2014,183,92,249,102,275,351,419.5,339.7142857142857,407.625,406.42857142857144,23,6,22,21
2014_09_BAL_PIT,PIT,BAL,9,2014,340,55,303,63,395,366,430.25,384.5,459.625,361.25,24,19,26,11
2014_09_DEN_NE,NE,DEN,9,2014,333,66,438,43,399,481,374.5,406.2857142857143,368,361.3673469387755,17,20,16,12
2014_09_IND_NYG,NYG,IND,9,2014,359,89,354,98,448,452,346.85714285714283,459.625,415.2857142857143,430.25,7,26,23,25
2014_09_JAX_CIN,CIN,JAX,9,2014,233,191,247,132,424,379,361.57142857142856,331.75,382.81632653061223,369.8125,12,4,18,17
2014_09_NO_CAR,CAR,NO,9,2014,151,109,297,105,260,402,350.375,451.14285714285717,364.66666666666663,365.85714285714283,8,25,13,15
2014_09_NYJ_KC,KC,NYJ,9,2014,199,113,235,139,312,374,353.57142857142856,331.625,356.42857142857144,344.625,9,3,10,7
2014_09_OAK_SEA,SEA,LV,9,2014,179,149,194,37,328,231,363.7142857142857,305.42857142857144,348.87755102040813,364.85714285714283,14,1,8,14
2014_09_PHI_HOU,HOU,PHI,9,2014,203,118,326,190,321,516,360.25,406.42857142857144,331.625,339.7142857142857,11,21,3,6
2014_09_SD_MIA,MIA,LAC,9,2014,309,132,148,50,441,198,369.2857142857143,362.375,333.0816326530612,405.89583333333337,16,13,4,20
2014_09_STL_SF,SF,LA,9,2014,237,80,105,91,317,196,376.14285714285717,356.42857142857144,402.3142857142857,353.57142857142856,18,10,19,9
2014_09_TB_CLE,CLE,TB,9,2014,300,56,260,113,356,373,364.85714285714283,311.7142857142857,305.42857142857144,334.3265306122449,15,2,1,5
2014_09_WAS_MIN,MIN,WAS,9,2014,268,100,251,122,368,373,334.25,407.625,313.27083333333337,419.5,5,22,2,24
2014_10_ATL_TB,TB,ATL,10,2014,301,92,219,110,393,329,319.375,391.875,363.75,356.625,2,21,15,12
2014_10_CAR_PHI,PHI,CAR,10,2014,332,37,306,102,369,408,420.125,340.3333333333333,355.34375,445.6825396825397,24,7,11,24
2014_10_CHI_GB,GB,CHI,10,2014,319,132,283,55,451,338,362.75,368,450.04166666666663,374.5,14,16,25,18
2014_10_CLE_CIN,CIN,CLE,10,2014,93,86,198,170,179,368,369.375,363.75,337.65625,319.375,18,15,6,2
2014_10_DAL_JAX,JAX,DAL,10,2014,290,71,254,151,361,405,337,403.44444444444446,368.5079365079365,340.968253968254,6,22,16,8
2014_10_DEN_OAK,LV,DEN,10,2014,192,30,353,118,222,471,296.125,415.625,359.25,377.5625,1,23,13,19
2014_10_KC_BUF,BUF,KC,10,2014,259,111,177,127,370,304,344.625,348.375,331.625,336.921875,9,10,3,5
2014_10_MIA_DET,DET,MIA,10,2014,307,63,207,50,370,257,356.625,378.25,391.875,341.828125,11,19,21,9
2014_10_NYG_SEA,SEA,NYG,10,2014,172,350,283,54,522,337,359.25,359.5,296.125,458.671875,12,13,1,26
2014_10_PIT_NYJ,NYJ,PIT,10,2014,132,150,343,36,282,379,336.3333333333333,426.3333333333333,348.95238095238096,382.44444444444446,4,25,10,20
2014_10_SF_NO,NO,SF,10,2014,292,136,210,144,428,354,445,368.75,339.078125,336.375,26,17,7,4
2014_10_STL_ARI,ARI,LA,10,2014,326,28,216,70,354,286,341.125,336.375,401.4375,368.75,8,5,22,17
2014_10_TEN_BAL,BAL,TEN,10,2014,169,151,179,67,320,246,382.44444444444446,331.625,426.3333333333333,360.25,20,3,23,14
2014_11_ATL_CAR,CAR,ATL,11,2014,292,106,268,86,398,354,347.1,384.8888888888889,415.0125,327.55555555555554,9,22,25,2
2014_11_BUF_MIA,MIA,BUF,11,2014,240,125,193,54,365,247,364.77777777777777,347.44444444444446,358.1111111111111,343.44444444444446,17,10,13,7
2014_11_CIN_NO,NO,CIN,11,2014,255,75,220,186,330,406,443.1111111111111,348.22222222222223,367.1111111111111,364.22222222222223,27,11,17,14
2014_11_DEN_STL,LA,DEN,11,2014,220,131,389,28,351,417,330.77777777777777,421.77777777777777,342.55555555555554,287.8888888888889,4,26,6,1
2014_11_DET_ARI,ARI,DET,11,2014,306,46,183,98,352,281,342.55555555555554,358.1111111111111,330.77777777777777,364.77777777777777,6,14,3,16
2014_11_HOU_CLE,CLE,HOU,11,2014,330,65,211,213,395,424,364.22222222222223,355.8888888888889,348.22222222222223,418.60317460317464,15,12,10,26
2014_11_MIN_CHI,CHI,MIN,11,2014,330,138,158,96,468,254,364.6666666666667,338,372.55555555555554,403.77777777777777,16,5,18,23
2014_11_NE_IND,IND,NE,11,2014,303,19,257,246,322,503,458.77777777777777,377.22222222222223,358.0952380952381,414.58730158730157,28,20,12,24
2014_11_OAK_SD,LAC,LV,11,2014,193,120,172,71,313,243,344.1111111111111,287.8888888888889,377.25396825396825,421.77777777777777,8,1,20,27
2014_11_PHI_GB,GB,PHI,11,2014,367,110,346,109,477,455,372.55555555555554,414.44444444444446,364.6666666666667,347.85185185185185,19,24,15,9
2014_11_PIT_TEN,TEN,PIT,11,2014,263,49,207,206,312,413,322.1111111111111,421.6,375.5061728395062,330.9,2,25,19,4
2014_11_SEA_KC,KC,SEA,11,2014,108,190,178,204,298,382,343.44444444444446,377.3333333333333,347.44444444444446,357,7,21,8,11
2014_11_SF_NYG,NYG,SF,11,2014,280,65,193,148,345,341,357,367.1111111111111,377.3333333333333,443.1111111111111,13,18,21,28
2014_11_TB_WAS,WAS,TB,11,2014,207,155,288,48,362,336,403.77777777777777,327.55555555555554,338,384.8888888888889,23,3,5,22
2014_12_ARI_SEA,SEA,ARI,12,2014,211,124,149,64,335,213,377.8,343.5,338.9,350.4,21,11,7,11
2014_12_BAL_NO,NO,BAL,12,2014,420,126,243,215,546,458,431.8,376.2,354,323.0625,29,20,13,2
2014_12_CIN_HOU,HOU,CIN,12,2014,189,64,233,139,253,372,362.7,354,367.3,431.8,15,13,18,29
2014_12_CLE_ATL,ATL,CLE,12,2014,273,63,322,162,336,484,381.8,367.3,352.19,362.7,22,18,12,15
2014_12_DAL_NYG,NYG,DAL,12,2014,338,89,275,119,427,394,355.8,403.6,364.5,339.4,14,26,16,8
2014_12_DET_NE,NE,DET,12,2014,349,90,264,91,439,355,389.8,350.4,445.1,343.5,24,12,30,10
2014_12_GB_MIN,MIN,GB,12,2014,210,112,209,155,322,364,329.6,383,375,418.5,4,23,19,25
2014_12_JAX_IND,IND,JAX,12,2014,253,175,146,80,428,226,445.1,339.4,389.8,403.6,30,9,22,24
2014_12_KC_OAK,LV,KC,12,2014,174,179,234,96,353,330,283.4,338.9,341,377.8,1,8,9,20
2014_12_MIA_DEN,DEN,MIA,12,2014,257,201,228,97,458,325,421.3,364.8,332.8,337.4,28,17,5,6
2014_12_NYJ_BUF,BUF,NYJ,12,2014,230,116,165,92,346,257,337.4,330.9,364.8,421.6,7,5,17,28
2014_12_STL_SD,LAC,LA,12,2014,291,128,217,107,419,324,341,332.8,283.4,421.3,10,6,1,27
2014_12_TB_CHI,CHI,TB,12,2014,130,92,341,66,222,407,375,328.4,329.6,399.6,19,3,4,23
2014_12_TEN_PHI,PHI,TEN,12,2014,307,164,345,52,471,397,418.5,321.1,383,420.73999999999995,27,2,21,26
2014_12_WAS_SF,SF,WAS,12,2014,256,66,106,136,322,242,364.5,399.6,355.8,328.4,16,25,14,3
2014_13_ARI_ATL,ATL,ARI,13,2014,361,142,294,35,503,329,377.6363636363636,331.6363636363636,377.90909090909093,373.90909090909093,21,6,22,20
2014_13_CAR_MIN,MIN,CAR,13,2014,138,92,194,178,230,372,328.90909090909093,351.72727272727275,381.27272727272725,382.0808080808081,4,13,23,24
2014_13_CHI_DET,DET,CHI,13,2014,390,91,280,13,481,293,350.8181818181818,361.09090909090907,394.27272727272725,335.54545454545456,12,17,27,9
2014_13_CIN_TB,TB,CIN,13,2014,190,75,187,112,265,299,335.54545454545456,355.6363636363636,361.09090909090907,352.72727272727275,8,15,17,14
2014_13_CLE_BUF,BUF,CLE,13,2014,190,106,255,74,296,329,338.1818181818182,377.90909090909093,324.1818181818182,377.6363636363636,10,22,3,21
2014_13_DEN_KC,KC,DEN,13,2014,153,41,179,214,194,393,338.09090909090907,424.6363636363636,289.72727272727275,361.1818181818182,9,30,1,18
2014_13_MIA_NYJ,NYJ,MIA,13,2014,65,277,235,74,342,309,324.1818181818182,361.1818181818182,338.1818181818182,424.6363636363636,2,18,11,30
2014_13_NE_GB,GB,NE,13,2014,368,130,245,84,498,329,381.27272727272725,394.27272727272725,328.90909090909093,350.8181818181818,23,26,5,13
2014_13_NO_PIT,PIT,NO,13,2014,435,103,257,143,538,400,420.8181818181818,442.1818181818182,321.19191919191917,383.6363636363636,28,31,2,25
2014_13_NYG_JAX,JAX,NYG,13,2014,194,118,247,116,312,363,329.09090909090907,362.27272727272725,443.54545454545456,402.72727272727275,5,19,32,28
2014_13_OAK_STL,LA,LV,13,2014,183,172,230,61,355,291,332,289.72727272727275,348.09090909090907,338.09090909090907,7,1,12,10
2014_13_PHI_DAL,DAL,PHI,13,2014,199,93,217,256,292,473,402.72727272727275,423.27272727272725,362.27272727272725,328,27,29,19,4
2014_13_SD_BAL,BAL,LAC,13,2014,225,125,383,64,350,447,383.6363636363636,348.09090909090907,442.1818181818182,332,24,11,31,8
2014_13_SEA_SF,SF,SEA,13,2014,121,64,236,157,185,393,360.6363636363636,373.90909090909093,385.27272727272725,331.6363636363636,16,20,26,7
2014_13_TEN_HOU,HOU,TEN,13,2014,358,99,275,83,457,358,352.72727272727275,328,355.6363636363636,423.27272727272725,14,3,15,29
2014_13_WAS_IND,IND,WAS,13,2014,370,126,392,84,496,476,443.54545454545456,385.27272727272725,329.09090909090907,360.6363636363636,32,25,6,16
2014_14_ATL_GB,GB,ATL,14,2014,327,179,375,91,506,466,391,388.0833333333333,388.8333333333333,331.4166666666667,25,23,24,8
2014_14_BAL_MIA,MIA,BAL,14,2014,227,63,269,183,290,452,356.8333333333333,380.8333333333333,325.6666666666667,356.3333333333333,16,22,3,15
2014_14_BUF_DEN,DEN,BUF,14,2014,173,133,355,74,306,429,422,334.6666666666667,326.0833333333333,373.8333333333333,28,10,4,20
2014_14_CAR_NO,NO,CAR,14,2014,235,92,226,271,327,497,438.6666666666667,353.4166666666667,430.5833333333333,320.6666666666667,31,13,30,2
2014_14_DAL_CHI,CHI,DAL,14,2014,341,35,205,194,376,399,355.4166666666667,393.5,361.6666666666667,427.4166666666667,14,27,18,29
2014_14_HOU_JAX,JAX,HOU,14,2014,205,74,135,169,279,304,327.66666666666663,361.4166666666667,362.3333333333333,330.5,5,17,19,7
2014_14_IND_CLE,CLE,IND,14,2014,136,115,294,93,251,387,373.8333333333333,447.9166666666667,334.6666666666667,392.8333333333333,20,32,10,26
2014_14_KC_ARI,ARI,KC,14,2014,239,141,293,126,380,419,331.4166666666667,326.0833333333333,388.0833333333333,422,8,4,23,28
2014_14_NE_SD,LAC,NE,14,2014,189,53,317,87,242,404,356.3333333333333,388.8333333333333,380.8333333333333,391,15,24,22,25
2014_14_NYG_TEN,TEN,NYG,14,2014,206,61,260,142,267,402,330.5,362.3333333333333,361.4166666666667,327.66666666666663,7,19,17,5
2014_14_NYJ_MIN,MIN,NYJ,14,2014,309,114,254,168,423,422,320.6666666666667,325.6666666666667,353.4166666666667,356.8333333333333,2,3,13,16
2014_14_PIT_CIN,CIN,PIT,14,2014,327,86,350,193,413,543,350.9166666666667,430.5833333333333,329.6666666666667,438.6666666666667,12,30,6,31
2014_14_SEA_PHI,PHI,SEA,14,2014,96,57,263,188,153,451,427.4166666666667,375.5,393.5,346,29,21,27,11
2014_14_SF_OAK,LV,SF,14,2014,254,85,174,97,339,271,289.8333333333333,346,333.9166666666667,375.5,1,11,9,21
2014_14_STL_WAS,WAS,LA,14,2014,232,27,213,131,259,344,392.8333333333333,333.9166666666667,447.9166666666667,289.8333333333333,26,9,32,1
2014_14_TB_DET,DET,TB,14,2014,311,113,250,26,424,276,361.6666666666667,329.6666666666667,355.4166666666667,350.9166666666667,18,6,14,12
2014_15_ARI_STL,LA,ARI,15,2014,229,69,139,143,298,282,334.6923076923077,335.15384615384613,382.53846153846155,333.2307692307692,8,9,22,7
2014_15_CIN_CLE,CLE,CIN,15,2014,80,53,117,244,133,361,364.38461538461536,355.6923076923077,443.2307692307692,439.2307692307692,17,14,32,31
2014_15_DAL_PHI,PHI,DAL,15,2014,252,75,265,115,327,380,406.3076923076923,393.9230769230769,381.3076923076923,357,28,25,21,16
2014_15_DEN_SD,LAC,DEN,15,2014,232,56,233,111,288,344,347.53846153846155,413.0769230769231,390,341.9230769230769,12,29,24,11
2014_15_GB_BUF,BUF,GB,15,2014,158,113,185,158,271,343,341.9230769230769,399.84615384615387,413.0769230769231,394.0769230769231,11,27,29,26
2014_15_HOU_IND,IND,HOU,15,2014,187,110,157,137,297,294,443.2307692307692,357,364.38461538461536,323.9230769230769,32,16,17,2
2014_15_JAX_BAL,BAL,JAX,15,2014,221,93,229,82,314,311,386.3076923076923,323.9230769230769,351.6923076923077,357,23,2,13,16
2014_15_MIA_NE,NE,MIA,15,2014,287,108,346,76,395,422,390,351.6923076923077,347.53846153846155,386.3076923076923,24,13,12,23
2014_15_MIN_DET,DET,MIN,15,2014,153,80,315,76,233,391,366.46153846153845,328.53846153846155,325.53846153846155,333.0769230769231,20,5,3,6
2014_15_NO_CHI,CHI,NO,15,2014,194,125,375,83,319,458,357,430.0769230769231,393.9230769230769,364.46153846153845,16,30,25,18
2014_15_NYJ_TEN,TEN,NYJ,15,2014,260,89,179,114,349,293,325.61538461538464,333.0769230769231,365.38461538461536,328.53846153846155,4,6,19,5
2014_15_OAK_KC,KC,LV,15,2014,297,93,222,78,390,300,333.2307692307692,293.61538461538464,335.15384615384613,340.2307692307692,7,1,9,10
2014_15_PIT_ATL,ATL,PIT,15,2014,310,97,360,45,407,405,394.0769230769231,439.2307692307692,399.84615384615387,355.6923076923077,26,31,27,14
2014_15_SF_SEA,SEA,SF,15,2014,168,152,141,140,320,281,381.3076923076923,340.2307692307692,406.3076923076923,293.61538461538464,21,10,28,1
2014_15_TB_CAR,CAR,TB,15,2014,277,123,154,151,400,305,364.46153846153845,325.53846153846155,430.0769230769231,366.46153846153845,18,3,30,20
2014_15_WAS_NYG,NYG,WAS,15,2014,250,49,275,144,299,419,365.38461538461536,382.53846153846155,325.61538461538464,334.6923076923077,19,22,4,8
2014_16_ATL_NO,NO,ATL,16,2014,313,57,322,81,370,403,432.07142857142856,395,354.2857142857143,436.7857142857143,30,26,15,32
2014_16_BAL_HOU,HOU,BAL,16,2014,190,123,195,33,313,228,352.5,381.14285714285717,432.7857142857143,323,14,22,31,2
2014_16_BUF_OAK,LV,BUF,16,2014,214,140,329,13,354,342,294.07142857142856,336.85714285714283,337.2857142857143,395.7857142857143,1,10,11,27
2014_16_CLE_CAR,CAR,CLE,16,2014,201,209,166,84,410,250,367,347.85714285714283,324.07142857142856,356.07142857142856,20,13,3,16
2014_16_DEN_CIN,CIN,DEN,16,2014,146,207,311,85,353,396,356.07142857142856,408.14285714285717,347.85714285714283,343.2857142857143,16,29,13,12
2014_16_DET_CHI,CHI,DET,16,2014,181,64,243,138,245,381,354.2857142857143,356.92857142857144,432.07142857142856,333,15,18,30,8
2014_16_GB_TB,TB,GB,16,2014,147,16,318,121,163,439,324.07142857142856,395.7857142857143,367,336.85714285714283,3,27,20,10
2014_16_IND_DAL,DAL,IND,16,2014,261,127,235,1,388,236,392.92857142857144,432.7857142857143,400.64285714285717,352.5,25,31,28,14
2014_16_KC_PIT,PIT,KC,16,2014,220,68,317,39,288,356,436.7857142857143,337.2857142857143,395,294.07142857142856,32,11,26,1
2014_16_MIN_MIA,MIA,MIN,16,2014,396,110,259,119,506,378,356.7142857142857,333,390.35714285714283,356.92857142857144,17,8,24,18
2014_16_NE_NYJ,NYJ,NE,16,2014,210,116,182,85,326,267,330.2142857142857,390.35714285714283,327.2857142857143,356.7142857142857,5,24,4,17
2014_16_NYG_STL,LA,NYG,16,2014,290,106,391,128,396,519,332.07142857142856,360.64285714285717,331.35714285714283,385.14285714285717,7,19,6,23
2014_16_PHI_WAS,WAS,PHI,16,2014,220,100,374,134,320,508,385.14285714285717,400.64285714285717,360.64285714285717,392.92857142857144,23,28,19,25
2014_16_SD_SF,SF,LAC,16,2014,114,355,356,98,469,454,336,343.2857142857143,376.92857142857144,408.14285714285717,9,12,21,29
2014_16_SEA_ARI,ARI,SEA,16,2014,216,29,339,267,245,606,331.35714285714283,376.92857142857144,332.07142857142856,336,6,21,7,9
2014_16_TEN_JAX,JAX,TEN,16,2014,124,177,287,95,301,382,323,327.2857142857143,381.14285714285717,330.2142857142857,2,4,22,5
2014_17_ARI_SF,SF,ARI,17,2014,204,206,316,98,410,414,344.8666666666667,325.6,350.6666666666667,392.2,12,4,15,24
2014_17_BUF_NE,NE,BUF,17,2014,170,116,176,104,286,280,382.1333333333333,337.2,329.93333333333334,298.06666666666666,23,9,5,1
2014_17_CAR_ATL,ATL,CAR,17,2014,260,63,114,194,323,308,395.53333333333336,369.8666666666667,427.93333333333334,341.3333333333333,26,19,32,11
2014_17_CHI_MIN,MIN,CHI,17,2014,209,121,172,99,330,271,336,347,366.6666666666667,358.53333333333336,7,13,18,17
2014_17_CIN_PIT,PIT,CIN,17,2014,317,29,244,116,346,360,426.8666666666667,355.8666666666667,338.53333333333336,407.3333333333333,31,16,10,28
2014_17_CLE_BAL,BAL,CLE,17,2014,312,129,177,109,441,286,370.93333333333334,341.3333333333333,349.8666666666667,369.8666666666667,20,11,14,19
2014_17_DAL_WAS,WAS,DAL,17,2014,336,104,299,174,440,473,380.8,392.6,407.8,419.6666666666667,22,25,29,30
2014_17_DET_GB,GB,DET,17,2014,232,152,217,111,384,328,398.6666666666667,358.53333333333336,313.3333333333333,347,27,17,2,13
2014_17_IND_TEN,TEN,IND,17,2014,79,142,315,64,221,379,330.93333333333334,419.6666666666667,321.53333333333336,392.6,6,30,3,25
2014_17_JAX_HOU,HOU,JAX,17,2014,250,123,140,121,373,261,349.8666666666667,321.53333333333336,370.93333333333334,330.93333333333334,14,3,20,6
2014_17_NO_TB,TB,NO,17,2014,115,183,281,70,298,351,313.3333333333333,427.93333333333334,398.6666666666667,395.53333333333336,2,32,27,26
2014_17_NYJ_MIA,MIA,NYJ,17,2014,259,179,396,104,438,500,366.6666666666667,329.93333333333334,336,382.1333333333333,18,5,7,23
2014_17_OAK_DEN,DEN,LV,17,2014,312,142,158,67,454,225,407.3333333333333,298.06666666666666,355.8666666666667,337.2,28,1,16,9
2014_17_PHI_NYG,NYG,PHI,17,2014,429,76,292,164,505,456,371.2,407.8,336.3333333333333,380.8,21,29,8,22
2014_17_SD_KC,KC,LAC,17,2014,157,111,291,112,268,403,338.53333333333336,350.6666666666667,426.8666666666667,344.8666666666667,10,15,31,12
2014_17_STL_SEA,SEA,LA,17,2014,239,132,243,42,371,285,392.2,336.3333333333333,325.6,371.2,24,8,4,21
2014_18_ARI_CAR,CAR,ARI,18,2014,198,188,82,27,386,109,366,331.125,391,348.9375,4,1,6,3
2014_18_BAL_PIT,PIT,BAL,18,2014,356,68,259,53,424,312,421.8125,375.3125,356.125,337.875,8,5,4,2
2014_18_CIN_IND,IND,CIN,18,2014,376,114,155,110,490,265,417.125,356.125,324.0625,421.8125,7,2,1,8
2014_18_DET_DAL,DAL,DET,18,2014,293,73,323,90,366,413,397.625,356.625,384.5,397.75,6,3,5,7
2014_19_BAL_NE,NE,BAL,19,2014,418,14,292,136,432,428,376.125,371.5882352941176,333.625,421.94117647058823,3,2,4,8
2014_19_CAR_SEA,SEA,CAR,19,2014,268,100,246,132,368,378,390.875,367.1764705882353,333.125,318.05882352941177,4,1,3,2
2014_19_DAL_GB,GB,DAL,19,2014,316,119,191,145,435,336,397.75,395.7647058823529,356.625,359.94117647058823,6,5,6,7
2014_19_IND_DEN,DEN,IND,19,2014,211,88,265,99,299,364,410.25,421.4117647058824,293.5,350.7647058823529,7,8,1,5
2014_20_GB_SEA,SEA,GB,20,2014,228,194,178,135,422,313,389.52941176470586,399.94117647058823,367.8131487889273,392.24913494809687,2,3,1,3
2014_20_IND_NE,NE,IND,20,2014,226,177,126,83,403,209,379.4117647058824,418.22222222222223,374.90657439446363,404.06944444444446,1,4,2,4
2014_21_NE_SEA,SEA,NE,21,2014,247,162,328,57,409,385,391.3333333333333,380.72222222222223,395.1111111111111,406.5987654320988,2,1,1,2
2015_01_BAL_DEN,DEN,BAL,1,2015,175,69,117,73,244,190,0,0,0,0,32,32,32,32
2015_01_CAR_JAX,JAX,CAR,1,2015,183,96,175,105,279,280,0,0,0,0,32,32,32,32
2015_01_CIN_OAK,LV,CIN,1,2015,203,63,269,127,266,396,0,0,0,0,32,32,32,32
2015_01_CLE_NYJ,NYJ,CLE,1,2015,179,154,231,104,333,335,0,0,0,0,32,32,32,32
2015_01_DET_SD,LAC,DET,1,2015,403,96,246,69,499,315,0,0,0,0,32,32,32,32
2015_01_GB_CHI,CHI,GB,1,2015,225,189,189,133,414,322,0,0,0,0,32,32,32,32
2015_01_IND_BUF,BUF,IND,1,2015,195,147,243,64,342,307,0,0,0,0,32,32,32,32
2015_01_KC_HOU,HOU,KC,1,2015,334,98,243,97,432,340,0,0,0,0,32,32,32,32
2015_01_MIA_WAS,WAS,MIA,1,2015,196,161,226,74,357,300,0,0,0,0,32,32,32,32
2015_01_MIN_SF,SF,MIN,1,2015,165,230,231,71,395,302,0,0,0,0,32,32,32,32
2015_01_NO_ARI,ARI,NO,1,2015,307,120,355,54,427,409,0,0,0,0,32,32,32,32
2015_01_NYG_DAL,DAL,NYG,1,2015,356,80,189,99,436,288,0,0,0,0,32,32,32,32
2015_01_PHI_ATL,ATL,PHI,1,2015,298,105,336,63,403,399,0,0,0,0,32,32,32,32
2015_01_PIT_NE,NE,PIT,1,2015,288,80,351,134,368,485,0,0,0,0,32,32,32,32
2015_01_SEA_STL,LA,SEA,1,2015,297,76,251,124,373,375,0,0,0,0,32,32,32,32
2015_01_TEN_TB,TB,TEN,1,2015,210,92,209,124,302,333,0,0,0,0,32,32,32,32
2015_02_ARI_CHI,CHI,ARI,2,2015,241,109,185,115,350,300,414,427,322,409,27,28,12,26
2015_02_ATL_NYG,NYG,ATL,2,2015,292,97,363,56,389,419,288,403,436,399,6,25,30,24
2015_02_BAL_OAK,LV,BAL,2,2015,351,97,384,109,448,493,266,190,396,244,3,1,23,2
2015_02_DAL_PHI,PHI,DAL,2,2015,224,7,268,109,231,377,399,436,403,288,24,30,25,6
2015_02_DEN_KC,KC,DEN,2,2015,191,147,256,61,338,317,340,244,432,190,16,2,29,1
2015_02_DET_MIN,MIN,DET,2,2015,153,199,286,38,352,324,302,315,395,499,9,11,22,32
2015_02_HOU_CAR,CAR,HOU,2,2015,195,172,244,61,367,305,280,432,279,340,5,29,4,16
2015_02_MIA_JAX,JAX,MIA,2,2015,273,123,359,42,396,401,279,300,280,357,4,7,5,18
2015_02_NE_BUF,BUF,NE,2,2015,242,160,466,56,402,522,342,368,307,485,17,19,10,31
2015_02_NYJ_IND,IND,NYJ,2,2015,250,93,244,101,343,345,307,333,342,335,10,14,17,15
2015_02_SD_CIN,CIN,LAC,2,2015,214,175,241,131,389,372,396,499,266,315,23,32,3,11
2015_02_SEA_GB,GB,SEA,2,2015,249,127,206,119,376,325,322,375,414,373,12,21,27,20
2015_02_SF_PIT,PIT,SF,2,2015,369,84,335,111,453,446,485,395,368,302,31,22,19,9
2015_02_STL_WAS,WAS,LA,2,2015,203,182,150,67,385,217,357,373,300,375,18,20,7,21
2015_02_TB_NO,NO,TB,2,2015,255,104,207,139,359,346,409,302,427,333,26,9,28,14
2015_02_TEN_CLE,CLE,TEN,2,2015,172,116,257,166,288,423,335,333,333,302,15,14,14,9
2015_03_ATL_DAL,DAL,ATL,3,2015,232,127,285,158,359,443,406.5,411,315,338.5,27,28,4,11
2015_03_BUF_MIA,MIA,BUF,3,2015,297,102,277,151,399,428,350.5,372,337.5,445,17,22,10,31
2015_03_CHI_SEA,SEA,CHI,3,2015,235,159,63,98,394,161,350,382,349,363.5,16,24,15,19
2015_03_CIN_BAL,BAL,CIN,3,2015,362,36,383,86,398,469,341.5,392.5,357,435.5,14,26,18,30
2015_03_DEN_DET,DET,DEN,3,2015,282,28,324,41,310,365,319.5,280.5,327,339,5,1,9,13
2015_03_IND_TEN,TEN,IND,3,2015,367,88,260,133,455,393,378,325,311.5,339,23,8,3,13
2015_03_JAX_NE,NE,JAX,3,2015,358,125,242,57,483,299,445,337.5,372,350.5,31,10,22,17
2015_03_KC_GB,GB,KC,3,2015,333,123,290,75,456,365,349,339,350,280.5,15,13,16,1
2015_03_NO_CAR,CAR,NO,3,2015,315,119,310,70,434,380,323.5,384,368.5,324,6,25,20,7
2015_03_OAK_CLE,CLE,LV,3,2015,341,39,314,155,380,469,311.5,357,378,341.5,3,18,23,14
2015_03_PHI_NYJ,NYJ,PHI,3,2015,283,47,118,123,330,241,339,315,325,406.5,13,4,8,27
2015_03_PIT_STL,LA,PIT,3,2015,197,71,230,62,268,292,295,469,371,420.5,2,32,21,29
2015_03_SD_MIN,MIN,LAC,3,2015,121,163,309,90,284,399,327,435.5,319.5,392.5,9,30,5,26
2015_03_SF_ARI,ARI,SF,3,2015,311,139,67,103,450,170,363.5,420.5,382,469,19,29,24,32
2015_03_TB_HOU,HOU,TB,3,2015,228,186,261,57,414,318,368.5,324,323.5,384,20,7,6,25
2015_03_WAS_NYG,NYG,WAS,3,2015,279,84,316,88,363,404,338.5,371,411,295,11,21,28,2
2015_04_BAL_PIT,PIT,BAL,4,2015,124,167,186,191,291,377,410,360.3333333333333,286,418,27,16,1,27
2015_04_CAR_TB,TB,CAR,4,2015,287,141,124,133,428,257,322,360.3333333333333,383.6666666666667,382.6666666666667,7,16,19,18
2015_04_CLE_SD,LAC,CLE,4,2015,358,91,356,100,449,456,423.3333333333333,334.3333333333333,312.6666666666667,394.3333333333333,30,9,5,24
2015_04_DAL_NO,NO,DAL,4,2015,359,103,246,115,462,361,382.6666666666667,390.6666666666667,360.3333333333333,421.6666666666667,20,24,14,28
2015_04_DET_SEA,SEA,DET,4,2015,287,110,203,53,397,256,364.6666666666667,316.3333333333333,308.3333333333333,308.6666666666667,17,6,3,4
2015_04_GB_SF,SF,GB,4,2015,160,77,224,162,237,386,337,384.6666666666667,392.3333333333333,347.6666666666667,11,22,23,12
2015_04_HOU_ATL,ATL,HOU,4,2015,256,135,382,54,391,436,421.6666666666667,383.6666666666667,390.6666666666667,322,29,21,22,7
2015_04_JAX_IND,IND,JAX,4,2015,282,60,298,142,342,440,347.6666666666667,324.6666666666667,403.6666666666667,457.6666666666667,14,8,25,30
2015_04_KC_CIN,CIN,KC,4,2015,321,124,386,113,445,499,418,347.6666666666667,360.3333333333333,384.6666666666667,28,14,14,20
2015_04_MIN_DEN,DEN,MIN,4,2015,213,144,269,113,357,382,308.6666666666667,312.6666666666667,316.3333333333333,423.3333333333333,4,5,6,29
2015_04_NYG_BUF,BUF,NYG,4,2015,274,55,212,92,329,304,390.6666666666667,346.6666666666667,366.6666666666667,382,24,12,16,17
2015_04_NYJ_MIA,MIA,NYJ,4,2015,198,59,218,207,257,425,366.6666666666667,336,390.6666666666667,290.3333333333333,18,10,22,2
2015_04_OAK_CHI,CHI,LV,4,2015,281,98,196,70,379,266,308.3333333333333,394.3333333333333,364.6666666666667,334.3333333333333,3,26,15,8
2015_04_PHI_WAS,WAS,PHI,4,2015,290,127,270,87,417,357,382,290.3333333333333,346.6666666666667,336,19,2,11,9
2015_04_STL_ARI,ARI,LA,4,2015,352,113,171,164,465,335,392.3333333333333,286,337,410,25,1,10,26
2015_05_ARI_DET,DET,ARI,5,2015,379,56,171,187,435,358,301.25,410.5,372.75,298.25,2,24,16,1
2015_05_BUF_TEN,TEN,BUF,5,2015,187,97,113,127,284,240,403.6666666666667,375.25,347.6666666666667,336,23,15,11,9
2015_05_CHI_KC,KC,CHI,5,2015,181,117,252,87,298,339,385.5,326,424.75,362.25,19,6,27,13
2015_05_CLE_BAL,BAL,CLE,5,2015,210,181,457,83,391,540,364.5,364.75,380.25,429.75,12,13,18,28
2015_05_DEN_OAK,LV,DEN,5,2015,249,65,266,43,314,309,362.25,320.75,326,330,11,5,6,7
2015_05_IND_HOU,HOU,IND,5,2015,362,82,213,110,444,323,396.75,346.25,414,353.5,21,8,26,12
2015_05_JAX_TB,TB,JAX,5,2015,209,183,303,55,392,358,348.5,353.5,334.5,346.25,9,10,8,10
2015_05_NE_DAL,DAL,NE,5,2015,187,102,275,109,289,384,383.25,457.6666666666667,402.5,324.6666666666667,17,28,24,5
2015_05_NO_PHI,PHI,NO,5,2015,333,186,335,96,519,431,307,402.5,390.75,383.25,3,22,22,19
2015_05_PIT_SD,LAC,PIT,5,2015,365,52,203,155,417,358,429.75,380.25,364.75,364.5,27,16,15,14
2015_05_SEA_CIN,CIN,SEA,5,2015,331,109,213,200,440,413,424.75,372.75,385.5,301.25,26,14,21,2
2015_05_SF_NYG,NYG,SF,5,2015,441,84,262,124,525,386,336,312,375.25,385,7,4,17,20
2015_05_STL_GB,GB,LA,5,2015,241,86,161,191,327,352,385,298.25,312,410.5,18,1,4,25
2015_05_WAS_ATL,ATL,WAS,5,2015,254,176,219,51,430,270,414,390.75,396.75,307,25,20,23,3
2015_06_ARI_PIT,PIT,ARI,6,2015,174,141,421,55,315,476,375.8,400,427.2,328,19,22,27,4
2015_06_ATL_NO,NO,ATL,6,2015,312,81,295,150,393,445,408.2,417.2,349.4,366.6,24,25,10,15
2015_06_BAL_SF,SF,BAL,6,2015,340,65,343,77,405,420,326.8,369.8,373.8,399.8,2,15,18,22
2015_06_CAR_SEA,SEA,CAR,6,2015,241,115,269,135,356,404,380.8,334.5,427.8,348.5,20,6,28,9
2015_06_CHI_DET,DET,CHI,6,2015,405,155,353,91,560,444,328,328.6,400,368,3,4,23,16
2015_06_CIN_BUF,BUF,CIN,6,2015,263,112,243,112,375,355,348.2,427.8,379.73333333333335,380.8,9,27,20,21
2015_06_DEN_CLE,CLE,DEN,6,2015,213,109,290,152,322,442,399.8,318.4,369.8,352.6,21,1,17,11
2015_06_HOU_JAX,JAX,HOU,6,2015,331,83,293,95,414,388,354.4,406.2,357.2,341.6,11,23,12,8
2015_06_KC_MIN,MIN,KC,6,2015,249,84,282,57,333,339,330,368,320.75,328.6,5,14,2,5
2015_06_MIA_TEN,TEN,MIA,6,2015,282,63,266,180,345,446,373.75,339.25,341.4375,358.25,17,7,7,13
2015_06_NE_IND,IND,NE,6,2015,312,120,312,116,432,428,341.6,439.25,406.2,359.6875,8,28,24,14
2015_06_NYG_PHI,PHI,NYG,6,2015,280,158,189,81,438,270,349.4,373.8,408.2,326.8,10,18,25,3
2015_06_SD_GB,GB,LAC,6,2015,255,133,503,60,388,563,373.4,427.2,309,375.8,16,26,1,19
2015_06_WAS_NYJ,NYJ,WAS,6,2015,253,221,196,34,474,230,358.25,366.6,339.25,417.2,12,13,6,26
2015_07_ATL_TEN,TEN,ATL,7,2015,187,77,251,127,264,378,368,421.8333333333333,360.6,405.6666666666667,18,26,11,23
2015_07_BAL_ARI,ARI,BAL,7,2015,275,150,252,55,425,307,412.6666666666667,378.1666666666667,365.6666666666667,339.8333333333333,25,20,15,5
2015_07_BUF_JAX,JAX,BUF,7,2015,182,120,298,115,302,413,364.3333333333333,352.6666666666667,403.1666666666667,415.6666666666667,14,7,22,25
2015_07_CLE_STL,LA,CLE,7,2015,163,158,297,82,321,379,309,386.8333333333333,373.4,339,1,22,17,3
2015_07_DAL_NYG,NYG,DAL,7,2015,170,132,227,233,302,460,356.5,364.4,364.1666666666667,442.9333333333334,8,15,13,28
2015_07_HOU_MIA,MIA,HOU,7,2015,296,248,273,71,544,344,360.6,403.1666666666667,368,364.3333333333333,11,23,16,14
2015_07_MIN_DET,DET,MIN,7,2015,256,77,316,140,333,456,366.6666666666667,330.6,347.8333333333333,362.2,17,2,7,12
2015_07_NO_IND,IND,NO,7,2015,333,75,280,183,408,463,356.6666666666667,405.6666666666667,437.375,421.8333333333333,9,24,27,26
2015_07_NYJ_NE,NE,NYJ,7,2015,355,16,295,89,371,384,437,381.4,359.68,339.28000000000003,27,21,10,4
2015_07_OAK_SD,LAC,LV,7,2015,336,90,289,130,426,419,449.8333333333333,352.6,375.8333333333333,318.4,28,6,18,1
2015_07_PHI_CAR,CAR,PHI,7,2015,197,204,205,177,401,382,348.4,364.1666666666667,375.84000000000003,356.5,5,13,19,9
2015_07_PIT_KC,KC,PIT,7,2015,251,138,209,147,389,356,363.1666666666667,365.6666666666667,330.5,412.6666666666667,12,16,2,24
2015_07_SEA_SF,SF,SEA,7,2015,124,61,235,176,185,411,339.8333333333333,376.6666666666667,378.1666666666667,346.0833333333333,3,19,21,6
2015_07_TB_WAS,WAS,TB,7,2015,317,50,297,190,367,487,343.8333333333333,357.2,377.5416666666667,354.4,4,10,20,8
2015_08_ARI_CLE,CLE,ARI,8,2015,223,39,374,119,262,493,385.7142857142857,414.42857142857144,310.7142857142857,368,20,24,1,15
2015_08_CIN_PIT,PIT,CIN,8,2015,262,116,231,78,378,309,364.2857142857143,415.6666666666667,366.85714285714283,352.6666666666667,12,26,13,6
2015_08_DET_KC,KC,DET,8,2015,149,206,227,81,355,308,366.85714285714283,361.85714285714283,364.2857142857143,348.5142857142858,13,9,11,5
2015_08_GB_DEN,DEN,GB,8,2015,340,160,77,90,500,167,339,375.8333333333333,386.8333333333333,449.8333333333333,3,15,21,28
2015_08_IND_CAR,CAR,IND,8,2015,248,140,231,136,388,367,357.1666666666667,364,367.1388888888889,413.85714285714283,8,11,14,23
2015_08_MIA_NE,NE,MIA,8,2015,356,95,300,15,451,315,426,391.1666666666667,381.8333333333333,393.3055555555556,27,21,18,22
2015_08_MIN_CHI,CHI,MIN,8,2015,211,97,187,147,308,334,347.8333333333333,351.5,366.6666666666667,361.0555555555556,4,7,12,8
2015_08_NYG_NO,NO,NYG,8,2015,505,103,350,87,608,437,413.85714285714283,348.7142857142857,364,378.0571428571428,23,5,10,16
2015_08_NYJ_OAK,LV,NYJ,8,2015,333,118,311,74,451,385,363.6666666666667,381.8333333333333,445.8611111111111,426,10,19,27,26
2015_08_SD_BAL,BAL,LAC,8,2015,319,72,301,81,391,382,368,446.42857142857144,414.42857142857144,362.08571428571435,14,28,24,9
2015_08_SEA_DAL,DAL,SEA,8,2015,97,129,210,113,226,323,380.3333333333333,381.57142857142856,347.4166666666667,317.7142857142857,17,18,3,2
2015_08_SF_STL,LA,SF,8,2015,191,197,162,38,388,200,311,317.7142857142857,385.52777777777777,381.57142857142856,1,2,19,17
2015_08_TB_ATL,ATL,TB,8,2015,397,101,177,117,498,294,415.57142857142856,378.8333333333333,353.14285714285717,347.6944444444444,25,16,7,4
2015_08_TEN_HOU,HOU,TEN,8,2015,235,56,171,86,291,257,394.7142857142857,350.6666666666667,386.80000000000007,414.52777777777777,22,6,20,25
2015_09_ATL_SF,SF,ATL,9,2015,185,133,303,17,318,320,303,425.875,320.625,368.22916666666663,1,23,2,14
2015_09_CHI_SD,LAC,CHI,9,2015,280,77,345,109,357,454,438.375,342.14285714285717,370.875,349,26,4,15,5
2015_09_CLE_CIN,CIN,CLE,9,2015,234,152,168,69,386,237,400.42857142857144,370.25,366.2448979591837,424.25,22,18,13,23
2015_09_DEN_IND,IND,DEN,9,2015,252,120,281,35,372,316,364.375,362,361.02083333333337,346,14,13,9,4
2015_09_GB_CAR,CAR,GB,9,2015,297,130,369,71,427,440,361.57142857142856,346,364.42857142857144,362,12,5,12,11
2015_09_JAX_NYJ,NYJ,JAX,9,2015,272,29,381,98,301,479,382.2857142857143,355.42857142857144,376.14285714285717,361.2857142857143,21,8,18,10
2015_09_MIA_BUF,BUF,MIA,9,2015,181,266,316,108,447,424,361.2857142857143,380.2857142857143,355.42857142857144,429.57142857142856,11,20,6,25
2015_09_NYG_TB,TB,NYG,9,2015,247,136,213,114,383,327,366.7142857142857,359.75,427.34693877551024,438.125,17,10,24,26
2015_09_OAK_PIT,PIT,LV,9,2015,413,195,301,139,608,440,366,376.14285714285717,402.33333333333337,382.2857142857143,15,19,22,21
2015_09_PHI_DAL,DAL,PHI,9,2015,299,134,295,172,433,467,358.2857142857143,366.7142857142857,373.2040816326531,355.91428571428565,9,17,16,7
2015_09_STL_MIN,MIN,LA,9,2015,159,145,168,160,304,328,349,322,342.14285714285717,300.89795918367344,7,2,3,1
2015_09_TEN_NO,NO,TEN,9,2015,387,61,371,112,448,483,438.125,337.2857142857143,359.75,379.89795918367344,25,3,8,19
2015_09_WAS_NE,NE,WAS,9,2015,299,161,217,37,460,254,429.57142857142856,347.14285714285717,380.2857142857143,375.74285714285713,24,6,20,17
2015_10_ARI_SEA,SEA,ARI,10,2015,240,115,363,117,355,480,374.25,424.25,361.04166666666663,370.25,19,26,10,16
2015_10_BUF_NYJ,NYJ,BUF,10,2015,193,128,158,148,321,306,372.125,372,370.875,385.75,18,17,17,22
2015_10_CAR_TEN,TEN,CAR,10,2015,185,64,217,119,249,336,355.5,369.75,439.359375,357.75,6,14,28,9
2015_10_CHI_STL,LA,CHI,10,2015,200,94,258,153,294,411,322.75,356.125,343.375,428.203125,1,8,4,25
2015_10_CLE_PIT,PIT,CLE,10,2015,402,60,372,15,462,387,392.8888888888889,355.44444444444446,383.23809523809524,398.82539682539687,24,5,21,24
2015_10_DAL_TB,TB,DAL,10,2015,264,84,186,42,348,228,368.75,367.625,355.65625,379.25,13,12,8,20
2015_10_DET_GB,GB,DET,10,2015,333,47,242,45,380,287,357.75,355.125,369.75,365.375,10,4,15,12
2015_10_HOU_CIN,CIN,HOU,10,2015,197,74,192,82,271,274,398.625,381.75,353.59375,338.95833333333337,25,21,6,3
2015_10_JAX_BAL,BAL,JAX,10,2015,316,89,188,90,405,278,370.875,370.875,438.375,372.125,16,16,27,19
2015_10_KC_DEN,DEN,KC,10,2015,181,69,204,106,250,310,356.25,365.375,365.328125,355.125,9,11,11,7
2015_10_MIA_PHI,PHI,MIA,10,2015,392,83,217,99,475,316,379.25,385.75,367.625,372,20,23,13,18
2015_10_MIN_OAK,LV,MIN,10,2015,302,84,140,263,386,403,384.125,343.375,396.25,322.75,22,3,23,1
2015_10_NE_NYG,NYG,NE,10,2015,361,80,334,77,441,411,356.1111111111111,433.375,368.5238095238095,335.5,7,27,14,2
2015_10_NO_WAS,WAS,NO,10,2015,324,209,209,158,533,367,335.5,439.22222222222223,433.375,353.4761904761905,2,28,26,5
2015_11_BUF_NE,NE,BUF,11,2015,277,85,233,94,362,327,430.8888888888889,364.6666666666667,365.5432098765432,366.44444444444446,28,13,15,18
2015_11_CIN_ARI,ARI,CIN,11,2015,317,82,315,99,399,414,430.44444444444446,384.44444444444446,372.1111111111111,369.77777777777777,27,23,20,19
2015_11_DAL_MIA,MIA,DAL,11,2015,188,70,227,166,258,393,378,352.1111111111111,389.8888888888889,366.44444444444446,21,7,25,18
2015_11_DEN_CHI,CHI,DEN,11,2015,265,86,250,170,351,420,362.22222222222223,344.44444444444446,319.55555555555554,359.22222222222223,12,4,2,10
2015_11_GB_MIN,MIN,GB,11,2015,296,94,212,124,390,336,350,360.22222222222223,384.3333333333333,347.55555555555554,6,10,23,5
2015_11_IND_ATL,ATL,IND,11,2015,280,100,213,74,380,287,414.1111111111111,365.22222222222223,304.6666666666667,356.8888888888889,25,14,1,9
2015_11_KC_SD,LAC,KC,11,2015,178,52,253,153,230,406,429.3333333333333,359.22222222222223,354.5714285714286,344.44444444444446,26,9,8,4
2015_11_NYJ_HOU,HOU,NYJ,11,2015,250,123,216,70,373,286,369.77777777777777,366.44444444444446,384.44444444444446,364.6666666666667,18,17,24,14
2015_11_OAK_DET,DET,LV,11,2015,282,109,169,52,391,221,347.55555555555554,384.3333333333333,360.22222222222223,350,5,22,11,6
2015_11_SF_SEA,SEA,SF,11,2015,260,255,264,59,515,323,372.1111111111111,304.6666666666667,430.44444444444446,414.1111111111111,19,1,27,26
2015_11_STL_BAL,BAL,LA,11,2015,299,96,136,82,395,218,374.6666666666667,319.55555555555554,360.55555555555554,362.22222222222223,20,2,12,13
2015_11_TB_PHI,PHI,TB,11,2015,261,136,246,283,397,529,389.8888888888889,366.44444444444446,378,352.1111111111111,24,17,22,7
2015_11_TEN_JAX,JAX,TEN,11,2015,242,90,231,104,332,335,360.55555555555554,343.6666666666667,374.6666666666667,366,11,3,21,16
2015_11_WAS_CAR,CAR,WAS,11,2015,246,142,207,14,388,221,366,357.44444444444446,343.6666666666667,431.1975308641975,15,8,3,28
2015_12_ARI_SF,SF,ARI,12,2015,318,67,271,70,385,341,306.5,427.3,386.4,387.4,1,31,24,25
2015_12_BAL_CLE,CLE,BAL,12,2015,289,63,232,104,352,336,358.6,376.7,399.8,309.4,13,22,27,2
2015_12_BUF_KC,KC,BUF,12,2015,255,158,291,129,413,420,363.9,360.9,409.4,424,16,14,28,30
2015_12_CAR_DAL,DAL,CAR,12,2015,199,31,183,129,230,312,356.2,368.2,366,343.8,8,20,18,4
2015_12_CHI_GB,GB,CHI,12,2015,202,177,200,101,379,301,357.8,361.1,354,352,11,15,7,6
2015_12_MIA_NYJ,NYJ,MIA,12,2015,277,137,351,12,414,363,358.4,366,370.1,356.2,12,18,21,9
2015_12_MIN_ATL,ATL,MIN,12,2015,230,116,174,191,346,365,410.7,354,357.4,357.8,29,7,10,12
2015_12_NE_DEN,DEN,NE,12,2015,270,179,280,39,449,319,352,424,361.1,360.9,6,30,16,15
2015_12_NO_HOU,HOU,NO,12,2015,205,167,228,50,372,278,370.1,432,358.4,355.25,21,32,13,8
2015_12_NYG_WAS,WAS,NYG,12,2015,302,105,321,33,407,354,343.8,364.6,368.2,431.1375,4,17,20,32
2015_12_OAK_TEN,TEN,LV,12,2015,218,44,330,84,262,414,342.8,368,357.7,351.9,3,19,11,5
2015_12_PHI_DET,DET,PHI,12,2015,337,108,199,68,445,267,351.9,390.6,368,382.7,5,26,19,23
2015_12_PIT_SEA,SEA,PIT,12,2015,345,100,490,58,445,548,386.4,399.8,306.5,358.6,24,27,1,14
2015_12_SD_JAX,JAX,LAC,12,2015,329,102,300,79,431,379,357.7,409.4,342.8,363.9,10,28,3,17
2015_12_STL_CIN,CIN,LA,12,2015,236,140,259,94,376,353,387.4,309.4,427.3,376.7,25,2,31,22
2015_12_TB_IND,IND,TB,12,2015,315,27,245,132,342,377,357.4,382.7,410.7,390.6,9,23,29,26
2015_13_ARI_STL,LA,ARI,13,2015,146,66,362,175,212,537,313.3636363636364,419.45454545454544,386.3636363636364,313.6363636363636,1,32,25,2
2015_13_ATL_TB,TB,ATL,13,2015,227,166,269,64,393,333,382.1818181818182,404.8181818181818,356,355,24,27,8,6
2015_13_BAL_MIA,MIA,BAL,13,2015,86,137,308,94,223,402,365.72727272727275,373,363.45454545454544,358,17,22,14,9
2015_13_CAR_NO,NO,CAR,13,2015,282,70,331,175,352,506,418,363.09090909090907,370.27272727272725,344.72727272727275,31,13,20,4
2015_13_CIN_CLE,CLE,CIN,13,2015,230,68,239,144,298,383,358,386.3636363636364,373,313.3636363636364,9,25,22,1
2015_13_DAL_WAS,WAS,DAL,13,2015,219,73,223,97,292,320,349.54545454545456,344.72727272727275,363.6363636363636,363.09090909090907,5,4,15,13
2015_13_DEN_SD,LAC,DEN,13,2015,202,93,166,134,295,300,406.6363636363636,360.8181818181818,364.3636363636364,414.45454545454544,28,12,16,30
2015_13_GB_DET,DET,GB,13,2015,220,101,273,67,321,340,360.3636363636364,359.72727272727275,379.3636363636364,355.6363636363636,11,10,23,7
2015_13_HOU_BUF,BUF,HOU,13,2015,211,187,293,126,398,419,366.27272727272725,370.27272727272725,368.3636363636364,418,18,20,19,31
2015_13_IND_PIT,PIT,IND,13,2015,364,158,220,54,522,274,413.27272727272725,356,391.72727272727275,382.1818181818182,29,8,26,24
2015_13_JAX_TEN,TEN,JAX,13,2015,268,210,322,81,478,403,335.45454545454544,364.3636363636364,372.1818181818182,406.6363636363636,3,16,21,28
2015_13_KC_OAK,LV,KC,13,2015,283,99,162,89,382,251,372.1818181818182,368.3636363636364,335.45454545454544,366.27272727272725,21,19,3,18
2015_13_NYJ_NYG,NYG,NYJ,13,2015,297,74,390,90,371,480,363.6363636363636,363.45454545454544,349.54545454545456,365.72727272727275,15,14,5,17
2015_13_PHI_NE,NE,PHI,13,2015,348,103,120,128,451,248,414.45454545454544,379.3636363636364,360.8181818181818,360.3636363636364,30,23,12,11
2015_13_SEA_MIN,MIN,SEA,13,2015,118,31,274,173,149,447,355,391.72727272727275,404.8181818181818,413.27272727272725,6,26,27,29
2015_13_SF_CHI,CHI,SF,13,2015,202,170,196,121,372,317,355.6363636363636,313.6363636363636,359.72727272727275,419.45454545454544,7,2,10,32
2015_14_ATL_CAR,CAR,ATL,14,2015,301,142,235,54,443,289,375,398.8333333333333,412.5,383.0833333333333,22,28,29,24
2015_14_BUF_PHI,PHI,BUF,14,2015,247,116,268,152,363,420,368.4166666666667,368.9166666666667,417.5,374.3333333333333,17,18,30,21
2015_14_DAL_GB,GB,DAL,14,2015,218,230,114,171,448,285,358.0833333333333,342.6666666666667,357.0833333333333,344.75,13,4,12,5
2015_14_DET_STL,LA,DET,14,2015,124,203,245,111,327,356,304.9166666666667,357.0833333333333,429.25,358.0833333333333,1,12,32,13
2015_14_IND_JAX,JAX,IND,14,2015,250,154,260,95,404,355,367.5833333333333,349.1666666666667,347.3333333333333,422.3333333333333,16,7,6,31
2015_14_MIN_ARI,ARI,MIN,14,2015,310,97,335,72,407,407,429.25,337.8333333333333,304.9166666666667,396.3333333333333,32,3,1,26
2015_14_NE_HOU,HOU,NE,14,2015,159,87,226,116,246,342,374.3333333333333,417.5,368.9166666666667,368.4166666666667,21,30,18,17
2015_14_NO_TB,TB,NO,14,2015,182,115,312,87,297,399,383.0833333333333,412.5,398.8333333333333,375,24,29,28,22
2015_14_NYG_MIA,MIA,NYG,14,2015,236,128,337,92,364,429,353.8333333333333,364.25,375.4166666666667,373.1666666666667,9,15,23,20
2015_14_OAK_DEN,DEN,LV,14,2015,308,34,135,27,342,162,355.75,373,397.3333333333333,358.5833333333333,10,19,27,14
2015_14_PIT_CIN,CIN,PIT,14,2015,339,64,282,84,403,366,386.0833333333333,422.3333333333333,353,349.1666666666667,25,31,8,7
2015_14_SD_KC,KC,LAC,14,2015,191,150,263,44,341,307,358.5833333333333,397.3333333333333,373,355.75,14,27,19,10
2015_14_SEA_BAL,BAL,SEA,14,2015,274,28,301,123,302,424,375.4166666666667,396.3333333333333,353.8333333333333,337.8333333333333,23,26,9,3
2015_14_SF_CLE,CLE,SF,14,2015,270,230,194,71,500,265,353,313.9166666666667,386.0833333333333,357,8,2,25,11
2015_14_TEN_NYJ,NYJ,TEN,14,2015,263,183,315,24,446,339,373.1666666666667,347.3333333333333,364.25,367.5833333333333,20,6,15,16
2015_14_WAS_CHI,CHI,WAS,14,2015,315,87,300,99,402,399,357,344.75,313.9166666666667,342.6666666666667,11,5,2,4
2015_15_ARI_PHI,PHI,ARI,15,2015,361,74,274,230,435,504,368,427.53846153846155,372.84615384615387,343.15384615384613,17,32,21,4
2015_15_ATL_JAX,JAX,ATL,15,2015,297,85,246,83,382,329,370.38461538461536,390.38461538461536,349.61538461538464,380.2307692307692,20,27,7,24
2015_15_BUF_WAS,WAS,BUF,15,2015,319,123,235,240,442,475,348.9230769230769,372.84615384615387,360.46153846153845,368,6,21,13,17
2015_15_CAR_NYG,NYG,CAR,15,2015,245,161,340,171,406,511,369.2307692307692,380.2307692307692,354.61538461538464,390.38461538461536,18,24,8,27
2015_15_CHI_MIN,MIN,CHI,15,2015,231,129,231,94,360,325,343.15384615384613,360.46153846153845,427.53846153846155,348.9230769230769,4,13,32,6
2015_15_CIN_SF,SF,CIN,15,2015,295,55,192,68,350,260,310.15384615384613,387.38461538461536,364.3076923076923,418,2,25,14,31
2015_15_CLE_SEA,SEA,CLE,15,2015,249,182,161,94,431,255,398.46153846153845,364.3076923076923,369.7692307692308,310.15384615384613,28,14,19,2
2015_15_DEN_PIT,PIT,DEN,15,2015,380,23,296,104,403,400,418,354.6923076923077,387.38461538461536,356.7692307692308,31,9,25,10
2015_15_DET_NO,NO,DET,15,2015,341,69,254,150,410,404,411.46153846153845,357,376.46153846153845,306.61538461538464,29,11,22,1
2015_15_GB_OAK,LV,GB,15,2015,276,120,204,103,396,307,356.7692307692308,365,354.6923076923077,338.2307692307692,10,16,9,3
2015_15_HOU_IND,IND,HOU,15,2015,160,50,173,155,210,328,349.61538461538464,364.46153846153845,370.38461538461536,411.6923076923077,7,15,20,30
2015_15_KC_BAL,BAL,KC,15,2015,281,93,171,113,374,284,369.7692307692308,357.2307692307692,398.46153846153845,390.38461538461536,19,12,28,27
2015_15_MIA_SD,LAC,MIA,15,2015,311,140,216,44,451,260,390.38461538461536,354.61538461538464,357.2307692307692,369.2307692307692,27,8,12,18
2015_15_NYJ_DAL,DAL,NYJ,15,2015,195,133,299,73,328,372,338.2307692307692,378.7692307692308,365,346.6923076923077,3,23,16,5
2015_15_TB_STL,LA,TB,15,2015,234,98,363,146,332,509,306.61538461538464,376.46153846153845,357,411.46153846153845,1,22,11,29
2015_15_TEN_NE,NE,TEN,15,2015,267,93,274,59,360,333,411.6923076923077,346.6923076923077,364.46153846153845,378.7692307692308,30,5,15,23
2015_16_CAR_ATL,ATL,CAR,16,2015,306,77,142,155,383,297,386,389.57142857142856,371.2142857142857,371.85714285714283,25,26,18,19
2015_16_CHI_TB,TB,CHI,16,2015,295,104,156,174,399,330,385.92857142857144,357.92857142857144,308.42857142857144,344.35714285714283,24,12,1,5
2015_16_CIN_DEN,DEN,CIN,16,2015,299,113,200,108,412,308,357.92857142857144,378.2857142857143,416.92857142857144,313,12,22,31,2
2015_16_CLE_KC,KC,CLE,16,2015,125,136,136,232,261,368,352,356.5,370.07142857142856,400.7857142857143,8,10,17,28
2015_16_DAL_BUF,BUF,DAL,16,2015,179,236,186,121,415,307,380.14285714285717,337.5,355.57142857142856,378.2857142857143,23,3,9,22
2015_16_GB_ARI,ARI,GB,16,2015,269,121,155,101,390,256,433,360.85714285714283,372.7857142857143,359.57142857142856,32,15,20,13
2015_16_HOU_TEN,TEN,HOU,16,2015,234,30,207,128,264,335,345.7142857142857,361.85714285714283,408,339.64285714285717,6,16,29,4
2015_16_IND_MIA,MIA,IND,16,2015,329,82,177,100,411,277,347.85714285714283,339.64285714285717,394.7142857142857,361.85714285714283,7,4,27,16
2015_16_JAX_NO,NO,JAX,16,2015,412,135,368,65,547,433,411.35714285714283,371.2142857142857,360.35714285714283,386,30,18,14,25
2015_16_NE_NYJ,NYJ,NE,16,2015,296,143,231,63,439,294,378.2857142857143,408,337.5,345.7142857142857,22,29,3,6
2015_16_NYG_MIN,MIN,NYG,16,2015,168,218,302,91,386,393,344.35714285714283,371.85714285714283,357.92857142857144,389.57142857142856,5,19,12,26
2015_16_PIT_BAL,BAL,PIT,16,2015,274,121,220,110,395,330,370.07142857142856,416.92857142857144,352,357.92857142857144,17,31,8,12
2015_16_SD_OAK,LV,LAC,16,2015,204,106,277,72,310,349,359.57142857142856,394.7142857142857,360.85714285714283,347.85714285714283,13,27,15,7
2015_16_SF_DET,DET,SF,16,2015,301,87,225,121,388,346,360.35714285714283,313,411.35714285714283,378.2857142857143,14,2,30,22
2015_16_STL_SEA,SEA,LA,16,2015,289,59,103,102,348,205,400.7857142857143,308.42857142857144,356.5,385.92857142857144,28,1,10,24
2015_16_WAS_PHI,PHI,WAS,16,2015,380,45,365,67,425,432,372.7857142857143,355.57142857142856,433,380.14285714285717,20,9,32,23
2015_17_BAL_CIN,CIN,BAL,17,2015,160,145,292,59,305,351,373.6,371.73333333333335,361.53333333333336,411.1333333333333,19,17,15,30
2015_17_DET_CHI,CHI,DET,17,2015,245,111,298,67,356,365,356.06666666666666,362.2,386.8,315.2,10,16,26,2
2015_17_JAX_HOU,HOU,JAX,17,2015,249,160,239,32,409,271,360.06666666666666,375.3333333333333,340.26666666666665,420.4,13,20,5,31
2015_17_MIN_GB,GB,MIN,17,2015,291,76,99,151,367,250,353.8666666666667,347.1333333333333,430.1333333333333,373.26666666666665,9,7,32,18
2015_17_NE_MIA,MIA,NE,17,2015,350,96,140,70,446,210,352.06666666666666,400.4,335.46666666666664,382.3333333333333,8,29,4,22
2015_17_NO_ATL,ATL,NO,17,2015,334,87,323,67,421,390,385.8,420.4,383.4,375.3333333333333,25,31,24,20
2015_17_NYJ_BUF,BUF,NYJ,17,2015,182,113,181,122,295,303,382.46666666666664,382.3333333333333,335.46666666666664,400.4,23,22,4,29
2015_17_OAK_KC,KC,LV,17,2015,159,189,194,48,348,242,345.93333333333334,356.26666666666665,357.26666666666665,391.6666666666667,6,11,12,27
2015_17_PHI_NYG,NYG,PHI,17,2015,302,208,320,120,510,440,373.26666666666665,376.26666666666665,347.1333333333333,360.6666666666667,18,21,7,14
2015_17_PIT_CLE,CLE,PIT,17,2015,240,86,349,30,326,379,357.26666666666665,411.1333333333333,345.93333333333334,371.73333333333335,12,30,6,17
2015_17_SD_DEN,DEN,LAC,17,2015,301,210,228,110,511,338,361.53333333333336,391.6666666666667,373.6,356.26666666666665,15,27,19,11
2015_17_SEA_ARI,ARI,SEA,17,2015,213,27,225,145,240,370,430.1333333333333,397.26666666666665,353.8666666666667,301.53333333333336,32,28,9,1
2015_17_STL_SF,SF,LA,17,2015,354,108,231,133,462,364,315.2,301.53333333333336,362.2,397.26666666666665,2,1,16,28
2015_17_TB_CAR,CAR,TB,17,2015,293,111,325,77,404,402,383.4,386.8,385.8,356.06666666666666,24,26,25,10
2015_17_TEN_IND,IND,TEN,17,2015,207,127,137,137,334,274,335.46666666666664,340.26666666666665,352.06666666666666,360.06666666666666,4,5,8,13
2015_17_WAS_DAL,DAL,WAS,17,2015,435,100,304,146,535,450,335.46666666666664,360.6666666666667,382.46666666666664,376.26666666666665,4,14,23,21
2015_18_GB_WAS,WAS,GB,18,2015,329,84,210,141,413,351,366.25,354.6875,347.9375,341.0625,5,3,2,1
2015_18_KC_HOU,HOU,KC,18,2015,136,114,190,141,250,331,363.125,346.0625,368.8125,349.125,4,2,6,3
2015_18_PIT_CIN,CIN,PIT,18,2015,212,91,240,167,303,407,369.3125,409.125,370.4375,355.3125,6,8,7,5
2015_18_SEA_MIN,MIN,SEA,18,2015,146,58,142,93,204,235,341.0625,395.5625,354.6875,418.25,1,7,4,8
2015_19_GB_ARI,ARI,GB,19,2015,349,40,261,135,389,396,418.25,354.47058823529414,395.5625,369,8,2,8,5
2015_19_KC_NE,NE,KC,19,2015,302,38,246,135,340,381,388.5,345.1764705882353,357.9375,356.47058823529414,6,1,3,2
2015_19_PIT_DEN,DEN,PIT,19,2015,222,109,339,85,331,424,370.875,409,388.3125,365.4117647058824,3,7,7,4
2015_19_SEA_CAR,CAR,SEA,19,2015,161,144,366,78,305,444,384.6875,386.11764705882354,387.75,333,4,5,6,1
2015_20_ARI_CAR,CAR,ARI,20,2015,335,152,235,60,487,295,380,416.52941176470586,389.52249134948096,356.9134948096886,2,4,3,2
2015_20_NE_DEN,DEN,NE,20,2015,176,99,310,44,275,354,368.52941176470586,385.6470588235294,409.88235294117646,347.28373702422147,1,3,4,1
2015_21_CAR_DEN,DEN,CAR,21,2015,141,90,265,118,231,383,363.3333333333333,385.94444444444446,383.8888888888889,409.77777777777777,1,2,1,2
2016_01_BUF_BAL,BAL,BUF,1,2016,258,83,111,65,341,176,0,0,0,0,32,32,32,32
2016_01_CAR_DEN,DEN,CAR,1,2016,178,148,194,157,326,351,0,0,0,0,32,32,32,32
2016_01_CHI_HOU,HOU,CHI,1,2016,231,129,216,73,360,289,0,0,0,0,32,32,32,32
2016_01_CIN_NYJ,NYJ,CIN,1,2016,189,152,366,57,341,423,0,0,0,0,32,32,32,32
2016_01_CLE_PHI,PHI,CLE,1,2016,278,133,190,120,411,310,0,0,0,0,32,32,32,32
2016_01_DET_IND,IND,DET,1,2016,385,82,340,116,467,456,0,0,0,0,32,32,32,32
2016_01_GB_JAX,JAX,GB,1,2016,320,48,199,95,368,294,0,0,0,0,32,32,32,32
2016_01_LA_SF,SF,LA,1,2016,170,150,130,65,320,195,0,0,0,0,32,32,32,32
2016_01_MIA_SEA,SEA,MIA,1,2016,258,112,186,64,370,250,0,0,0,0,32,32,32,32
2016_01_MIN_TEN,TEN,MIN,1,2016,271,64,236,65,335,301,0,0,0,0,32,32,32,32
2016_01_NE_ARI,ARI,NE,1,2016,271,92,264,106,363,370,0,0,0,0,32,32,32,32
2016_01_NYG_DAL,DAL,NYG,1,2016,227,101,207,113,328,320,0,0,0,0,32,32,32,32
2016_01_OAK_NO,NO,LV,1,2016,423,88,319,167,511,486,0,0,0,0,32,32,32,32
2016_01_PIT_WAS,WAS,PIT,1,2016,329,55,300,147,384,447,0,0,0,0,32,32,32,32
2016_01_SD_KC,KC,LAC,1,2016,363,83,243,155,446,398,0,0,0,0,32,32,32,32
2016_01_TB_ATL,ATL,TB,1,2016,334,52,281,90,386,371,0,0,0,0,32,32,32,32
2016_02_ATL_OAK,LV,ATL,2,2016,299,155,396,139,454,535,486,386,511,371,31,23,32,21
2016_02_BAL_CLE,CLE,BAL,2,2016,260,145,302,80,405,382,310,341,411,176,7,14,25,1
2016_02_CIN_PIT,PIT,CIN,2,2016,259,124,366,46,383,412,447,423,384,341,28,26,22,14
2016_02_DAL_WAS,WAS,DAL,2,2016,364,82,292,102,446,394,384,328,447,320,22,11,28,9
2016_02_GB_MIN,MIN,GB,2,2016,286,30,213,83,316,296,301,294,335,368,6,5,12,18
2016_02_IND_DEN,DEN,IND,2,2016,266,134,197,83,400,280,326,467,351,456,10,30,15,29
2016_02_JAX_SD,LAC,JAX,2,2016,220,150,329,69,370,398,398,368,446,294,24,18,27,5
2016_02_KC_HOU,HOU,KC,2,2016,268,97,186,119,365,305,360,446,289,398,16,27,4,24
2016_02_MIA_NE,NE,MIA,2,2016,324,161,387,70,485,457,370,250,363,370,20,3,17,20
2016_02_NO_NYG,NYG,NO,2,2016,368,64,263,41,432,304,320,511,328,486,9,32,11,31
2016_02_NYJ_BUF,BUF,NYJ,2,2016,307,86,374,123,393,497,176,341,341,423,1,14,14,26
2016_02_PHI_CHI,CHI,PHI,2,2016,235,64,190,100,299,290,289,411,360,310,4,25,16,7
2016_02_SEA_LA,LA,SEA,2,2016,239,64,254,67,303,321,195,370,320,250,2,20,9,3
2016_02_SF_CAR,CAR,SF,2,2016,353,176,243,65,529,308,351,320,326,195,15,9,10,2
2016_02_TB_ARI,ARI,TB,2,2016,315,105,243,85,420,328,363,371,370,386,17,21,20,23
2016_02_TEN_DET,DET,TEN,2,2016,260,137,238,139,397,377,456,335,467,301,29,12,30,6
2016_03_ARI_BUF,BUF,ARI,3,2016,119,208,287,88,327,375,284.5,391.5,419,349.5,2,22,27,8
2016_03_ATL_NO,NO,ATL,3,2016,376,115,240,217,491,457,407.5,460.5,376,470,23,31,19,32
2016_03_BAL_JAX,JAX,BAL,3,2016,194,48,214,84,242,298,383,361.5,384,357.5,20,14,21,12
2016_03_CHI_DAL,DAL,CHI,3,2016,248,199,317,78,447,395,361,294,415,350.5,13,3,25,9
2016_03_CLE_MIA,MIA,CLE,3,2016,319,115,279,169,434,448,353.5,357.5,427.5,361.5,10,12,29,14
2016_03_DEN_CIN,CIN,DEN,3,2016,206,143,312,52,349,364,417.5,363,415,373.5,26,16,25,17
2016_03_DET_GB,GB,DET,3,2016,205,123,385,50,328,435,295,426.5,308.5,356,4,28,5,11
2016_03_HOU_NE,NE,HOU,3,2016,103,185,196,109,288,305,427.5,362.5,353.5,375.5,29,15,10,18
2016_03_LA_TB,TB,LA,3,2016,405,83,190,137,488,327,349.5,249,391.5,345.5,8,1,22,7
2016_03_MIN_CAR,CAR,MIN,3,2016,265,105,171,58,370,229,440,308.5,314,295,30,5,6,4
2016_03_NYJ_KC,KC,NYJ,3,2016,237,72,188,117,309,305,375.5,419,362.5,284.5,18,27,15,2
2016_03_OAK_TEN,TEN,LV,3,2016,214,181,249,123,395,372,356,470,426.5,460.5,11,32,28,31
2016_03_PIT_PHI,PHI,PIT,3,2016,301,125,257,29,426,286,350.5,415,294,417.5,9,25,3,26
2016_03_SD_IND,IND,LAC,3,2016,331,93,326,37,424,363,373.5,384,363,383,17,21,16,20
2016_03_SF_SEA,SEA,SF,3,2016,308,127,119,135,435,254,345.5,314,249,440,7,6,1,30
2016_03_WAS_NYG,NYG,WAS,3,2016,350,120,327,90,470,417,376,415,407.5,361,19,25,23,13
2016_04_BUF_NE,NE,BUF,4,2016,205,90,246,134,295,380,381,298.6666666666667,343.3333333333333,386,17,4,9,19
2016_04_CAR_ATL,ATL,CAR,4,2016,503,90,337,49,593,386,459.3333333333333,416.6666666666667,435.3333333333333,282,30,26,28,2
2016_04_CLE_WAS,WAS,CLE,4,2016,183,145,223,163,328,386,415.6666666666667,387.6666666666667,407.3333333333333,380.3333333333333,25,19,25,16
2016_04_DAL_SF,SF,DAL,4,2016,196,106,245,194,302,439,294,389.6666666666667,375.3333333333333,327.6666666666667,3,20,13,6
2016_04_DEN_TB,TB,DEN,4,2016,179,72,238,89,251,327,395.6666666666667,363.3333333333333,275,394.6666666666667,23,10,1,23
2016_04_DET_CHI,CHI,DET,4,2016,302,114,213,66,416,279,327.6666666666667,429.3333333333333,389.6666666666667,306,5,27,21,5
2016_04_IND_JAX,JAX,IND,4,2016,207,136,234,94,343,328,336,390.3333333333333,340.3333333333333,377,6,21,8,15
2016_04_KC_PIT,PIT,KC,4,2016,300,149,287,87,449,374,372,353.3333333333333,375.6666666666667,381,12,9,14,18
2016_04_LA_ARI,ARI,LA,4,2016,325,118,266,41,443,307,386,275,298.6666666666667,395.6666666666667,18,1,4,24
2016_04_MIA_CIN,CIN,MIA,4,2016,296,77,189,62,373,251,394.6666666666667,380.3333333333333,363.3333333333333,387.6666666666667,22,15,11,20
2016_04_NO_SD,LAC,NO,4,2016,321,38,207,83,359,290,377,435.3333333333333,390.3333333333333,459.3333333333333,14,28,22,30
2016_04_NYG_MIN,MIN,NYG,4,2016,262,104,261,78,366,339,282,407.3333333333333,416.6666666666667,415.6666666666667,2,24,27,26
2016_04_OAK_BAL,BAL,LV,4,2016,298,130,199,62,428,261,340.3333333333333,437.3333333333333,336,369,7,29,7,12
2016_04_SEA_NYJ,NYJ,SEA,4,2016,261,58,309,66,319,375,381,375.3333333333333,353.3333333333333,294,17,13,10,3
2016_04_TEN_HOU,HOU,TEN,4,2016,254,115,202,124,369,326,343.3333333333333,369,381,437.3333333333333,8,11,18,29
2016_05_ARI_SF,SF,ARI,5,2016,162,151,124,172,313,296,296,400.25,402,283,2,25,25,1
2016_05_ATL_DEN,DEN,ATL,5,2016,223,84,267,122,307,389,354.25,492.75,359.5,409,9,28,13,26
2016_05_BUF_LA,LA,BUF,5,2016,271,102,124,193,373,317,283,319,400.25,359.5,1,5,24,13
2016_05_CHI_IND,IND,CHI,5,2016,322,98,397,125,420,522,374.75,349.75,337.75,391.75,16,8,5,20
2016_05_CIN_DAL,DAL,CIN,5,2016,227,180,269,96,407,365,402,389.25,296,348,26,19,2,6
2016_05_HOU_MIN,MIN,HOU,5,2016,271,96,184,59,367,243,303,349.75,390.25,358.25,3,8,19,10
2016_05_NE_CLE,CLE,NE,5,2016,249,27,406,98,276,504,387.25,359.5,393.75,319,18,12,22,4
2016_05_NYG_GB,GB,NYG,5,2016,259,147,199,43,406,242,306,390.25,429.3333333333333,303,4,20,27,3
2016_05_NYJ_PIT,PIT,NYJ,5,2016,380,61,255,72,441,327,391.25,365.5,358.5,375.25,21,14,11,16
2016_05_PHI_DET,DET,PHI,5,2016,180,80,238,116,260,354,391.75,375.6666666666667,349.75,372,22,17,8,15
2016_05_SD_OAK,LV,LAC,5,2016,317,89,359,72,406,431,393.25,372.5,362.25,399,23,15,14,23
2016_05_TB_CAR,CAR,TB,5,2016,278,136,219,113,414,332,409,359.5,492.75,354.25,27,12,28,9
2016_05_TEN_MIA,MIA,TEN,5,2016,191,51,163,235,242,398,348,358.25,389.25,349.75,6,10,18,8
2016_05_WAS_BAL,BAL,WAS,5,2016,210,118,260,60,328,320,362.25,393.75,393.25,387.25,13,24,21,17
2016_06_ATL_SEA,SEA,ATL,6,2016,270,72,335,52,342,387,375.25,472,365.5,344.8,17,30,14,7
2016_06_BAL_NYG,NYG,BAL,6,2016,403,38,307,98,441,405,360.6,355.4,326,379,12,9,5,19
2016_06_CAR_NO,NO,CAR,6,2016,465,63,322,103,528,425,399,410,372.5,354,26,29,17,9
2016_06_CIN_NE,NE,CIN,6,2016,376,79,254,120,455,374,388.4,384.4,365,403,24,23,13,29
2016_06_CLE_TEN,TEN,CLE,6,2016,284,137,337,40,421,377,366.2,365,326.8,388.4,15,13,6,25
2016_06_DAL_GB,GB,DAL,6,2016,294,78,247,191,372,438,331,403,353.1875,384.4,6,28,8,24
2016_06_DEN_SD,LAC,DEN,6,2016,178,99,230,84,277,314,384.2,344.8,395.8,472,22,8,27,30
2016_06_IND_HOU,HOU,IND,6,2016,269,158,252,161,427,413,328.4,383.8,315.8,384.2,5,20,3,23
2016_06_JAX_CHI,CHI,JAX,6,2016,302,92,271,54,394,325,384.2,337.75,383.8,374.75,22,7,21,18
2016_06_KC_OAK,LV,KC,6,2016,225,64,224,183,289,407,395.8,358.5,384.2,391.25,25,11,23,26
2016_06_LA_DET,DET,LA,6,2016,270,83,321,76,353,397,365.4,301,371.33333333333337,318.6,14,2,16,4
2016_06_NYJ_ARI,ARI,NYJ,6,2016,225,171,205,33,396,238,379.4,357.8,299.4,401.2,19,10,1,28
2016_06_PHI_WAS,WAS,PHI,6,2016,263,230,179,94,493,273,379,370.25,355.4,358.8125,18,16,10,12
2016_06_PIT_MIA,MIA,PIT,6,2016,252,222,189,128,474,317,326.8,401.2,366.2,357.8,4,27,15,11
2016_06_SF_BUF,BUF,SF,6,2016,179,313,187,133,492,320,318.6,299.4,301,379.4,3,1,2,20
2016_07_BAL_NYJ,NYJ,BAL,7,2016,215,155,248,11,370,259,337.8333333333333,363.6666666666667,382.1666666666667,374,5,14,20,17
2016_07_BUF_MIA,MIA,BUF,7,2016,204,256,221,67,460,288,351.3333333333333,347.5,387.1666666666667,302.8333333333333,11,9,23,1
2016_07_CHI_GB,GB,CHI,7,2016,326,103,130,69,429,199,339.2,385.8333333333333,410,335.625,6,24,28,4
2016_07_CLE_CIN,CIN,CLE,7,2016,308,271,182,180,579,362,382.6666666666667,367,399.5,375.3333333333333,23,16,25,19
2016_07_HOU_DEN,DEN,HOU,7,2016,157,190,131,140,347,271,339.6666666666667,344.8333333333333,366.3333333333333,388.6666666666667,7,8,13,24
2016_07_IND_TEN,TEN,IND,7,2016,232,124,353,81,356,434,375.3333333333333,388.6666666666667,367,344.8333333333333,20,26,15,7
2016_07_MIN_PHI,PHI,MIN,7,2016,138,101,224,93,239,317,350.8,315.8,401.8,328.4,10,2,26,3
2016_07_NE_PIT,PIT,NE,7,2016,281,94,222,140,375,362,387.1666666666667,399.5,351.3333333333333,382.6666666666667,25,28,9,21
2016_07_NO_KC,KC,NO,7,2016,214,112,367,104,326,471,368.2,424.8,374.44,413,17,29,18,29
2016_07_NYG_LA,LA,NYG,7,2016,291,74,196,36,365,232,317,374,363.3333333333333,363.6666666666667,3,19,11,12
2016_07_OAK_JAX,JAX,LV,7,2016,246,105,200,144,351,344,335.2,378,386.15999999999997,366.5833333333333,4,21,22,14
2016_07_SD_ATL,ATL,LAC,7,2016,273,130,371,78,403,449,457.8333333333333,366.3333333333333,369.7083333333333,339.6666666666667,30,15,16,6
2016_07_SEA_ARI,ARI,SEA,7,2016,342,132,225,52,474,277,382.1666666666667,368.6,337.8333333333333,455,22,18,5,30
2016_07_TB_SF,SF,TB,7,2016,143,160,269,249,303,518,302.8333333333333,354,347.5,410,1,12,8,28
2016_07_WAS_DET,DET,WAS,7,2016,266,94,301,130,360,431,363.3333333333333,398,317,354.0416666666667,13,27,2,10
2016_08_ARI_CAR,CAR,ARI,8,2016,212,141,363,24,353,387,412.5,395.2857142857143,420.5,355.5142857142858,24,20,24,11
2016_08_DET_HOU,HOU,DET,8,2016,186,105,240,58,291,298,334.2857142857143,362.85714285714283,340.7142857142857,402.7142857142857,3,12,7,22
2016_08_GB_ATL,ATL,GB,8,2016,288,90,246,108,378,354,450,354.1666666666667,378.14285714285717,354.6944444444444,26,9,18,10
2016_08_JAX_TEN,TEN,JAX,8,2016,280,214,337,48,494,385,372.57142857142856,337.8333333333333,395.14285714285717,372.3333333333333,14,4,20,16
2016_08_KC_IND,IND,KC,8,2016,210,105,350,88,315,438,395.14285714285717,361.1666666666667,372.57142857142856,432.5,19,11,17,25
2016_08_MIN_CHI,CHI,MIN,8,2016,252,158,228,57,410,285,359.14285714285717,316,352.0285714285714,332.1666666666667,10,1,9,3
2016_08_NE_BUF,BUF,NE,8,2016,218,167,315,72,385,387,339,394.14285714285717,366.85714285714283,385.42857142857144,5,18,15,19
2016_08_NYJ_CLE,CLE,NYJ,8,2016,345,68,228,171,413,399,366.2857142857143,342.42857142857144,410.7142857142857,348.7142857142857,13,7,23,8
2016_08_OAK_TB,TB,LV,8,2016,180,102,513,128,282,641,381.3333333333333,373.14285714285717,302.8611111111111,337.45714285714286,17,15,1,5
2016_08_PHI_DAL,DAL,PHI,8,2016,287,187,202,97,474,299,408.8333333333333,332.1666666666667,337.8333333333333,316,22,2,6,2
2016_08_SD_DEN,DEN,LAC,8,2016,276,57,267,123,333,390,340.7142857142857,378.14285714285717,334.2857142857143,450,6,16,4,26
2016_08_SEA_NO,NO,SEA,8,2016,265,123,296,74,388,370,432.5,353.3333333333333,361.1666666666667,397.47222222222223,25,8,12,21
2016_08_WAS_CIN,CIN,WAS,8,2016,284,152,458,100,436,558,410.7142857142857,402.7142857142857,366.2857142857143,362.85714285714283,23,21,14,13
2016_09_ATL_TB,TB,ATL,9,2016,336,70,344,136,406,480,367.14285714285717,441,411.40816326530614,354.14583333333337,15,26,23,10
2016_09_BUF_SEA,SEA,BUF,9,2016,282,33,289,162,315,451,355.7142857142857,344.75,426.14285714285717,393.25,13,7,25,20
2016_09_CAR_LA,LA,CAR,9,2016,296,59,225,59,355,284,323.85714285714283,404,353.7142857142857,394.10204081632656,3,22,9,21
2016_09_DAL_CLE,CLE,DAL,9,2016,203,45,255,168,248,423,372.125,418.14285714285717,349.5,327.42857142857144,16,24,8,2
2016_09_DEN_OAK,LV,DEN,9,2016,184,218,283,33,402,316,406.625,339.75,368.91666666666663,379.625,23,5,13,17
2016_09_DET_MIN,MIN,DET,9,2016,273,78,219,97,351,316,311.57142857142856,354.75,366.40816326530614,328.875,2,12,12,3
2016_09_IND_GB,GB,IND,9,2016,297,116,281,85,413,366,354.14285714285717,385.125,439.7142857142857,370.77083333333337,11,19,26,14
2016_09_JAX_KC,KC,JAX,9,2016,187,62,252,205,249,457,372.14285714285717,344.57142857142856,383.6938775510204,389.9183673469388,17,6,18,19
2016_09_NO_SF,SF,NO,9,2016,398,93,323,248,491,571,302.85714285714283,426.14285714285717,377.42857142857144,355.7142857142857,1,25,16,11
2016_09_NYJ_MIA,MIA,NYJ,9,2016,149,137,213,132,286,345,366.85714285714283,349.5,339,372.125,14,9,4,15
2016_09_PHI_NYG,NYG,PHI,9,2016,257,54,364,96,311,460,353.7142857142857,327.42857142857144,323.85714285714283,418.14285714285717,10,4,1,24
2016_09_PIT_BAL,BAL,PIT,9,2016,250,50,264,36,300,300,348.7142857142857,385.42857142857144,342.42857142857144,394.14285714285717,8,20,6,22
2016_09_TEN_SD,LAC,TEN,9,2016,275,208,313,80,483,393,379.625,387.75,339.75,343.72916666666663,18,21,5,7
2016_10_ATL_PHI,PHI,ATL,10,2016,231,208,267,48,439,315,344,445.3333333333333,348.375,371.46031746031747,7,28,7,16
2016_10_CHI_TB,TB,CHI,10,2016,312,80,182,122,392,304,372,365.5,445.875,312.125,17,16,28,1
2016_10_CIN_NYG,NYG,CIN,10,2016,240,122,204,78,362,282,348.375,413.875,344,422.125,8,24,5,26
2016_10_CLE_BAL,BAL,CLE,10,2016,296,119,150,33,415,183,342.625,358.3333333333333,374.75,418.6825396825397,6,13,17,25
2016_10_DAL_PIT,PIT,DAL,10,2016,408,48,319,127,456,446,374.75,418.75,342.625,356.609375,18,25,4,11
2016_10_DEN_NO,NO,DEN,10,2016,303,80,258,103,383,361,444.25,337.1111111111111,326.375,406.1111111111111,27,5,2,23
2016_10_GB_TEN,TEN,GB,10,2016,305,154,379,69,459,448,388.3333333333333,361.5,391.1111111111111,382.734375,19,15,21,18
2016_10_HOU_JAX,JAX,HOU,10,2016,265,80,99,181,345,280,358.625,328.875,356.75,354.75,14,4,12,10
2016_10_KC_CAR,CAR,KC,10,2016,261,99,178,91,360,269,389,356.75,327.75,358.625,20,12,3,15
2016_10_LA_NYJ,NYJ,LA,10,2016,163,139,165,125,302,290,349,327.75,357.87301587301585,389,9,3,13,20
2016_10_MIA_SD,LAC,MIA,10,2016,326,70,240,106,396,346,391.1111111111111,356.75,388.3333333333333,348.9375,21,12,19,8
2016_10_MIN_WAS,WAS,MIN,10,2016,262,128,307,47,390,354,422.125,316.5,413.875,349.90625,26,1,24,9
2016_10_SEA_NE,NE,SEA,10,2016,316,81,348,96,397,444,393.25,350.625,344.75,358.03125,22,10,6,14
2016_10_SF_ARI,ARI,SF,10,2016,376,80,210,83,456,293,394.25,326.375,405.0625,444.25,23,2,22,27
2016_11_ARI_MIN,MIN,ARI,11,2016,169,72,198,135,241,333,320.6666666666667,401.1111111111111,418.55555555555554,322.6666666666667,1,24,26,3
2016_11_BAL_DAL,DAL,BAL,11,2016,301,118,269,101,419,370,421.77777777777777,350.6666666666667,383.77777777777777,338.85185185185185,27,9,19,6
2016_11_BUF_CIN,CIN,BUF,11,2016,207,93,166,183,300,349,399.22222222222223,356.55555555555554,349.8888888888889,351.1904761904762,23,12,11,12
2016_11_CHI_NYG,NYG,CHI,11,2016,227,102,252,93,329,345,349.8888888888889,358.6666666666667,399.22222222222223,374.22222222222223,7,14,24,18
2016_11_GB_WAS,WAS,GB,11,2016,375,151,360,84,526,444,418.55555555555554,371.1111111111111,320.6666666666667,396.18518518518516,26,16,2,23
2016_11_HOU_OAK,LV,HOU,11,2016,295,30,243,124,325,367,406.1111111111111,323.44444444444446,337.1111111111111,357.1111111111111,25,3,5,13
2016_11_JAX_DET,DET,JAX,11,2016,278,14,202,83,292,285,350.44444444444446,357.1111111111111,315.95238095238096,323.44444444444446,8,13,1,4
2016_11_MIA_LA,LA,MIA,11,2016,134,102,172,98,236,270,323.55555555555554,355.55555555555554,343.77777777777777,391.6543209876543,4,11,8,21
2016_11_NE_SF,SF,NE,11,2016,206,122,280,171,328,451,322.6666666666667,393.6666666666667,401.1111111111111,361,2,21,25,16
2016_11_NO_CAR,CAR,NO,11,2016,192,50,285,107,242,392,385.77777777777777,437.44444444444446,347,339.7654320987654,20,28,9,7
2016_11_PHI_SEA,SEA,PHI,11,2016,287,152,218,113,439,331,361,354.55555555555554,393.6666666666667,430.85185185185185,15,10,22,28
2016_11_PIT_CLE,CLE,PIT,11,2016,246,33,167,146,279,313,340.8,383.77777777777777,349.8625,421.77777777777777,5,19,10,27
2016_11_TB_KC,KC,TB,11,2016,261,82,331,116,343,447,347,374.22222222222223,385.77777777777777,358.6666666666667,6,17,20,14
2016_11_TEN_IND,IND,TEN,11,2016,262,76,290,97,338,387,383,395.4,360.6825396825397,370.15,18,22,15,17
2016_12_ARI_ATL,ATL,ARI,12,2016,269,116,289,58,385,347,432.3,394.3,353.5,312.7,31,25,14,1
2016_12_CAR_OAK,LV,CAR,12,2016,315,56,246,129,371,375,398,371.4,327.8,432.9,27,18,5,31
2016_12_CIN_BAL,BAL,CIN,12,2016,234,92,283,64,326,347,352.6,389.3,421.5,355.8,14,23,29,16
2016_12_GB_PHI,PHI,GB,12,2016,254,81,313,74,335,387,352.2,378.4,368.8,429.3,13,20,18,30
2016_12_JAX_BUF,BUF,JAX,12,2016,166,153,126,183,319,309,355.8,349.9,389.3,344.6,15,12,24,7
2016_12_KC_DEN,DEN,KC,12,2016,368,124,220,83,492,303,339.5,346.6,438.125,381.5,6,9,32,23
2016_12_LA_NO,NO,LA,12,2016,360,209,214,69,569,283,432.9,314.8,371.4,347,32,2,19,9
2016_12_MIN_DET,DET,MIN,12,2016,232,94,224,82,326,306,344.6,312.7,349.9,394.3,8,1,11,25
2016_12_NE_NYJ,NYJ,NE,12,2016,269,64,286,91,333,377,344.3,399.4,323.975,323.2,7,28,4,3
2016_12_NYG_CLE,CLE,NYG,12,2016,322,58,194,104,380,298,335.1818181818182,347.8,377.3434343434343,357.3,5,11,20,17
2016_12_PIT_IND,IND,PIT,12,2016,240,91,221,148,331,369,378.5,376.7,394.56,334.62,21,19,26,6
2016_12_SD_HOU,HOU,LAC,12,2016,246,114,242,67,360,309,327.8,391.6,398,355.675,4,24,27,15
2016_12_SEA_TB,TB,SEA,12,2016,220,118,151,127,338,278,381.5,368.8,346.6,352.2,22,17,8,12
2016_12_SF_MIA,MIA,SF,12,2016,285,95,296,193,380,489,347,323.2,314.8,399.4,10,3,2,28
2016_12_TEN_CHI,CHI,TEN,12,2016,316,95,226,149,411,375,357.3,394.6363636363636,347.8,378.90909090909093,16,26,10,22
2016_12_WAS_DAL,DAL,WAS,12,2016,195,163,449,56,358,505,421.5,429.3,352.6,378.4,29,30,13,21
2016_13_BUF_OAK,LV,BUF,13,2016,260,139,191,212,399,403,395.54545454545456,352.45454545454544,371.72727272727275,346.1818181818182,25,13,16,9
2016_13_CAR_SEA,SEA,CAR,13,2016,315,240,182,89,555,271,360.54545454545456,371.72727272727275,377.54545454545456,395.54545454545456,15,17,19,25
2016_13_DAL_MIN,MIN,DAL,13,2016,253,87,139,140,340,279,312.09090909090907,415.72727272727275,342.90909090909093,436.1818181818182,2,27,7,29
2016_13_DEN_JAX,JAX,DEN,13,2016,181,154,104,104,335,208,346.1818181818182,353.3636363636364,352.45454545454544,342.6363636363636,9,14,13,6
2016_13_DET_NO,NO,DET,13,2016,326,50,341,85,376,426,445.27272727272725,342.90909090909093,311.90909090909093,312.09090909090907,30,6,1,2
2016_13_HOU_GB,GB,HOU,13,2016,209,109,202,123,318,325,379.1818181818182,330.72727272727275,350.6363636363636,384.09090909090907,21,3,12,21
2016_13_IND_NYJ,NYJ,IND,13,2016,216,36,289,139,252,428,343.27272727272725,374.1818181818182,397.3636363636364,376,8,18,26,18
2016_13_KC_ATL,ATL,KC,13,2016,297,128,270,123,425,393,428,342.6363636363636,390,353.3636363636364,28,5,23,14
2016_13_LA_NE,NE,LA,13,2016,269,133,161,36,402,197,397.3636363636364,311.90909090909093,343.27272727272725,445.27272727272725,26,1,8,30
2016_13_MIA_BAL,BAL,MIA,13,2016,386,110,226,62,496,288,350.1818181818182,350,385.45454545454544,338.27272727272725,11,10,22,4
2016_13_NYG_PIT,PIT,NYG,13,2016,289,117,195,56,406,251,376,343.27272727272725,374.1818181818182,339.25619834710744,19,8,17,5
2016_13_PHI_CIN,CIN,PHI,13,2016,332,80,308,53,412,361,385.45454545454544,350.6363636363636,350.1818181818182,379.1818181818182,23,12,11,20
2016_13_SF_CHI,CHI,SF,13,2016,192,142,39,141,334,180,362.1818181818182,338.27272727272725,392.85123966942143,350,16,4,24,10
2016_13_TB_SD,LAC,TB,13,2016,225,119,280,81,344,361,384.09090909090907,377.54545454545456,330.72727272727275,360.54545454545456,22,20,3,15
2016_13_WAS_ARI,ARI,WAS,13,2016,300,88,271,87,388,358,390,436.1818181818182,428,415.72727272727275,24,29,28,27
2016_14_ARI_MIA,MIA,ARI,14,2016,242,83,145,175,325,320,344.8333333333333,389.8333333333333,362.3333333333333,429.6666666666667,9,25,17,31
2016_14_ATL_LA,LA,ATL,14,2016,235,104,237,66,339,303,302.33333333333337,427.75,397.75,346.8333333333333,1,30,28,11
2016_14_BAL_NE,NE,BAL,14,2016,406,95,324,42,501,366,397.75,362.3333333333333,302.33333333333337,344.8333333333333,28,16,1,9
2016_14_CHI_DET,DET,CHI,14,2016,223,114,212,92,337,304,349.8333333333333,359.8333333333333,439.5,325.0833333333333,12,15,32,3
2016_14_CIN_CLE,CLE,CIN,14,2016,104,169,180,213,273,393,338.9166666666667,387.6666666666667,343.65000000000003,351.5,7,24,8,13
2016_14_DAL_NYG,NYG,DAL,14,2016,193,93,165,108,286,273,335.5833333333333,404.3333333333333,378.5,314.41666666666663,5,29,22,2
2016_14_DEN_TEN,TEN,DEN,14,2016,88,180,350,18,268,368,393,341.25,361.77500000000003,345.25,26,8,16,10
2016_14_HOU_IND,IND,HOU,14,2016,276,83,147,185,359,332,378.6666666666667,330.25,335.6666666666667,374.0833333333333,22,4,6,19
2016_14_MIN_JAX,JAX,MIN,14,2016,257,85,292,85,342,377,345.25,314.41666666666663,341.25,404.3333333333333,10,2,7,29
2016_14_NO_TB,TB,NO,14,2016,184,104,257,46,288,303,376.1666666666667,439.5,380.75,349.8333333333333,19,32,24,12
2016_14_NYJ_SF,SF,NYJ,14,2016,133,248,257,188,381,445,325.0833333333333,335.6666666666667,359.8333333333333,378.6666666666667,3,6,15,23
2016_14_OAK_KC,KC,LV,14,2016,264,65,117,135,329,252,346.8333333333333,395.8333333333333,427.75,356.6666666666667,11,27,30,14
2016_14_PIT_BUF,BUF,PIT,14,2016,228,67,220,240,295,460,356.6666666666667,378.5,395.8333333333333,335.5833333333333,14,21,27,5
2016_14_SD_CAR,CAR,LAC,14,2016,160,126,236,58,286,294,363.3333333333333,380.75,376.75,376.1666666666667,17,23,21,20
2016_14_SEA_GB,GB,SEA,14,2016,246,93,240,136,339,376,374.0833333333333,376.75,330.25,363.3333333333333,18,20,4,18
2016_14_WAS_PHI,PHI,WAS,14,2016,314,95,234,107,409,341,351.5,429.6666666666667,387.6666666666667,389.8333333333333,13,31,25,26
2016_15_CAR_WAS,WAS,CAR,15,2016,315,29,300,148,344,448,422.84615384615387,357.38461538461536,355.9230769230769,374.0769230769231,31,16,15,20
2016_15_CLE_BUF,BUF,CLE,15,2016,174,280,196,107,454,303,351.9230769230769,333.84615384615387,384.7692307692308,388.0769230769231,13,6,26,27
2016_15_DET_NYG,NYG,DET,15,2016,201,114,273,56,315,329,331.7692307692308,348.84615384615387,394.2307692307692,355.53846153846155,5,12,28,14
2016_15_GB_CHI,CHI,GB,15,2016,362,95,252,226,457,478,355.53846153846155,371.38461538461536,348.84615384615387,376.6923076923077,14,19,12,21
2016_15_IND_MIN,MIN,IND,15,2016,291,34,250,161,325,411,319.2307692307692,377.15384615384613,345,330.38461538461536,2,22,10,4
2016_15_JAX_HOU,HOU,JAX,15,2016,308,79,92,67,387,159,330.38461538461536,345,377.15384615384613,319.2307692307692,4,10,22,2
2016_15_LA_SEA,SEA,LA,15,2016,229,72,167,47,301,214,376.6923076923077,305.1538461538462,371.38461538461536,418.15384615384613,21,1,19,30
2016_15_MIA_NYJ,NYJ,MIA,15,2016,266,116,236,67,382,303,344.0769230769231,343.3076923076923,329.38461538461536,384.46153846153845,9,8,3,24
2016_15_NE_DEN,DEN,NE,15,2016,282,58,188,136,340,324,343.3076923076923,405.6923076923077,383.38461538461536,362.61538461538464,8,29,23,17
2016_15_NO_ARI,ARI,NO,15,2016,318,116,389,130,434,519,384.46153846153845,429,343.3076923076923,369.38461538461536,24,32,8,18
2016_15_OAK_SD,LAC,LV,15,2016,206,73,213,145,279,358,374.0769230769231,384.7692307692308,357.38461538461536,345.46153846153845,20,26,16,11
2016_15_PHI_BAL,BAL,PHI,15,2016,206,151,170,169,357,339,362.61538461538464,355.9230769230769,405.6923076923077,422.84615384615387,17,15,29,31
2016_15_PIT_CIN,CIN,PIT,15,2016,157,76,286,97,233,383,388.0769230769231,384.7692307692308,333.84615384615387,351.9230769230769,27,26,6,13
2016_15_SF_ATL,ATL,SF,15,2016,302,248,183,107,550,290,418.15384615384613,329.38461538461536,305.1538461538462,344.0769230769231,30,3,1,9
2016_15_TB_DAL,DAL,TB,15,2016,279,185,247,52,464,299,394.2307692307692,369.38461538461536,331.7692307692308,429,28,18,5,32
2016_15_TEN_KC,KC,TEN,15,2016,163,157,241,148,320,389,345.46153846153845,383.38461538461536,384.7692307692308,343.3076923076923,11,23,26,8
2016_16_ARI_SEA,SEA,ARI,16,2016,350,78,284,94,428,378,371.2857142857143,388,298.64285714285717,435.42857142857144,20,27,1,32
2016_16_ATL_CAR,CAR,ATL,16,2016,198,119,277,152,317,429,363.85714285714283,427.57142857142856,417.2142857142857,326.57142857142856,17,31,30,3
2016_16_BAL_PIT,PIT,BAL,16,2016,279,127,262,122,406,384,384.64285714285717,362.2142857142857,377,354.7142857142857,26,15,21,13
2016_16_CIN_HOU,HOU,CIN,16,2016,176,95,268,50,271,318,334.42857142857144,377,331.7142857142857,384.64285714285717,7,21,6,26
2016_16_DEN_KC,KC,DEN,16,2016,246,238,183,63,484,246,343.64285714285717,343.07142857142856,383.7857142857143,399.85714285714283,10,9,25,29
2016_16_DET_DAL,DAL,DET,16,2016,222,164,260,90,386,350,399.2142857142857,347.42857142857144,364.35714285714283,330.57142857142856,28,12,18,4
2016_16_IND_OAK,LV,IND,16,2016,261,210,288,102,471,390,382.85714285714283,379.57142857142856,367.2857142857143,319.64285714285717,24,23,19,2
2016_16_MIA_BUF,BUF,MIA,16,2016,329,272,233,261,601,494,359.2142857142857,340.42857142857144,331.64285714285717,346.7857142857143,14,8,5,11
2016_16_MIN_GB,GB,MIN,16,2016,347,40,382,93,387,475,379,319.64285714285717,362.7857142857143,379.57142857142856,22,2,16,23
2016_16_NYG_PHI,PHI,NYG,16,2016,168,118,356,114,286,470,354.7142857142857,330.57142857142856,362.2142857142857,347.42857142857144,13,4,15,12
2016_16_NYJ_NE,NE,NYJ,16,2016,220,114,136,111,334,247,399.85714285714283,346.7857142857143,343.07142857142856,340.42857142857144,29,11,9,8
2016_16_SD_CLE,CLE,LAC,16,2016,175,124,322,34,299,356,331.64285714285717,367.2857142857143,359.2142857142857,382.85714285714283,5,19,14,24
2016_16_SF_LA,LA,SF,16,2016,90,99,266,70,189,336,298.64285714285717,326.57142857142856,371.2857142857143,427.57142857142856,1,3,20,31
2016_16_TB_NO,NO,TB,16,2016,299,123,277,89,422,366,435.42857142857144,364.35714285714283,388,399.2142857142857,32,18,27,28
2016_16_TEN_JAX,JAX,TEN,16,2016,345,84,223,58,429,281,331.7142857142857,383.7857142857143,334.42857142857144,343.64285714285717,6,25,7,10
2016_16_WAS_CHI,CHI,WAS,16,2016,323,140,270,208,463,478,362.7857142857143,417.2142857142857,379,363.85714285714283,16,30,22,17
2016_17_ARI_LA,LA,ARI,17,2016,143,52,263,84,195,347,291.3333333333333,387.3333333333333,327.2,375.06666666666666,1,26,2,20
2016_17_BAL_CIN,CIN,BAL,17,2016,226,153,279,72,379,351,373.06666666666666,363.6666666666667,330.2,386.06666666666666,19,15,5,25
2016_17_BUF_NYJ,NYJ,BUF,17,2016,210,127,182,68,337,250,340.1333333333333,375.3333333333333,395.46666666666664,350.6666666666667,9,21,28,12
2016_17_CAR_TB,TB,CAR,17,2016,202,112,237,128,314,365,364.46666666666664,360.73333333333335,434.53333333333336,427.6666666666667,16,14,32,31
2016_17_CHI_MIN,MIN,CHI,17,2016,250,124,149,183,374,332,330,369.46666666666664,379.53333333333336,421.26666666666665,4,18,23,30
2016_17_CLE_PIT,PIT,CLE,17,2016,277,69,232,231,346,463,386.06666666666666,329.46666666666664,363.6666666666667,366.53333333333336,25,3,15,17
2016_17_DAL_PHI,PHI,DAL,17,2016,245,114,151,69,359,220,350.1333333333333,398.3333333333333,339.8666666666667,347.6,11,29,8,10
2016_17_GB_DET,DET,GB,17,2016,347,76,300,153,423,453,347.6,379.53333333333336,398.3333333333333,330,10,23,29,4
2016_17_HOU_TEN,TEN,HOU,17,2016,150,103,278,46,253,324,376.93333333333334,330.2,338.2,373.06666666666666,22,5,7,19
2016_17_JAX_IND,IND,JAX,17,2016,321,94,301,182,415,483,380.26666666666665,338.2,388.73333333333335,376.93333333333334,24,7,27,22
2016_17_KC_SD,LAC,KC,17,2016,269,129,264,103,398,367,366.53333333333336,353,329.46666666666664,336.6,17,13,3,6
2016_17_NE_MIA,MIA,NE,17,2016,205,75,276,120,280,396,350.6666666666667,395.46666666666664,375.3333333333333,340.1333333333333,12,28,21,9
2016_17_NO_ATL,ATL,NO,17,2016,331,142,350,132,473,482,427.6666666666667,434.53333333333336,360.73333333333335,364.46666666666664,31,32,14,16
2016_17_NYG_WAS,WAS,NYG,17,2016,287,38,180,161,325,341,421.26666666666665,339.8666666666667,369.46666666666664,350.1333333333333,30,8,18,11
2016_17_OAK_DEN,DEN,LV,17,2016,206,143,171,57,349,228,336.6,388.73333333333335,353,380.26666666666665,6,27,13,24
2016_17_SEA_SF,SF,SEA,17,2016,215,62,300,87,277,387,327.2,375.06666666666666,291.3333333333333,387.3333333333333,2,20,1,26
2016_18_DET_SEA,SEA,DET,18,2016,224,177,205,49,401,254,375.8125,352.3125,324.0625,384.125,5,4,1,6
2016_18_MIA_PIT,PIT,MIA,18,2016,197,179,289,52,376,341,383.5625,346.25,337.8125,395.5,7,3,3,7
2016_18_NYG_GB,GB,NYG,18,2016,362,75,299,70,437,369,384.125,339.9375,352.3125,415.25,8,2,4,8
2016_18_OAK_HOU,HOU,LV,18,2016,168,123,161,64,291,225,329.8125,378.6875,369.1875,337.375,1,6,5,2
2016_19_GB_DAL,DAL,GB,19,2016,302,138,355,87,440,442,387.1875,387.2352941176471,350.6875,341.6470588235294,5,6,5,1
2016_19_HOU_NE,NE,HOU,19,2016,287,98,197,105,385,302,395.5,327.52941176470586,346.25,369.6470588235294,7,1,3,7
2016_19_PIT_KC,KC,PIT,19,2016,172,61,224,171,233,395,353.875,383.11764705882354,368.5,345.94117647058823,2,4,6,2
2016_19_SEA_ATL,ATL,SEA,19,2016,338,99,225,101,437,326,430.5,377.29411764705884,437.5,346.52941176470586,8,3,8,4
2016_20_GB_ATL,ATL,GB,20,2016,392,101,287,99,493,386,430.88235294117646,390.27777777777777,374.27681660899657,390.12152777777777,4,2,3,4
2016_20_PIT_NE,NE,PIT,20,2016,384,57,314,54,441,368,394.88235294117646,383.77777777777777,326.02768166089965,347.15972222222223,3,1,1,2
2016_21_NE_ATL,ATL,NE,21,2016,284,104,466,104,388,570,434.3333333333333,397.44444444444446,390.04012345679007,382.9012345679012,2,1,2,1
2017_01_ARI_DET,DET,ARI,1,2017,292,82,268,45,374,313,0,0,0,0,30,30,30,30
2017_01_ATL_CHI,CHI,ATL,1,2017,213,125,321,64,338,385,0,0,0,0,30,30,30,30
2017_01_BAL_CIN,CIN,BAL,1,2017,170,77,121,157,247,278,0,0,0,0,30,30,30,30
2017_01_CAR_SF,SF,CAR,1,2017,193,51,171,116,244,287,0,0,0,0,30,30,30,30
2017_01_IND_LA,LA,IND,1,2017,318,63,179,75,381,254,0,0,0,0,30,30,30,30
2017_01_JAX_HOU,HOU,JAX,1,2017,164,93,125,155,257,280,0,0,0,0,30,30,30,30
2017_01_KC_NE,NE,KC,1,2017,267,124,368,185,391,553,0,0,0,0,30,30,30,30
2017_01_LAC_DEN,DEN,LAC,1,2017,219,140,192,64,359,256,0,0,0,0,30,30,30,30
2017_01_NO_MIN,MIN,NO,1,2017,346,129,291,60,475,351,0,0,0,0,30,30,30,30
2017_01_NYG_DAL,DAL,NYG,1,2017,268,129,220,35,397,255,0,0,0,0,30,30,30,30
2017_01_NYJ_BUF,BUF,NYJ,1,2017,224,190,187,38,414,225,0,0,0,0,30,30,30,30
2017_01_OAK_TEN,TEN,LV,1,2017,256,95,262,109,351,371,0,0,0,0,30,30,30,30
2017_01_PHI_WAS,WAS,PHI,1,2017,240,64,307,58,304,365,0,0,0,0,30,30,30,30
2017_01_PIT_CLE,CLE,PIT,1,2017,222,57,263,35,279,298,0,0,0,0,30,30,30,30
2017_01_SEA_GB,GB,SEA,1,2017,311,84,158,90,395,248,0,0,0,0,30,30,30,30
2017_02_ARI_IND,IND,ARI,2,2017,216,76,332,83,292,415,254,313,381,374,7,17,25,24
2017_02_BUF_CAR,CAR,BUF,2,2017,228,77,125,69,305,194,287,414,244,225,14,30,4,3
2017_02_CHI_TB,TB,CHI,2,2017,204,117,301,20,321,321,0,338,0,385,2,18,2,26
2017_02_CLE_BAL,BAL,CLE,2,2017,217,136,300,93,353,393,278,279,247,298,11,12,5,15
2017_02_DAL_DEN,DEN,DAL,2,2017,231,178,238,40,409,278,359,397,256,255,21,29,9,8
2017_02_DET_NYG,NYG,DET,2,2017,239,62,122,138,301,260,255,374,397,313,8,24,29,17
2017_02_GB_ATL,ATL,GB,2,2017,252,141,343,59,393,402,385,395,338,248,26,28,18,6
2017_02_HOU_CIN,CIN,HOU,2,2017,224,82,125,168,306,293,247,257,278,280,5,10,11,13
2017_02_MIA_LAC,LAC,MIA,2,2017,331,44,230,111,375,341,256,0,359,0,9,2,21,2
2017_02_MIN_PIT,PIT,MIN,2,2017,243,102,167,91,345,258,298,475,279,351,15,31,12,20
2017_02_NE_NO,NO,NE,2,2017,356,81,447,119,437,566,351,391,475,553,20,27,31,32
2017_02_NYJ_OAK,LV,NYJ,2,2017,230,180,166,126,410,292,371,225,351,414,23,3,20,30
2017_02_PHI_KC,KC,PHI,2,2017,251,112,333,107,363,440,553,365,391,304,32,22,27,16
2017_02_SF_SEA,SEA,SF,2,2017,198,131,99,159,329,258,248,244,395,287,6,4,28,14
2017_02_TEN_JAX,JAX,TEN,2,2017,223,99,215,179,322,394,280,351,257,371,13,20,10,23
2017_02_WAS_LA,LA,WAS,2,2017,247,97,179,229,344,408,381,304,254,365,25,16,7,22
2017_03_ATL_DET,DET,ATL,3,2017,264,71,294,151,335,445,317,389,278,398.5,13,26,8,29
2017_03_BAL_JAX,JAX,BAL,3,2017,244,166,64,134,410,198,301,315.5,372.5,336,9,12,23,17
2017_03_CIN_GB,GB,CIN,3,2017,313,64,212,110,377,322,398.5,276.5,389,275,29,5,26,6
2017_03_CLE_IND,IND,CLE,3,2017,259,92,242,111,351,353,273,336,364,315.5,3,17,21,13
2017_03_DAL_ARI,ARI,DAL,3,2017,325,49,183,99,374,282,364,337.5,273,384,22,18,5,25
2017_03_DEN_BUF,BUF,DEN,3,2017,213,75,259,111,288,370,304,384,296,337.5,10,25,10,18
2017_03_HOU_NE,NE,HOU,3,2017,378,59,301,125,437,426,478.5,275,394,276.5,32,4,28,7
2017_03_KC_LAC,LAC,KC,3,2017,237,104,155,189,341,344,315.5,458,170.5,402.5,12,31,2,30
2017_03_LA_SF,SF,LA,3,2017,332,113,292,126,445,418,251,362.5,288.5,356,1,21,9,19
2017_03_MIA_NYJ,NYJ,MIA,3,2017,249,103,220,30,352,250,258.5,341,390.5,375,2,19,27,24
2017_03_NO_CAR,CAR,NO,3,2017,184,132,220,149,316,369,296,394,304,478.5,8,28,12,32
2017_03_NYG_PHI,PHI,NYG,3,2017,176,193,366,49,369,415,402.5,278,458,317,30,6,31,14
2017_03_OAK_WAS,WAS,LV,3,2017,365,116,118,32,481,150,356,390.5,362.5,258.5,20,27,20,4
2017_03_PIT_CHI,CHI,PIT,3,2017,101,222,235,70,323,305,329.5,321.5,160.5,366.5,16,15,1,22
2017_03_SEA_TEN,TEN,SEA,3,2017,225,195,373,69,420,442,372.5,288.5,301,251,24,7,11,3
2017_03_TB_MIN,MIN,TB,3,2017,369,125,328,26,494,354,366.5,321,321.5,321,23,14,16,15
2017_04_BUF_ATL,ATL,BUF,4,2017,242,147,182,117,389,299,407.6666666666667,298.6666666666667,323,379.3333333333333,29,5,12,22
2017_04_CAR_NE,NE,CAR,4,2017,307,80,316,140,387,456,464.6666666666667,302.6666666666667,325.3333333333333,385.6666666666667,32,7,15,24
2017_04_CHI_GB,GB,CHI,4,2017,179,91,218,103,270,321,391.3333333333333,327.3333333333333,291.6666666666667,316,27,16,2,10
2017_04_CIN_CLE,CLE,CIN,4,2017,183,45,286,86,228,372,341.6666666666667,291.6666666666667,299,391.3333333333333,20,3,4,27
2017_04_DET_MIN,MIN,DET,4,2017,219,87,209,97,306,306,409,323,332,407.6666666666667,30,12,17,29
2017_04_IND_SEA,SEA,IND,4,2017,295,194,157,98,489,255,339.6666666666667,299,388.3333333333333,341.6666666666667,19,6,25,20
2017_04_JAX_NYJ,NYJ,JAX,4,2017,255,256,140,175,511,315,289.6666666666667,337.3333333333333,310.6666666666667,276.3333333333333,2,17,8,1
2017_04_LA_DAL,DAL,LA,4,2017,252,189,255,168,441,423,319,381,367.3333333333333,315.6666666666667,11,23,21,9
2017_04_NO_MIA,MIA,NO,4,2017,164,58,268,86,222,354,295.5,385.6666666666667,305.25,302.6666666666667,4,24,6,5
2017_04_NYG_TB,TB,NYG,4,2017,332,111,288,91,443,379,337.5,323.6666666666667,430.25,391.3333333333333,18,13,31,27
2017_04_OAK_DEN,DEN,LV,4,2017,179,143,249,24,322,273,379.3333333333333,310.3333333333333,298.6666666666667,397.6666666666667,22,8,3,28
2017_04_PHI_LAC,LAC,PHI,4,2017,347,58,242,214,405,456,324,391.3333333333333,420,323.6666666666667,14,27,30,13
2017_04_PIT_BAL,BAL,PIT,4,2017,235,82,216,173,317,389,276.3333333333333,316,337.3333333333333,327.3333333333333,1,10,18,16
2017_04_SF_ARI,ARI,SF,4,2017,357,51,234,95,408,329,367.3333333333333,315.6666666666667,319,381,21,9,11,23
2017_04_TEN_HOU,HOU,TEN,4,2017,283,173,117,86,456,203,325.3333333333333,388.3333333333333,464.6666666666667,339.6666666666667,15,25,32,19
2017_04_WAS_KC,KC,WAS,4,2017,293,136,220,111,429,331,420,397.6666666666667,324,310.3333333333333,31,28,14,7
2017_05_ARI_PHI,PHI,ARI,5,2017,304,122,291,31,426,322,407.5,377.5,344.25,319,26,23,13,6
2017_05_BAL_OAK,LV,BAL,5,2017,159,108,222,143,267,365,301,286.5,365,334.25,5,2,19,9
2017_05_BUF_CIN,CIN,BUF,5,2017,328,65,166,82,393,248,311.75,298.75,313.25,403,6,4,4,26
2017_05_CAR_DET,DET,CAR,5,2017,229,50,355,28,279,383,318.75,341,383.25,445.25,8,14,24,28
2017_05_GB_DAL,DAL,GB,5,2017,251,163,221,160,414,381,349.5,361,391.5,325.75,18,20,25,7
2017_05_JAX_PIT,PIT,JAX,5,2017,312,70,95,231,382,326,334.25,331.75,286.5,345,12,11,1,14
2017_05_KC_HOU,HOU,KC,5,2017,261,144,324,127,405,451,358,422.25,342,381,19,27,11,23
2017_05_LAC_NYG,NYG,LAC,5,2017,225,152,258,124,377,382,337.5,344.25,363.875,407.5,13,16,18,27
2017_05_MIN_CHI,CHI,MIN,5,2017,166,115,176,159,281,335,325.75,383.25,361,318.75,10,24,17,5
2017_05_NE_TB,TB,NE,5,2017,334,90,303,113,424,416,372.6666666666667,445.25,342.11111111111114,341,21,28,12,10
2017_05_NYJ_CLE,CLE,NYJ,5,2017,281,140,194,34,421,228,313.25,345,311.75,331.75,7,17,3,8
2017_05_SEA_LA,LA,SEA,5,2017,288,100,198,62,388,260,391.5,377,349.5,288,25,22,15,2
2017_05_SF_IND,IND,SF,5,2017,314,159,353,66,473,419,288,319,377,377.5,3,9,21,22
2017_05_TEN_MIA,MIA,TEN,5,2017,92,100,141,69,192,210,271,342,375.11111111111114,358,1,15,20,16
2017_06_CHI_BAL,BAL,CHI,6,2017,180,125,134,231,305,365,302.2,316.8,294.2,373.6,3,6,3,23
2017_06_CLE_HOU,HOU,CLE,6,2017,225,123,140,134,348,274,367.4,334.8,428,321.6,19,10,27,10
2017_06_DET_NO,NO,DET,6,2017,186,193,312,66,379,378,377.75,310.8,277.125,349.4,21,4,2,17
2017_06_GB_MIN,MIN,GB,6,2017,239,112,175,72,351,247,373.6,365,316.8,362.4,20,17,9,20
2017_06_IND_TEN,TEN,IND,6,2017,306,168,212,85,474,297,315.6,325,255.2,339,5,8,1,14
2017_06_LA_JAX,JAX,LA,6,2017,241,169,124,142,410,266,330.6,390.8,343.8,353.6,9,24,15,19
2017_06_LAC_OAK,LV,LAC,6,2017,171,109,268,80,280,348,294.2,351.8,302.2,345.4,2,15,6,16
2017_06_MIA_ATL,ATL,MIA,6,2017,248,100,151,138,348,289,403,251.25,298.75,309,25,1,4,7
2017_06_NE_NYJ,NYJ,NE,6,2017,354,74,257,118,428,375,321.6,439.4,334.8,382.93333333333334,7,28,13,24
2017_06_NYG_DEN,DEN,NYG,6,2017,394,46,128,148,440,276,365,345.4,301,351.8,17,13,5,18
2017_06_PHI_CAR,CAR,PHI,6,2017,239,80,222,101,319,323,349.4,411.2,310.8,366.4,14,26,8,21
2017_06_PIT_KC,KC,PIT,6,2017,246,28,252,194,274,446,428,343.8,367.4,330.6,27,12,22,12
2017_06_SF_WAS,WAS,SF,6,2017,330,94,279,85,424,364,381,339,422.25,325,22,11,26,11
2017_06_TB_ARI,ARI,TB,6,2017,283,160,351,70,443,421,366.4,385.5,411.2,437.9375,18,23,25,28
2017_07_ARI_LA,LA,ARI,7,2017,235,197,188,25,432,213,370,379.1666666666667,343.8333333333333,391.4166666666667,21,23,12,26
2017_07_ATL_NE,NE,ATL,7,2017,249,162,233,120,411,353,428.6666666666667,392,339.3333333333333,258.8,30,26,10,1
2017_07_BAL_MIN,MIN,BAL,7,2017,188,169,186,64,357,250,369.8333333333333,302.6666666666667,345.3333333333333,324.8333333333333,20,4,15,7
2017_07_CAR_CHI,CHI,CAR,7,2017,107,68,211,108,175,319,324.8333333333333,344.3333333333333,302.6666666666667,396.5,7,14,4,28
2017_07_CIN_PIT,PIT,CIN,7,2017,268,152,140,71,420,211,360.8333333333333,328,402.3333333333333,288.6,18,8,29,2
2017_07_DAL_SF,SF,DAL,7,2017,235,103,236,265,338,501,343.1666666666667,362.4,388.1666666666667,365,12,19,24,19
2017_07_DEN_LAC,LAC,DEN,7,2017,183,80,207,69,263,276,351.1666666666667,380,291.8333333333333,331.52,16,24,3,9
2017_07_JAX_IND,IND,JAX,7,2017,200,96,330,188,296,518,320.3333333333333,343.8333333333333,342,370,5,13,11,21
2017_07_KC_OAK,LV,KC,7,2017,417,88,342,94,505,436,291.8333333333333,402.3333333333333,351.1666666666667,360.8333333333333,3,29,16,17
2017_07_NO_GB,GB,NO,7,2017,87,181,331,161,268,492,345.3333333333333,378,369.8333333333333,324.24,15,22,20,6
2017_07_NYJ_MIA,MIA,NYJ,7,2017,326,53,209,92,379,301,258.8,339.3333333333333,392,428.6666666666667,1,10,27,30
2017_07_SEA_NYG,NYG,SEA,7,2017,134,46,334,104,180,438,333.8333333333333,353.6,377.5,390.8,9,17,22,25
2017_07_TB_BUF,BUF,TB,7,2017,268,173,384,69,441,453,288.6,392.6,328,381.71999999999997,2,27,8,23
2017_07_TEN_CLE,CLE,TEN,7,2017,235,66,203,80,301,283,324.6666666666667,342,364.1666666666667,320.3333333333333,6,11,18,5
2017_07_WAS_PHI,PHI,WAS,7,2017,268,127,303,75,395,378,396.5,389.6,344.3333333333333,344,28,25,14,13
2017_08_ATL_NYJ,NYJ,ATL,8,2017,257,43,254,140,300,394,333.85714285714283,385.5,275.9714285714286,425.72222222222223,10,20,1,26
2017_08_CAR_TB,TB,CAR,8,2017,210,85,154,100,295,254,402.6666666666667,340.7142857142857,314,303.42857142857144,24,12,6,3
2017_08_CHI_NO,NO,CHI,8,2017,299,101,164,157,400,321,397,303.42857142857144,332.4444444444444,340.7142857142857,23,3,9,13
2017_08_DAL_WAS,WAS,DAL,8,2017,263,49,143,169,312,312,387.6666666666667,385.5,396.25,342.3055555555556,21,20,23,14
2017_08_DEN_KC,KC,DEN,8,2017,202,79,198,177,281,375,407.14285714285717,362.6666666666667,322.2857142857143,336.47222222222223,25,14,7,12
2017_08_HOU_SEA,SEA,HOU,8,2017,452,33,402,142,485,544,367.6666666666667,364.1666666666667,308.1944444444444,324.6666666666667,16,15,4,8
2017_08_IND_CIN,CIN,IND,8,2017,243,58,233,115,301,348,308.5,316.85714285714283,370.6944444444444,368.7142857142857,4,6,18,17
2017_08_LAC_NE,NE,LAC,8,2017,333,97,212,157,430,369,426.14285714285717,338.57142857142856,386.42857142857144,365.14285714285717,26,11,21,15
2017_08_MIA_BAL,BAL,MIA,8,2017,121,174,176,45,295,221,295.14285714285717,278.8333333333333,368,332.9444444444444,2,1,16,10
2017_08_MIN_CLE,CLE,MIN,8,2017,179,115,288,88,294,376,321.2857142857143,368,333.57142857142856,295.14285714285717,7,17,11,2
2017_08_OAK_BUF,BUF,LV,8,2017,165,166,313,54,331,367,314,322.2857142857143,402.6666666666667,407.14285714285717,5,9,24,25
2017_08_PIT_DET,DET,PIT,8,2017,423,71,317,75,494,392,322,369.2857142857143,377.9583333333333,311.2857142857143,8,18,19,5
2017_08_SF_PHI,PHI,SF,8,2017,211,112,167,94,323,261,396.2857142857143,342.42857142857144,387.9428571428572,382.19999999999993,22,13,22,20
2017_09_ARI_SF,SF,ARI,9,2017,294,63,201,167,357,368,332.25,355.42857142857144,387.125,378.85714285714283,10,14,22,19
2017_09_ATL_CAR,CAR,ATL,9,2017,137,201,313,53,338,366,329.875,386.7142857142857,389.20833333333337,329.02040816326524,9,21,24,11
2017_09_BAL_TEN,TEN,BAL,9,2017,218,71,277,73,289,350,333.57142857142856,295.125,321.2857142857143,271.60416666666663,11,2,7,1
2017_09_BUF_NYJ,NYJ,BUF,9,2017,140,194,285,63,334,348,329.625,316.42857142857144,386.5625,328.6734693877551,8,5,21,10
2017_09_CIN_JAX,JAX,CIN,9,2017,259,149,136,29,408,165,368.7142857142857,307.42857142857144,316.85714285714283,321.3061224489796,16,3,6,8
2017_09_DEN_PHI,PHI,DEN,9,2017,234,197,208,35,431,243,387.125,364.42857142857144,332.25,389.12244897959187,22,15,12,23
2017_09_DET_GB,GB,DET,9,2017,245,78,361,64,323,425,334.2857142857143,346.57142857142856,394.2857142857143,372.53061224489795,12,13,26,16
2017_09_IND_HOU,HOU,IND,9,2017,219,94,308,92,313,400,389.85714285714283,320.75,384.42857142857144,307.5625,24,6,20,4
2017_09_KC_DAL,DAL,KC,9,2017,249,131,263,68,380,331,375,391.375,376.85714285714283,364.20833333333337,17,25,18,14
2017_09_LA_NYG,NYG,LA,9,2017,220,111,311,162,331,473,311.85714285714283,378.85714285714283,365.6571428571429,355.42857142857144,4,19,15,13
2017_09_OAK_MIA,MIA,LV,9,2017,311,86,300,84,397,384,270.57142857142856,327.875,295.12244897959187,316.125,1,7,2,5
2017_09_TB_NO,NO,TB,9,2017,263,151,135,87,414,222,397.42857142857144,387.2857142857143,305.93877551020404,328.3265306122449,26,23,3,9
2017_09_WAS_SEA,SEA,WAS,9,2017,297,148,247,51,445,298,384.42857142857144,376.85714285714283,389.85714285714283,375,20,18,25,17
2017_10_CIN_TEN,TEN,CIN,10,2017,264,180,265,53,444,318,328,289.625,301.984375,373.625,7,2,2,19
2017_10_CLE_DET,DET,CLE,10,2017,249,104,237,201,353,438,356.375,317.875,332.875,369,15,5,9,18
2017_10_DAL_ATL,ATL,DAL,10,2017,215,132,176,107,347,283,384.125,375.625,330.890625,383.828125,24,22,8,21
2017_10_GB_CHI,CHI,GB,10,2017,297,55,212,160,352,372,305.625,332.875,397.375,356.375,3,11,26,14
2017_10_HOU_LA,LA,HOU,10,2017,361,104,221,89,465,310,390.625,380.25,314.25,330.65625,25,23,3,7
2017_10_LAC_JAX,JAX,LAC,10,2017,273,135,235,87,408,322,373.625,342.375,289.625,426.625,21,13,1,28
2017_10_MIA_CAR,CAR,MIA,10,2017,254,294,213,100,548,313,330.77777777777777,286.375,384.41269841269843,334.890625,10,1,22,10
2017_10_MIN_WAS,WAS,MIN,10,2017,327,81,304,102,408,406,367,369,392,317.875,18,19,24,4
2017_10_NE_DEN,DEN,NE,10,2017,221,118,303,99,339,402,349.25,426.625,392.609375,342.375,14,28,25,12
2017_10_NO_BUF,BUF,NO,10,2017,135,69,184,298,204,482,320.375,399.5,330.171875,366.625,6,27,6,16
2017_10_NYG_SF,SF,NYG,10,2017,288,186,273,114,474,387,335,314.25,356.82539682539687,390.625,12,4,15,23
2017_10_NYJ_TB,TB,NYJ,10,2017,187,90,262,56,277,318,366.625,330.1111111111111,399.5,319.93650793650795,17,9,27,5
2017_10_PIT_IND,IND,PIT,10,2017,222,71,236,88,293,324,329.55555555555554,372.125,381.3174603174603,343.5,8,20,20,13
2017_10_SEA_ARI,ARI,SEA,10,2017,273,34,238,75,307,313,357,392,335.34375,367,16,26,11,17
2017_11_ARI_HOU,HOU,ARI,11,2017,230,134,257,48,364,305,372.44444444444446,351.44444444444446,398.8888888888889,383.22222222222223,19,13,26,25
2017_11_ATL_SEA,SEA,ATL,11,2017,254,136,195,89,390,284,383.22222222222223,380,351.44444444444446,365.3333333333333,23,22,15,18
2017_11_BAL_GB,GB,BAL,11,2017,239,75,183,58,314,241,337.22222222222223,301.22222222222223,310.77777777777777,328.6190476190476,9,3,4,6
2017_11_BUF_LAC,LAC,BUF,11,2017,284,146,224,173,430,397,340.1111111111111,307.44444444444446,377.44444444444446,408.6666666666667,10,4,23,27
2017_11_CIN_DEN,DEN,CIN,11,2017,254,112,154,49,366,203,348.1111111111111,292.77777777777777,423.8888888888889,340.8888888888889,12,2,28,11
2017_11_DET_CHI,CHI,DET,11,2017,179,222,299,65,401,364,310.77777777777777,356,337.22222222222223,331.22222222222223,5,14,9,8
2017_11_JAX_CLE,CLE,JAX,11,2017,179,50,154,139,229,293,331.22222222222223,377.44444444444446,356,340.1111111111111,7,21,17,10
2017_11_KC_NYG,NYG,KC,11,2017,205,112,230,134,317,364,322.3333333333333,384.6666666666667,350.44444444444446,375.55555555555554,6,24,13,22
2017_11_LA_MIN,MIN,LA,11,2017,280,171,225,45,451,270,373.1111111111111,398.8888888888889,371.55555555555554,372.44444444444446,20,26,19,20
2017_11_NE_OAK,LV,NE,11,2017,237,109,340,89,346,429,334.1111111111111,423.8888888888889,284.6190476190476,348.1111111111111,8,28,1,12
2017_11_PHI_DAL,DAL,PHI,11,2017,145,112,168,215,257,383,365.3333333333333,392,380,350.93650793650795,16,25,24,14
2017_11_TB_MIA,MIA,TB,11,2017,365,83,275,53,448,328,289.3333333333333,356.6666666666667,354.91358024691357,328.7654320987654,1,15,16,7
2017_11_TEN_PIT,PIT,TEN,11,2017,299,65,306,52,364,358,366.77777777777777,340.8888888888889,325.4938271604938,292.77777777777777,17,11,5,2
2017_11_WAS_NO,NO,WAS,11,2017,385,160,322,156,545,478,408.6666666666667,371.55555555555554,307.44444444444446,373.1111111111111,27,18,3,21
2017_12_BUF_KC,KC,BUF,12,2017,199,55,183,104,254,287,382.6,316.4,321.8,349.1,27,4,9,14
2017_12_CAR_NYJ,NYJ,CAR,12,2017,307,109,168,145,416,313,328.9,352.5,357.6625,289.0375,9,17,19,2
2017_12_CHI_PHI,PHI,CHI,12,2017,248,176,147,6,424,153,391.1,319.8,354.5,356.8,30,5,17,18
2017_12_CLE_CIN,CIN,CLE,12,2017,214,152,268,169,366,437,283.8,321,349.9,369,1,6,15,22
2017_12_DEN_OAK,LV,DEN,12,2017,253,104,190,56,357,246,335.3,349.9,424.4,283.8,11,16,32,1
2017_12_GB_PIT,PIT,GB,12,2017,351,121,245,80,472,325,366.5,334.9,342.6,295.2,21,10,12,3
2017_12_HOU_BAL,BAL,HOU,12,2017,163,139,252,66,302,318,295.2,371.6,334.9,346.8,2,24,10,13
2017_12_JAX_ARI,ARI,JAX,12,2017,241,108,160,91,349,251,346.8,369,371.6,321,13,22,24,7
2017_12_LAC_DAL,DAL,LAC,12,2017,179,79,434,81,258,515,354.5,349.1,391.1,316.4,19,15,30,5
2017_12_MIA_NE,NE,MIA,12,2017,227,196,215,67,423,282,424.4,305.2,335.3,353.8,32,3,11,16
2017_12_MIN_DET,DET,MIN,12,2017,250,53,282,136,303,418,356.8,380.9,319.8,386,20,25,6,29
2017_12_NO_LA,LA,NO,12,2017,354,88,246,123,442,369,386,422.3,380.9,382.2,29,31,25,26
2017_12_NYG_WAS,WAS,NYG,12,2017,242,122,113,84,364,197,382.2,321.8,422.3,382.6,26,7,31,27
2017_12_SEA_SF,SF,SEA,12,2017,219,84,228,90,303,318,348.9,383.9,321.525,370.4,14,28,8,23
2017_12_TB_ATL,ATL,TB,12,2017,368,148,283,94,516,377,370.4,353.8,383.9,305.2,23,18,28,4
2017_12_TEN_IND,IND,TEN,12,2017,196,89,184,92,285,276,325.9,342.6,367.3125,366.5,8,12,21,20
2017_13_CAR_NO,NO,CAR,13,2017,269,148,183,112,417,295,417.45454545454544,348.90909090909093,391.09090909090907,336.8181818181818,31,17,29,11
2017_13_CLE_LAC,LAC,CLE,13,2017,344,94,215,89,438,304,364.1818181818182,331.54545454545456,345.72727272727275,291.27272727272725,21,8,15,1
2017_13_DEN_MIA,MIA,DEN,13,2017,235,145,200,103,380,303,303.09090909090907,340.45454545454544,424.27272727272725,337.27272727272725,3,13,32,12
2017_13_DET_BAL,BAL,DET,13,2017,269,101,316,78,370,394,295.8181818181818,351.90909090909093,366.72727272727275,384.27272727272725,2,18,22,28
2017_13_HOU_TEN,TEN,HOU,13,2017,150,198,365,53,348,418,336.54545454545456,366.72727272727275,322.1818181818182,295.8181818181818,10,22,7,2
2017_13_IND_JAX,JAX,IND,13,2017,338,96,174,141,434,315,358.27272727272725,322.1818181818182,347,336.54545454545456,20,7,16,10
2017_13_KC_NYJ,NYJ,KC,13,2017,331,157,366,112,488,478,336.8181818181818,370.90909090909093,348.90909090909093,313.72727272727275,11,23,17,6
2017_13_LA_ARI,ARI,LA,13,2017,221,118,220,90,339,310,347,391.09090909090907,358.27272727272725,417.45454545454544,16,29,20,31
2017_13_MIN_ATL,ATL,MIN,13,2017,173,102,227,105,275,332,383.6363636363636,384.27272727272725,355.90909090909093,351.90909090909093,27,28,19,18
2017_13_NE_BUF,BUF,NE,13,2017,115,183,258,191,298,449,313.72727272727275,424.27272727272725,370.90909090909093,303.09090909090907,6,32,23,3
2017_13_NYG_OAK,LV,NYG,13,2017,287,119,212,65,406,277,337.27272727272725,310.45454545454544,340.45454545454544,380.54545454545456,12,5,13,26
2017_13_PHI_SEA,SEA,PHI,13,2017,227,84,348,98,311,446,377.90909090909093,394.09090909090907,344.72727272727275,304.6363636363636,25,30,14,4
2017_13_PIT_CIN,CIN,PIT,13,2017,234,130,290,92,364,382,291.27272727272725,376.09090909090907,331.54545454545456,334,1,24,8,9
2017_13_SF_CHI,CHI,SF,13,2017,102,62,293,110,164,403,304.6363636363636,344.72727272727275,394.09090909090907,377.90909090909093,4,14,30,25
2017_13_TB_GB,GB,TB,13,2017,84,199,270,165,283,435,334,355.90909090909093,376.09090909090907,383.6363636363636,9,19,24,27
2017_13_WAS_DAL,DAL,WAS,13,2017,102,182,251,56,284,307,345.72727272727275,380.54545454545456,364.1818181818182,310.45454545454544,15,26,21,5
2017_14_BAL_PIT,PIT,BAL,14,2017,506,59,269,152,565,421,376.5833333333333,302,297.3333333333333,355.4166666666667,26,3,2,18
2017_14_CHI_CIN,CIN,CHI,14,2017,188,70,271,232,258,503,297.3333333333333,292.9166666666667,376.5833333333333,349.5833333333333,2,1,26,17
2017_14_DAL_NYG,NYG,DAL,14,2017,228,102,332,122,330,454,307.6666666666667,340.5833333333333,343,374.4166666666667,4,12,13,24
2017_14_DET_TB,TB,DET,14,2017,285,133,381,53,418,434,362.5,355.4166666666667,329.75,302,19,18,9,3
2017_14_GB_CLE,CLE,GB,14,2017,214,136,265,85,350,350,329.25,329.75,370.3333333333333,362.5,8,9,21,19
2017_14_IND_BUF,BUF,IND,14,2017,92,227,69,163,319,232,312.4166666666667,321.5833333333333,426.3333333333333,364.5833333333333,6,7,32,20
2017_14_MIN_CAR,CAR,MIN,14,2017,137,216,280,100,353,380,344.4166666666667,379.9166666666667,417.4166666666667,374.5833333333333,14,28,31,25
2017_14_NE_MIA,MIA,NE,14,2017,263,120,233,25,383,258,309.49999999999994,426.3333333333333,337.3333333333333,312.4166666666667,5,32,10,6
2017_14_NO_ATL,ATL,NO,14,2017,221,132,271,50,353,321,374.5833333333333,417.4166666666667,379.9166666666667,344.4166666666667,25,31,28,14
2017_14_NYJ_DEN,DEN,NYJ,14,2017,200,84,60,59,284,119,337.3333333333333,349.4166666666667,309.49999999999994,379.8333333333333,10,16,5,27
2017_14_OAK_KC,KC,LV,14,2017,268,165,211,70,433,281,379.8333333333333,343,349.4166666666667,307.6666666666667,27,13,16,4
2017_14_PHI_LA,LA,PHI,14,2017,199,109,333,139,308,472,384.3333333333333,398.4166666666667,346.3333333333333,372.3333333333333,29,30,15,23
2017_14_SEA_JAX,JAX,SEA,14,2017,268,156,271,141,424,412,364.5833333333333,372.3333333333333,321.5833333333333,398.4166666666667,20,23,7,30
2017_14_SF_HOU,HOU,SF,14,2017,238,90,334,102,328,436,371,349.5833333333333,337.5,292.9166666666667,22,17,11,1
2017_14_TEN_ARI,ARI,TEN,14,2017,178,136,159,65,314,224,346.3333333333333,337.5,384.3333333333333,371,15,11,29,22
2017_14_WAS_LAC,LAC,WAS,14,2017,322,174,151,65,496,216,370.3333333333333,374.4166666666667,329.25,340.5833333333333,21,24,8,12
2017_15_ARI_WAS,WAS,ARI,15,2017,196,31,189,141,227,330,362.2307692307692,343.84615384615387,380,328.7692307692308,19,14,27,8
2017_15_ATL_TB,TB,ATL,15,2017,299,84,212,201,383,413,366.7692307692308,372.9230769230769,361.46153846153845,410,20,23,18,31
2017_15_BAL_CLE,CLE,BAL,15,2017,146,130,288,97,276,385,330.84615384615387,311.15384615384613,331.3076923076923,391.0769230769231,9,4,10,29
2017_15_CHI_DET,DET,CHI,15,2017,237,91,314,43,328,357,361.46153846153845,309.0769230769231,366.7692307692308,294.3076923076923,18,2,20,1
2017_15_CIN_MIN,MIN,CIN,15,2017,236,124,132,46,360,178,379.9230769230769,294.3076923076923,345.0769230769231,309.0769230769231,26,1,15,2
2017_15_DAL_OAK,LV,DAL,15,2017,171,122,212,126,293,338,338.2307692307692,349.3076923076923,383.9230769230769,309.38461538461536,13,16,28,3
2017_15_DEN_IND,IND,DEN,15,2017,158,70,261,211,228,472,314.6923076923077,333.2307692307692,312.9230769230769,331.6923076923077,6,12,5,11
2017_15_GB_CAR,CAR,GB,15,2017,242,151,290,120,393,410,345.0769230769231,331.3076923076923,379.9230769230769,330.84615384615387,15,10,26,9
2017_15_HOU_JAX,JAX,HOU,15,2017,326,138,128,87,464,215,369.15384615384613,367.6923076923077,375.38461538461536,356.2307692307692,22,21,24,17
2017_15_LA_SEA,SEA,LA,15,2017,142,78,124,244,220,368,375.38461538461536,378.46153846153845,369.15384615384613,404.0769230769231,24,25,22,30
2017_15_LAC_KC,KC,LAC,15,2017,231,174,227,98,405,325,383.9230769230769,380,338.2307692307692,362.2307692307692,28,27,13,19
2017_15_MIA_BUF,BUF,MIA,15,2017,224,116,274,100,340,374,312.9230769230769,315.1538461538461,314.6923076923077,413.38461538461536,5,7,6,32
2017_15_NE_PIT,PIT,NE,15,2017,281,143,298,77,424,375,391.0769230769231,413.38461538461536,311.15384615384613,315.1538461538461,29,32,4,7
2017_15_NYJ_NO,NO,NYJ,15,2017,281,131,179,124,412,303,410,331.6923076923077,372.9230769230769,333.2307692307692,31,11,23,12
2017_15_PHI_NYG,NYG,PHI,15,2017,434,75,237,108,509,345,309.38461538461536,404.0769230769231,349.3076923076923,378.46153846153845,3,30,16,25
2017_15_TEN_SF,SF,TEN,15,2017,381,51,241,90,432,331,356.2307692307692,328.7692307692308,367.6923076923077,343.84615384615387,17,8,21,14
2017_16_ATL_NO,NO,ATL,16,2017,239,86,288,67,325,355,410.14285714285717,375.7857142857143,329.64285714285717,367.92857142857144,31,23,10,22
2017_16_BUF_NE,NE,BUF,16,2017,224,193,281,84,417,365,410.64285714285717,314.85714285714283,393.42857142857144,319.3571428571428,32,4,29,6
2017_16_CLE_CHI,CHI,CLE,16,2017,193,97,182,76,290,258,312.5,326.92857142857144,359.07142857142856,316.42857142857144,3,8,19,5
2017_16_DEN_WAS,WAS,DEN,16,2017,299,87,193,159,386,352,352.57142857142856,343.14285714285717,342.85714285714283,308.5,17,14,13,2
2017_16_DET_CIN,CIN,DET,16,2017,238,142,203,87,380,290,286,359.07142857142856,378.5,312.5,1,19,27,3
2017_16_IND_BAL,BAL,IND,16,2017,237,103,215,93,340,308,316.42857142857144,308.5,326.92857142857144,343.14285714285717,5,2,8,14
2017_16_JAX_SF,SF,JAX,16,2017,242,131,382,92,373,474,361.64285714285717,375.92857142857144,328.92857142857144,356.7857142857143,20,24,9,18
2017_16_LA_TEN,TEN,LA,16,2017,275,97,301,116,372,417,328.92857142857144,377.7142857142857,361.64285714285717,364.2857142857143,9,26,20,21
2017_16_LAC_NYJ,NYJ,LAC,16,2017,119,197,290,89,316,379,329.64285714285717,376.07142857142856,410.14285714285717,385.42857142857144,10,25,31,28
2017_16_MIA_KC,KC,MIA,16,2017,304,103,286,59,407,345,385.42857142857144,319.3571428571428,376.07142857142856,314.85714285714283,28,6,25,4
2017_16_MIN_GB,GB,MIN,16,2017,130,113,139,112,243,251,336.92857142857144,378.5,348.5,286,12,27,16,1
2017_16_NYG_ARI,ARI,NYG,16,2017,230,74,263,43,304,306,342.85714285714283,323.64285714285717,352.57142857142856,399.85714285714283,13,7,17,30
2017_16_OAK_PHI,PHI,LV,16,2017,163,78,140,137,241,277,399.85714285714283,335,323.64285714285717,348.5,30,11,7,16
2017_16_PIT_HOU,HOU,PIT,16,2017,93,176,226,104,269,330,356.7857142857143,393.42857142857144,375.92857142857144,410.64285714285717,18,29,24,32
2017_16_SEA_DAL,DAL,SEA,16,2017,181,128,93,76,309,169,348.5,364.2857142857143,335,377.7142857142857,16,21,11,26
2017_16_TB_CAR,CAR,TB,16,2017,160,115,367,66,275,433,348.5,367.92857142857144,336.92857142857144,375.7857142857143,16,22,12,23
2017_17_ARI_SEA,SEA,ARI,17,2017,221,101,145,116,322,261,351.26666666666665,340.26666666666665,345.8666666666667,322.46666666666664,18,13,16,8
2017_17_BUF_MIA,MIA,BUF,17,2017,271,93,204,126,364,330,321.0666666666666,318.2,386.8666666666667,411.06666666666666,6,5,28,32
2017_17_CAR_ATL,ATL,CAR,17,2017,317,60,180,87,377,267,374.4,343.6,404.46666666666664,372.26666666666665,24,14,31,23
2017_17_CHI_MIN,MIN,CHI,17,2017,189,147,178,30,336,208,370,311,330.6666666666667,322.3333333333333,22,3,10,7
2017_17_CIN_BAL,BAL,CIN,17,2017,203,118,222,146,321,368,318,292.26666666666665,308.46666666666664,354.46666666666664,4,1,2,19
2017_17_CLE_PIT,PIT,CLE,17,2017,239,124,314,102,363,416,389.2,322.3333333333333,350.93333333333334,311,29,7,17,3
2017_17_DAL_PHI,PHI,DAL,17,2017,173,70,179,129,243,308,389.26666666666665,345.8666666666667,331.1333333333333,351.26666666666665,30,16,11,18
2017_17_GB_DET,DET,GB,17,2017,323,51,193,103,374,296,354.46666666666664,330.6666666666667,292.26666666666665,370,19,10,1,22
2017_17_HOU_IND,IND,HOU,17,2017,114,146,137,85,260,222,308.46666666666664,350.93333333333334,318,389.2,2,17,4,29
2017_17_JAX_TEN,TEN,JAX,17,2017,134,116,158,83,250,241,331.8,382.46666666666664,380.3333333333333,362.4,12,27,26,21
2017_17_KC_DEN,DEN,KC,17,2017,254,110,284,110,364,394,343.73333333333335,386.8666666666667,354.8,321.0666666666666,15,28,20,6
2017_17_NO_TB,TB,NO,17,2017,363,110,245,92,473,337,372.26666666666665,404.46666666666664,343.6,374.4,23,31,14,24
2017_17_NYJ_NE,NE,NYJ,17,2017,195,147,232,40,342,272,411.06666666666666,328.73333333333335,318.2,376.26666666666665,32,9,5,25
2017_17_OAK_LAC,LAC,LV,17,2017,387,115,243,105,502,348,376.26666666666665,331.1333333333333,328.73333333333335,389.26666666666665,25,11,9,30
2017_17_SF_LA,LA,SF,17,2017,169,102,292,169,271,461,380.3333333333333,362.4,331.8,382.46666666666664,26,21,12,27
2017_17_WAS_NYG,NYG,WAS,17,2017,132,260,158,61,392,219,322.46666666666664,354.8,340.26666666666665,343.73333333333335,8,20,13,15
2017_18_ATL_LA,LA,ATL,18,2017,259,115,218,124,374,342,373.5,374.5625,368.5625,338.8125,4,6,5,3
2017_18_BUF_JAX,JAX,BUF,18,2017,87,155,148,130,242,278,373.625,318.9375,326.6875,323.74999999999994,5,1,2,1
2017_18_CAR_NO,NO,CAR,18,2017,376,41,349,107,417,456,400.25,338.8125,378.5625,374.5625,8,3,8,7
2017_18_TEN_KC,KC,TEN,18,2017,264,69,205,202,333,407,387.3125,326.6875,345,373.625,7,2,4,6
2017_19_ATL_PHI,PHI,ATL,19,2017,246,96,210,86,342,296,380.125,372.6470588235294,343.5,373.52941176470586,5,4,5,7
2017_19_JAX_PIT,PIT,JAX,19,2017,469,75,214,164,544,378,387.5625,365.88235294117646,328.1875,316.52941176470586,6,2,4,2
2017_19_NO_MIN,MIN,NO,19,2017,318,95,294,80,413,374,367.875,401.2352941176471,304.5625,345.70588235294116,3,7,1,6
2017_19_TEN_NE,NE,TEN,19,2017,337,101,254,65,438,319,406.75,331.4117647058824,325.1875,384.11764705882354,8,1,3,8
2017_20_JAX_NE,NE,JAX,20,2017,310,46,293,101,356,394,408.5882352941176,366.55555555555554,330.681660899654,396.25347222222223,4,1,1,3
2017_20_MIN_PHI,PHI,MIN,20,2017,352,110,271,70,462,341,377.88235294117646,370.52941176470586,368.1384083044982,399.6332179930796,3,2,2,4
2017_21_PHI_NE,NE,PHI,21,2017,505,113,374,164,618,538,405.6666666666667,382.55555555555554,368.08024691358025,368.8888888888889,2,1,1,2
2018_01_ATL_PHI,PHI,ATL,1,2018,132,113,251,74,245,325,0,0,0,0,32,32,32,32
2018_01_BUF_BAL,BAL,BUF,1,2018,260,117,98,83,377,181,0,0,0,0,32,32,32,32
2018_01_CHI_GB,GB,CHI,1,2018,341,69,171,139,410,310,0,0,0,0,32,32,32,32
2018_01_CIN_IND,IND,CIN,1,2018,319,75,243,101,394,344,0,0,0,0,32,32,32,32
2018_01_DAL_CAR,CAR,DAL,1,2018,161,147,170,94,308,264,0,0,0,0,32,32,32,32
2018_01_HOU_NE,NE,HOU,1,2018,277,122,176,167,399,343,0,0,0,0,32,32,32,32
2018_01_JAX_NYG,NYG,JAX,1,2018,224,114,176,137,338,313,0,0,0,0,32,32,32,32
2018_01_KC_LAC,LAC,KC,1,2018,424,123,256,106,547,362,0,0,0,0,32,32,32,32
2018_01_LA_OAK,LV,LA,1,2018,303,95,233,140,398,373,0,0,0,0,32,32,32,32
2018_01_NYJ_DET,DET,NYJ,1,2018,300,39,198,169,339,367,0,0,0,0,32,32,32,32
2018_01_PIT_CLE,CLE,PIT,1,2018,197,177,335,159,374,494,0,0,0,0,32,32,32,32
2018_01_SEA_DEN,DEN,SEA,1,2018,329,146,298,64,475,362,0,0,0,0,32,32,32,32
2018_01_SF_MIN,MIN,SF,1,2018,244,116,261,90,360,351,0,0,0,0,32,32,32,32
2018_01_TB_NO,NO,TB,1,2018,439,43,417,112,482,529,0,0,0,0,32,32,32,32
2018_01_TEN_MIA,MIA,TEN,1,2018,230,120,220,116,350,336,0,0,0,0,32,32,32,32
2018_01_WAS_ARI,ARI,WAS,1,2018,153,68,255,182,221,437,0,0,0,0,32,32,32,32
2018_02_ARI_LA,LA,ARI,2,2018,354,90,90,54,444,144,373,221,398,437,20,2,24,27
2018_02_BAL_CIN,CIN,BAL,2,2018,265,108,376,66,373,442,344,377,394,181,13,22,23,1
2018_02_CAR_ATL,ATL,CAR,2,2018,272,170,335,121,442,456,325,308,245,264,8,5,3,4
2018_02_CLE_NO,NO,CLE,2,2018,243,62,246,93,305,339,482,374,529,494,29,21,31,30
2018_02_DET_SF,SF,DET,2,2018,206,190,347,98,396,445,351,339,360,367,15,11,16,19
2018_02_HOU_TEN,TEN,HOU,2,2018,191,100,310,148,291,458,336,343,350,399,9,12,14,25
2018_02_IND_WAS,WAS,IND,2,2018,292,65,179,104,357,283,437,394,221,344,27,23,2,13
2018_02_KC_PIT,PIT,KC,2,2018,452,33,326,127,485,453,494,362,374,547,30,18,21,32
2018_02_LAC_BUF,BUF,LAC,2,2018,245,84,256,109,329,365,181,547,377,362,1,32,22,18
2018_02_MIA_NYJ,NYJ,MIA,2,2018,334,42,168,135,376,303,367,350,339,336,19,14,11,9
2018_02_MIN_GB,GB,MIN,2,2018,281,98,425,68,379,493,410,360,310,351,26,16,6,15
2018_02_NE_JAX,JAX,NE,2,2018,376,104,234,82,480,316,313,399,338,343,7,25,10,12
2018_02_NYG_DAL,DAL,NYG,2,2018,160,138,279,35,298,314,264,338,308,313,4,10,5,7
2018_02_OAK_DEN,DEN,LV,2,2018,222,168,288,92,390,380,475,398,362,373,28,24,18,20
2018_02_PHI_TB,TB,PHI,2,2018,402,43,334,91,445,425,529,245,482,325,31,3,29,8
2018_02_SEA_CHI,CHI,SEA,2,2018,200,86,226,74,286,300,310,362,410,475,6,18,26,28
2018_03_BUF_MIN,MIN,BUF,3,2018,296,14,196,128,310,324,426.5,255,394.5,456,28,2,21,30
2018_03_CHI_ARI,ARI,CHI,3,2018,193,53,220,122,246,342,182.5,298,408.5,331,1,4,26,8
2018_03_CIN_CAR,CAR,CIN,3,2018,150,230,352,66,380,418,382,358.5,383.5,409.5,16,13,17,27
2018_03_DAL_SEA,SEA,DAL,3,2018,192,113,168,166,305,334,331,281,298,326,8,3,4,6
2018_03_DEN_BAL,BAL,DEN,3,2018,277,77,192,120,354,312,409.5,432.5,358.5,389,27,29,13,18
2018_03_GB_WAS,WAS,GB,3,2018,220,166,265,100,386,365,397,394.5,338.5,426.5,23,21,10,28
2018_03_IND_PHI,PHI,IND,3,2018,255,152,164,68,407,232,335,338.5,487,397,9,10,31,23
2018_03_LAC_LA,LA,LAC,3,2018,354,171,226,141,525,367,408.5,456,182.5,255,26,30,1,2
2018_03_NE_DET,DET,NE,3,2018,262,159,133,89,421,222,392,357.5,373.5,396.5,19,12,15,22
2018_03_NO_ATL,ATL,NO,3,2018,374,48,396,143,422,539,383.5,393.5,382,356.5,17,20,16,11
2018_03_NYG_HOU,HOU,NYG,3,2018,385,59,297,114,444,411,400.5,326,313.5,281,24,6,5,3
2018_03_NYJ_CLE,CLE,NYJ,3,2018,220,133,169,107,353,276,356.5,371.5,393.5,326.5,11,14,20,7
2018_03_OAK_MIA,MIA,LV,3,2018,341,41,345,109,382,454,326.5,389,371.5,432.5,7,18,14,29
2018_03_PIT_TB,TB,PIT,3,2018,411,63,353,78,474,431,487,489.5,335,407.5,31,32,9,25
2018_03_SF_KC,KC,SF,3,2018,314,77,251,178,391,429,407.5,373.5,489.5,392,25,15,32,19
2018_03_TEN_JAX,JAX,TEN,3,2018,155,87,108,150,242,258,396.5,313.5,357.5,400.5,22,5,12,24
2018_04_BAL_PIT,PIT,BAL,4,2018,274,19,363,96,293,459,470,391,482.6666666666667,392.3333333333333,29,18,30,19
2018_04_BUF_GB,GB,BUF,4,2018,298,141,151,58,439,209,384.6666666666667,278,393.3333333333333,387.6666666666667,16,2,20,16
2018_04_CIN_ATL,ATL,CIN,4,2018,419,92,337,99,511,436,396.3333333333333,378.3333333333333,442,381.3333333333333,21,15,27,15
2018_04_CLE_OAK,LV,CLE,4,2018,437,139,295,208,576,503,410.6666666666667,355.3333333333333,345,339.6666666666667,24,13,11,9
2018_04_DET_DAL,DAL,DET,4,2018,255,183,307,96,438,403,298.6666666666667,401.6666666666667,322.3333333333333,312.3333333333333,4,22,8,6
2018_04_HOU_IND,IND,HOU,4,2018,464,41,375,119,505,494,303,415,359,354.3333333333333,5,25,14,12
2018_04_KC_DEN,DEN,KC,4,2018,245,159,304,142,404,446,392.3333333333333,402,391,392,20,23,17,18
2018_04_MIA_NE,NE,MIA,4,2018,274,175,135,56,449,191,312.3333333333333,345,401.6666666666667,410.6666666666667,6,11,22,24
2018_04_MIN_LA,LA,MIN,4,2018,465,100,422,54,565,476,447.3333333333333,387.6666666666667,426.3333333333333,278,28,17,26,2
2018_04_NO_NYG,NYG,NO,4,2018,255,65,227,170,320,397,354.3333333333333,442,415,396.3333333333333,12,27,25,21
2018_04_NYJ_JAX,JAX,NYJ,4,2018,388,126,167,34,514,201,345,339.6666666666667,295,355.3333333333333,11,9,3,13
2018_04_PHI_TEN,TEN,PHI,4,2018,344,70,348,117,414,465,295,359,345,303,3,14,11,5
2018_04_SEA_ARI,ARI,SEA,4,2018,180,92,172,171,272,343,203.66666666666666,322.3333333333333,312.6666666666667,298.6666666666667,1,8,7,4
2018_04_SF_LAC,LAC,SF,4,2018,250,126,298,76,376,374,426.3333333333333,392,447.3333333333333,402,26,19,28,23
2018_04_TB_CHI,CHI,TB,4,2018,354,139,271,60,493,331,312.6666666666667,482.6666666666667,203.66666666666666,470,7,30,1,29
2018_05_ARI_SF,SF,ARI,5,2018,349,147,170,56,496,226,387.5,220.75,413.75,327.5,14,1,24,6
2018_05_ATL_PIT,PIT,ATL,5,2018,250,131,305,62,381,367,425.75,425,408,392.75,26,25,21,17
2018_05_BAL_CLE,CLE,BAL,5,2018,342,112,298,116,454,414,392.25,408,452,425.75,15,21,29,26
2018_05_DAL_HOU,HOU,DAL,5,2018,375,88,208,98,463,306,434.75,333.5,353.5,402,28,7,10,20
2018_05_DEN_NYJ,NYJ,DEN,5,2018,198,323,377,92,521,469,305,395.25,387.25,413,3,18,14,23
2018_05_GB_DET,DET,GB,5,2018,183,94,442,98,277,540,402,398.25,333.5,260.75,20,19,7,2
2018_05_IND_NE,NE,IND,5,2018,341,97,365,84,438,449,346.5,353.5,306.5,434.75,9,10,4,28
2018_05_JAX_KC,KC,JAX,5,2018,313,126,430,101,439,531,413,387.25,395.25,305,23,13,18,3
2018_05_LA_SEA,SEA,LA,5,2018,198,190,321,155,388,476,327.5,476.75,220.75,409.75,6,30,1,22
2018_05_MIA_CIN,CIN,MIA,5,2018,248,103,185,128,351,313,392.75,306.5,425,346.5,16,4,25,9
2018_05_MIN_PHI,PHI,MIN,5,2018,311,81,301,77,392,378,385.5,409.75,324.75,476.75,12,22,5,30
2018_05_NYG_CAR,CAR,NYG,5,2018,237,118,383,50,355,433,381.3333333333333,345.75,378.3333333333333,430.75,11,8,11,27
2018_05_OAK_LAC,LAC,LV,5,2018,339,79,268,41,418,309,413.75,452,387.5,392.25,24,29,15,16
2018_05_TEN_BUF,BUF,TEN,5,2018,82,144,129,100,226,229,260.75,324.75,398.25,385.5,2,5,19,13
2018_05_WAS_NO,NO,WAS,5,2018,363,98,275,39,461,314,430.75,393.3333333333333,345.75,384.6666666666667,27,17,8,12
2018_06_ARI_MIN,MIN,ARI,6,2018,233,195,240,60,428,300,403.4,221.8,386.8,409.2,16,1,15,19
2018_06_BAL_TEN,TEN,BAL,6,2018,117,55,238,123,172,361,305.6,409.2,253.8,404.6,3,19,2,17
2018_06_BUF_HOU,HOU,BUF,6,2018,177,74,145,100,251,245,440.4,253.8,328,305.6,28,2,5,3
2018_06_CAR_WAS,WAS,CAR,6,2018,163,132,275,81,295,356,373.5,374.75,438.3125,367.5625,12,13,27,10
2018_06_CHI_MIA,MIA,CHI,6,2018,380,161,316,164,541,480,307.8,357.75,384.4,444.75,4,8,14,29
2018_06_IND_NYJ,NYJ,IND,6,2018,280,107,301,127,387,428,348.2,372.6,410,364.8,7,11,20,9
2018_06_JAX_DAL,DAL,JAX,6,2018,183,206,149,65,389,214,328,416,440.4,418.2,5,23,28,25
2018_06_KC_NE,NE,KC,6,2018,340,173,352,94,513,446,364.8,418.2,372.6,416,10,25,11,23
2018_06_LA_DEN,DEN,LA,6,2018,322,60,201,270,382,471,410,476.6,348.2,339.6,20,30,7,6
2018_06_LAC_CLE,CLE,LAC,6,2018,238,103,215,246,341,461,404.6,414.6,409.2,423.4,17,22,19,26
2018_06_PHI_NYG,NYG,PHI,6,2018,281,147,278,108,428,386,363.2,386.8,376.06666666666666,403.4,9,15,12,16
2018_06_PIT_CIN,CIN,PIT,6,2018,229,62,369,112,291,481,384.4,416.8,307.8,413.4,14,24,4,21
2018_06_SEA_OAK,LV,SEA,6,2018,142,79,222,155,221,377,423.4,339.6,414.6,476.6,26,6,22,30
2018_06_SF_GB,GB,SF,6,2018,425,116,245,174,541,419,426.6,409.2,377,221.8,27,19,13,1
2018_06_TB_ATL,ATL,TB,6,2018,355,70,395,121,425,516,413.4,444.75,416.8,357.75,21,29,24,8
2018_07_BUF_IND,IND,BUF,7,2018,156,220,175,135,376,310,381.8333333333333,252.33333333333334,354.6666666666667,408.8333333333333,12,2,6,20
2018_07_CAR_PHI,PHI,CAR,7,2018,310,58,269,121,368,390,386.6666666666667,371,374,357.8,15,9,9,7
2018_07_CIN_KC,KC,CIN,7,2018,358,198,187,65,556,252,422.8333333333333,368.8333333333333,389.5,427.5,25,8,15,25
2018_07_CLE_TB,TB,CLE,7,2018,365,114,215,119,479,334,459,394,415.71999999999997,422.3333333333333,27,17,21,22
2018_07_DAL_WAS,WAS,DAL,7,2018,178,130,273,73,308,346,357.8,338.1666666666667,371,382.3333333333333,7,4,8,13
2018_07_DEN_ARI,ARI,DEN,7,2018,194,69,189,131,263,320,234.83333333333334,405.3333333333333,407.5,475.6666666666667,1,19,19,28
2018_07_DET_MIA,MIA,DET,7,2018,239,107,217,248,346,465,346.6666666666667,377,378.125,426.6,5,11,11,24
2018_07_HOU_JAX,JAX,HOU,7,2018,217,70,139,141,287,280,382.3333333333333,408.8333333333333,338.1666666666667,252.33333333333334,14,21,4,2
2018_07_LA_SF,SF,LA,7,2018,170,107,202,146,277,348,410.8333333333333,475.6666666666667,445.6666666666667,405.3333333333333,22,28,26,18
2018_07_MIN_NYJ,NYJ,MIN,7,2018,206,71,241,88,277,329,354.6666666666667,407.5,381.8333333333333,234.83333333333334,6,20,12,1
2018_07_NE_CHI,CHI,NE,7,2018,333,134,277,108,467,385,382.2,389.5,354.44,422.8333333333333,13,16,5,23
2018_07_NO_BAL,BAL,NO,7,2018,284,77,212,134,361,346,401.1666666666667,436.8,283.3333333333333,377.46666666666664,18,26,3,10
2018_07_NYG_ATL,ATL,NYG,7,2018,379,67,399,61,446,460,415.3333333333333,374,456.625,386.6666666666667,23,10,27,14
2018_07_TEN_LAC,LAC,TEN,7,2018,306,47,237,164,353,401,422.3333333333333,283.3333333333333,394,401.1666666666667,24,3,16,17
2018_08_BAL_CAR,CAR,BAL,8,2018,232,154,238,101,386,339,374.1666666666667,395.42857142857144,383.5555555555556,423.8285714285715,9,20,12,25
2018_08_CLE_PIT,PIT,CLE,8,2018,257,168,180,74,425,254,427.5,385.42857142857144,368.8333333333333,461.85714285714283,24,12,9,28
2018_08_DEN_KC,KC,DEN,8,2018,303,49,262,189,352,451,441.85714285714283,393.14285714285717,352.14285714285717,238.85714285714286,25,19,7,1
2018_08_GB_LA,LA,GB,8,2018,307,135,286,106,442,392,457.42857142857144,445.6666666666667,391.7142857142857,410.8333333333333,27,26,18,23
2018_08_IND_OAK,LV,IND,8,2018,244,103,239,222,347,461,389.6666666666667,381,345.8333333333333,260.57142857142856,15,10,5,2
2018_08_MIA_HOU,HOU,MIA,8,2018,239,188,269,116,427,385,390.42857142857144,346.57142857142856,368.7142857142857,389.57142857142856,16,5,8,15
2018_08_NE_BUF,BUF,NE,8,2018,313,46,324,76,359,400,260.57142857142856,388.85714285714283,381,394.3142857142857,2,14,11,20
2018_08_NO_MIN,MIN,NO,8,2018,359,82,164,106,441,270,396.2857142857143,421.6666666666667,343.57142857142856,394.47222222222223,21,23,4,21
2018_08_NYJ_CHI,CHI,NYJ,8,2018,220,179,153,57,399,210,396.3333333333333,343.57142857142856,388.75,396.2857142857143,22,3,14,22
2018_08_PHI_JAX,JAX,PHI,8,2018,286,70,286,133,356,419,368.7142857142857,384,390.42857142857144,373.7142857142857,8,11,17,10
2018_08_SEA_DET,DET,SEA,8,2018,310,34,248,176,344,424,391.6666666666667,345.8333333333333,346.5555555555556,389.6666666666667,17,4,6,16
2018_08_SF_ARI,ARI,SF,8,2018,252,88,190,107,340,297,238.85714285714286,391.7142857142857,393.14285714285717,457.42857142857144,1,18,19,27
2018_08_TB_CIN,CIN,TB,8,2018,280,138,470,126,418,596,352.14285714285717,462.3333333333333,441.85714285714283,384,7,28,26,13
2018_08_WAS_NYG,NYG,WAS,8,2018,316,37,178,182,353,360,386.2857142857143,349.5,419.7142857142857,339.47222222222223,13,6,24,3
2018_09_ATL_WAS,WAS,ATL,9,2018,306,79,350,154,385,504,351,419.7142857142857,381.53061224489795,386.2857142857143,5,21,11,13
2018_09_CHI_BUF,BUF,CHI,9,2018,188,98,135,64,286,199,272.875,396.7142857142857,390.25,324.48979591836735,1,16,15,4
2018_09_DET_MIN,MIN,DET,9,2018,164,128,199,66,292,265,401.875,384.85714285714283,402.70833333333337,357,19,12,21,7
2018_09_GB_NE,NE,GB,9,2018,331,123,259,117,454,376,390.25,438,272.875,455.2244897959184,14,24,2,26
2018_09_HOU_DEN,DEN,HOU,9,2018,290,75,213,98,365,311,400.375,395,430.625,351.375,18,15,24,6
2018_09_KC_CLE,CLE,KC,9,2018,308,102,375,139,410,514,369,430.625,427.1875,400.375,8,23,23,19
2018_09_LA_NO,NO,LA,9,2018,346,141,391,92,487,483,400,455.5,402.6734693877551,438.95833333333337,17,25,20,25
2018_09_LAC_SEA,SEA,LAC,9,2018,235,154,228,160,389,388,357,412.42857142857144,384.85714285714283,300.14285714285717,7,20,12,3
2018_09_NYJ_MIA,MIA,NYJ,9,2018,139,64,229,80,203,309,351.375,326.875,395,396.66666666666663,6,3,17,18
2018_09_OAK_SF,SF,LV,9,2018,262,143,179,102,405,281,379.875,383.57142857142856,251.5,392.42857142857144,10,11,1,16
2018_09_PIT_BAL,BAL,PIT,9,2018,218,61,292,113,279,405,388.375,427.14285714285717,375.64583333333337,366.65306122448976,13,22,10,9
2018_09_TB_CAR,CAR,TB,9,2018,247,179,243,82,426,325,375.85714285714283,481.42857142857144,387.3673469387755,361.5510204081633,9,26,14,8
2018_09_TEN_DAL,DAL,TEN,9,2018,243,72,240,125,315,365,339.2857142857143,300.14285714285717,350.6857142857143,412.42857142857144,4,2,5,22
2018_10_ARI_KC,KC,ARI,10,2018,249,118,208,94,367,302,439.8888888888889,251.5,373.55555555555554,379.875,26,1,11,14
2018_10_ATL_CLE,CLE,ATL,10,2018,216,211,330,71,427,401,373.55555555555554,430.25,439.8888888888889,355.25,14,25,25,7
2018_10_BUF_NYJ,NYJ,BUF,10,2018,135,83,247,212,218,459,324.8888888888889,274.3333333333333,334.8888888888889,374.74603174603175,4,2,4,13
2018_10_CAR_PIT,PIT,CAR,10,2018,325,138,193,95,463,288,424.375,382.125,374.703125,461.875,23,16,12,27
2018_10_DAL_PHI,PHI,DAL,10,2018,360,71,270,171,431,441,388.375,336.25,367.125,308.25,18,6,9,2
2018_10_DET_CHI,CHI,DET,10,2018,355,54,274,76,409,350,372,369.875,274.515625,388.140625,13,11,1,18
2018_10_JAX_IND,IND,JAX,10,2018,285,81,324,91,366,415,391,367.125,384.33333333333337,388.375,19,10,17,19
2018_10_LAC_OAK,LV,LAC,10,2018,243,114,223,113,357,336,370.75,409.375,383.015625,361,12,21,16,8
2018_10_MIA_GB,GB,MIA,10,2018,199,195,213,131,394,344,430.25,334.8888888888889,398.21875,324.8888888888889,25,5,20,3
2018_10_NE_TEN,TEN,NE,10,2018,249,150,267,40,399,307,308.25,397.3333333333333,336.25,431.1111111111111,3,20,5,24
2018_10_NO_CIN,CIN,NO,10,2018,198,110,265,244,308,509,360.375,410.875,479.04166666666663,458.9375,8,22,28,26
2018_10_NYG_SF,SF,NYG,10,2018,250,124,188,97,374,285,382.6666666666667,382.125,372.17460317460313,350.8125,17,16,10,6
2018_10_SEA_LA,LA,SEA,10,2018,318,149,176,273,467,449,458.55555555555554,361,409.6666666666667,409.375,27,9,22,21
2018_10_WAS_TB,TB,WAS,10,2018,406,103,178,116,509,294,461.875,355.25,382.125,430.25,28,7,15,23
2018_11_CAR_DET,DET,CAR,11,2018,220,94,357,56,314,413,367.6666666666667,371.6666666666667,376.1111111111111,428.6666666666667,6,10,12,23
2018_11_CIN_BAL,BAL,CIN,11,2018,150,262,211,48,412,259,376.22222222222223,354.55555555555554,424.6825396825397,421.77777777777777,13,5,22,21
2018_11_DAL_ATL,ATL,DAL,11,2018,291,80,208,132,371,340,427,347.8888888888889,379.4938271604938,393.1111111111111,22,3,13,18
2018_11_DEN_LAC,LAC,DEN,11,2018,401,95,217,108,496,325,401.22222222222223,396.44444444444446,369.22222222222223,385.6666666666667,19,18,7,15
2018_11_GB_SEA,SEA,GB,11,2018,225,173,332,48,398,380,370.77777777777777,426.22222222222223,459.4938271604938,335.90123456790127,8,21,25,2
2018_11_HOU_WAS,WAS,HOU,11,2018,189,124,208,139,313,347,348.44444444444446,385.6666666666667,467.1111111111111,396.44444444444446,4,14,26,19
2018_11_KC_LA,LA,KC,11,2018,413,76,478,98,489,576,459.4,432.6,369.8,256.55,25,24,8,1
2018_11_MIN_CHI,CHI,MIN,11,2018,165,148,262,22,313,284,376.1111111111111,389.6666666666667,367.6666666666667,371.53968253968253,12,16,6,9
2018_11_OAK_ARI,ARI,LV,11,2018,136,154,192,152,290,344,257.1111111111111,369.22222222222223,431.7901234567901,401.22222222222223,1,7,24,20
2018_11_PHI_NO,NO,PHI,11,2018,373,173,156,58,546,214,421.77777777777777,393.1111111111111,354.55555555555554,347.8888888888889,20,17,5,3
2018_11_PIT_JAX,JAX,PIT,11,2018,104,179,314,26,283,340,372.44444444444446,428.6666666666667,388.22222222222223,371.6666666666667,11,23,17,10
2018_11_TB_NYG,NYG,TB,11,2018,231,163,366,151,394,517,371.3333333333333,467.1111111111111,381.7037037037037,348.44444444444446,9,26,14,4
2018_11_TEN_IND,IND,TEN,11,2018,295,102,203,87,397,290,388.22222222222223,318.3333333333333,372.44444444444446,387.2962962962963,15,2,11,16
2018_12_ARI_LAC,LAC,ARI,12,2018,259,178,105,62,437,167,410.7,260.4,389.3,366.7,25,1,22,11
2018_12_ATL_NO,NO,ATL,12,2018,171,150,377,26,321,403,434.2,421.4,375.2,347.1,29,27,16,8
2018_12_CHI_DET,DET,CHI,12,2018,236,111,238,38,347,276,362.3,369.8,375.8,379.1,9,12,17,18
2018_12_CLE_CIN,CIN,CLE,12,2018,255,129,258,84,384,342,345,378.9,379.8,427.325,7,17,19,28
2018_12_GB_MIN,MIN,GB,12,2018,342,91,198,82,433,280,379.1,421.6,369.8,373.5,18,28,12,14
2018_12_JAX_BUF,BUF,JAX,12,2018,160,167,127,226,327,353,292.8,363.5,314.2,419.8,2,10,3,24
2018_12_MIA_IND,IND,MIA,12,2018,347,118,204,113,465,317,389.1,335.8,315.5,426.625,23,5,4,27
2018_12_NE_NYJ,NYJ,NE,12,2018,276,74,283,215,350,498,314.2,388.3,292.8,317.325,3,22,2,5
2018_12_NYG_PHI,PHI,NYG,12,2018,236,127,297,126,363,423,375.2,373.6,434.2,472.1,15,14,29,30
2018_12_OAK_BAL,BAL,LV,12,2018,178,242,194,67,420,261,379.8,366.7,345,260.4,19,11,7,1
2018_12_PIT_DEN,DEN,PIT,12,2018,197,124,464,75,321,539,389.3,419.8,410.7,363.5,24,26,23,10
2018_12_SEA_CAR,CAR,SEA,12,2018,256,220,339,75,476,414,375.8,373.5,362.3,421.6,16,13,9,26
2018_12_SF_TB,TB,SF,12,2018,312,108,221,148,420,369,472.1,381.8,373.6,372.4125,30,21,15,13
2018_12_TEN_HOU,HOU,TEN,12,2018,210,281,303,105,491,408,381.8,315.5,344.9,389.1,21,4,6,21
2018_12_WAS_DAL,DAL,WAS,12,2018,289,146,268,80,435,348,347.1,344.9,421.4,381.8,8,6,25,20
2018_13_ARI_GB,GB,ARI,13,2018,233,98,149,182,331,331,408.72727272727275,251.9090909090909,384,413.09090909090907,25,1,20,26
2018_13_BAL_ATL,ATL,BAL,13,2018,131,34,167,207,165,374,419.72727272727275,383.45454545454544,423.90909090909093,357.09090909090907,27,19,28,9
2018_13_BUF_MIA,MIA,BUF,13,2018,137,60,231,198,197,429,334.09090909090907,295.90909090909093,396,362.54545454545456,5,2,23,12
2018_13_CAR_TB,TB,CAR,13,2018,249,95,300,168,344,468,467.3636363636364,384.90909090909093,380.6363636363636,377.1818181818182,32,21,17,15
2018_13_CHI_NYG,NYG,CHI,13,2018,219,141,286,118,360,404,378.09090909090907,361.27272727272725,374.09090909090907,360.90909090909093,16,11,13,10
2018_13_CLE_HOU,HOU,CLE,13,2018,224,187,397,31,411,428,391.72727272727275,375.54545454545456,323.90909090909093,348.54545454545456,22,14,4,7
2018_13_DEN_CIN,CIN,DEN,13,2018,236,111,151,218,347,369,348.54545454545456,383.09090909090907,375.54545454545456,430.6363636363636,7,18,14,29
2018_13_IND_JAX,JAX,IND,13,2018,150,79,248,41,229,289,362.54545454545456,396,295.90909090909093,334.09090909090907,12,23,2,5
2018_13_KC_OAK,LV,KC,13,2018,285,171,295,174,456,469,357.09090909090907,445.6363636363636,383.45454545454544,462.09090909090907,9,30,19,31
2018_13_LA_DET,DET,LA,13,2018,245,102,207,149,347,356,360.90909090909093,462.09090909090907,361.27272727272725,445.6363636363636,10,31,11,30
2018_13_LAC_PIT,PIT,LAC,13,2018,281,65,299,85,346,384,430.6363636363636,413.09090909090907,383.09090909090907,251.9090909090909,29,26,18,1
2018_13_MIN_NE,NE,MIN,13,2018,311,160,201,95,471,296,398.27272727272725,384,317.45454545454544,408.72727272727275,24,20,3,25
2018_13_NO_DAL,DAL,NO,13,2018,249,99,127,65,348,192,355.09090909090907,423.90909090909093,345.1818181818182,419.72727272727275,8,28,6,27
2018_13_NYJ_TEN,TEN,NYJ,13,2018,282,130,128,156,412,284,323.90909090909093,317.45454545454544,391.72727272727275,398.27272727272725,4,3,22,24
2018_13_SF_SEA,SEA,SF,13,2018,185,168,414,66,353,480,377.1818181818182,380.6363636363636,384.90909090909093,467.3636363636364,15,17,21,32
2018_13_WAS_PHI,PHI,WAS,13,2018,306,130,150,104,436,254,374.09090909090907,345.1818181818182,378.09090909090907,355.09090909090907,13,6,16,8
2018_14_ATL_GB,GB,ATL,14,2018,196,138,262,107,334,369,402.25,398.5,258.5,382.6666666666667,25,24,1,19
2018_14_BAL_KC,KC,BAL,14,2018,377,94,147,194,471,341,447.5833333333333,382.6666666666667,365.3333333333333,398.5,30,19,12,24
2018_14_CAR_CLE,CLE,CAR,14,2018,238,116,298,96,354,394,379.9166666666667,391.8333333333333,393.3333333333333,457.0833333333333,17,22,23,32
2018_14_CIN_LAC,LAC,CIN,14,2018,220,85,170,144,305,314,410.6666666666667,348.4166666666667,423.5833333333333,381.9166666666667,28,7,29,18
2018_14_DEN_SF,SF,DEN,14,2018,332,84,186,103,416,289,388.9166666666667,381.9166666666667,375.1666666666667,348.4166666666667,21,18,13,7
2018_14_DET_ARI,ARI,DET,14,2018,240,61,101,122,301,223,258.5,359.75,402.25,453.25,1,10,25,31
2018_14_IND_HOU,HOU,IND,14,2018,267,89,399,50,356,449,393.3333333333333,387.0833333333333,379.9166666666667,351.4166666666667,23,20,17,8
2018_14_JAX_TEN,TEN,JAX,14,2018,162,264,240,60,426,300,331.25000000000006,351.4166666666667,314.6666666666667,387.0833333333333,5,8,3,20
2018_14_LA_CHI,CHI,LA,14,2018,110,194,187,52,304,239,364.8333333333333,453.25,376.5833333333333,359.75,11,31,14,10
2018_14_MIN_SEA,SEA,MIN,14,2018,72,214,208,77,286,285,375.1666666666667,376.6666666666667,388.9166666666667,404.3333333333333,13,15,21,26
2018_14_NE_MIA,MIA,NE,14,2018,265,189,358,77,454,435,322.66666666666663,404.3333333333333,307.00000000000006,376.6666666666667,4,26,2,15
2018_14_NO_TB,TB,NO,14,2018,213,105,201,100,318,301,457.0833333333333,404.5833333333333,391.8333333333333,354.5,32,27,22,9
2018_14_NYG_WAS,WAS,NYG,14,2018,233,84,197,227,317,424,337.5833333333333,376.5833333333333,379.25,364.8333333333333,6,14,16,11
2018_14_NYJ_BUF,BUF,NYJ,14,2018,206,176,170,78,382,248,307.00000000000006,314.6666666666667,322.66666666666663,331.25000000000006,2,3,4,5
2018_14_PHI_DAL,DAL,PHI,14,2018,455,142,228,34,597,262,354.5,379.25,404.5833333333333,337.5833333333333,9,16,27,6
2018_14_PIT_OAK,LV,PIT,14,2018,322,55,306,40,377,346,365.3333333333333,423.5833333333333,447.5833333333333,410.6666666666667,12,29,30,28
2018_15_ARI_ATL,ATL,ARI,15,2018,231,215,243,60,446,303,396.2307692307692,261.7692307692308,397,349.2307692307692,24,1,26,9
2018_15_CLE_DEN,DEN,CLE,15,2018,257,32,188,134,289,322,374.7692307692308,377.9230769230769,391,392,16,17,21,23
2018_15_DAL_IND,IND,DAL,15,2018,192,178,206,112,370,318,391.84615384615387,373.15384615384613,390.46153846153845,370.2307692307692,22,15,20,14
2018_15_DET_BUF,BUF,DET,15,2018,204,117,208,105,321,313,312.76923076923083,349.2307692307692,309.53846153846155,261.7692307692308,3,9,2,1
2018_15_GB_CHI,CHI,GB,15,2018,235,100,274,88,335,362,360.15384615384613,397,436.7692307692308,396.2307692307692,10,26,30,24
2018_15_HOU_NYJ,NYJ,HOU,15,2018,253,90,294,47,343,341,309.53846153846155,390.46153846153845,312.76923076923083,391.84615384615387,2,20,3,22
2018_15_LAC_KC,KC,LAC,15,2018,243,60,313,119,303,432,449.38461538461536,402.53846153846155,379.46153846153845,345.7692307692308,32,27,18,7
2018_15_MIA_MIN,MIN,MIA,15,2018,215,220,108,156,435,264,369.61538461538464,332.7692307692308,368.3076923076923,406.6923076923077,13,4,12,28
2018_15_NE_PIT,PIT,NE,15,2018,235,158,279,96,393,375,417.61538461538464,406.6923076923077,366.2307692307692,332.7692307692308,29,28,11,4
2018_15_NO_CAR,CAR,NO,15,2018,181,98,203,155,279,358,392,396.61538461538464,377.9230769230769,446.38461538461536,23,25,17,31
2018_15_OAK_CIN,CIN,LV,15,2018,130,171,263,68,301,331,345.7692307692308,366.2307692307692,402.53846153846155,417.61538461538464,7,11,27,29
2018_15_PHI_LA,LA,PHI,15,2018,339,82,270,111,421,381,436.7692307692308,370.2307692307692,360.15384615384613,373.15384615384613,30,14,10,15
2018_15_SEA_SF,SF,SEA,15,2018,275,94,237,161,369,398,391,368.3076923076923,374.7692307692308,369.61538461538464,21,12,16,13
2018_15_TB_BAL,BAL,TB,15,2018,131,242,157,85,373,242,379.46153846153845,446.38461538461536,449.38461538461536,396.61538461538464,18,31,32,25
2018_15_TEN_NYG,NYG,TEN,15,2018,229,47,94,215,276,309,380.2307692307692,338.5384615384616,336,347.46153846153845,19,6,5,8
2018_15_WAS_JAX,JAX,WAS,15,2018,57,172,151,109,229,260,347.46153846153845,336,338.5384615384616,380.2307692307692,8,5,6,19
2018_16_ATL_CAR,CAR,ATL,16,2018,312,141,239,194,453,433,383.92857142857144,399.7857142857143,393.85714285714283,264.7142857142857,20,26,24,1
2018_16_BAL_LAC,LAC,BAL,16,2018,181,51,204,159,232,363,404.64285714285717,379,438.92857142857144,431.7857142857143,28,19,32,30
2018_16_BUF_NE,NE,BUF,16,2018,126,273,217,72,399,289,404.42857142857144,313.35714285714295,415.85714285714283,346.64285714285717,27,3,29,9
2018_16_CHI_SF,SF,CHI,16,2018,241,47,246,90,288,336,389.42857142857144,358.35714285714283,370.42857142857144,394.5,22,10,14,25
2018_16_CIN_CLE,CLE,CIN,16,2018,347,146,133,102,493,235,373.92857142857144,342.57142857142856,368.64285714285717,363.7142857142857,17,8,12,11
2018_16_DEN_OAK,LV,DEN,16,2018,167,114,202,100,281,302,363.7142857142857,368.64285714285717,342.57142857142856,373.92857142857144,11,12,8,17
2018_16_GB_NYJ,NYJ,GB,16,2018,341,47,442,127,388,569,311.92857142857144,394.5,386.92857142857144,358.35714285714283,2,25,21,10
2018_16_HOU_PHI,PHI,HOU,16,2018,471,57,339,62,528,401,371,386.92857142857144,435.64285714285717,311.92857142857144,15,21,31,2
2018_16_JAX_MIA,MIA,JAX,16,2018,146,62,145,126,208,271,327.85714285714283,339,374.2857142857143,330.57142857142856,4,7,18,5
2018_16_KC_SEA,SEA,KC,16,2018,271,210,273,154,481,427,370.42857142857144,438.92857142857144,389.42857142857144,404.64285714285717,14,32,22,28
2018_16_LA_ARI,ARI,LA,16,2018,182,104,216,269,286,485,264.7142857142857,435.64285714285717,399.7857142857143,371,1,31,26,15
2018_16_MIN_DET,DET,MIN,16,2018,161,86,253,100,247,353,346.64285714285717,374.2857142857143,313.35714285714295,327.85714285714283,9,18,3,4
2018_16_NYG_IND,IND,NYG,16,2018,357,49,309,83,406,392,390.2857142857143,372.7857142857143,369.2142857142857,336.4285714285715,23,16,13,6
2018_16_PIT_NO,NO,PIT,16,2018,326,57,380,65,383,445,393.85714285714283,415.85714285714283,383.92857142857144,404.42857142857144,24,29,20,27
2018_16_TB_DAL,DAL,TB,16,2018,161,80,336,63,241,399,369.2142857142857,431.7857142857143,390.2857142857143,379,13,30,23,19
2018_16_WAS_TEN,TEN,WAS,16,2018,211,99,153,161,310,314,336.4285714285715,330.57142857142856,372.7857142857143,339,6,5,16,7
2018_17_ARI_SEA,SEA,ARI,17,2018,152,182,149,85,334,234,377.8,266.1333333333333,438.1333333333333,438.93333333333334,16,1,31,32
2018_17_ATL_TB,TB,ATL,17,2018,345,92,383,109,437,492,429.6,402,360.6666666666667,388.53333333333336,30,26,12,22
2018_17_CAR_NO,NO,CAR,17,2018,118,184,268,111,302,379,393.1333333333333,388.53333333333336,417.8,402,25,22,29,26
2018_17_CHI_MIN,MIN,CHI,17,2018,132,63,163,169,195,332,372.8666666666667,356.8666666666667,340,382.6666666666667,14,10,9,20
2018_17_CIN_PIT,PIT,CIN,17,2018,287,65,95,125,352,220,417.8,335.4,393.1333333333333,381.8666666666667,29,8,25,19
2018_17_CLE_BAL,BAL,CLE,17,2018,179,296,376,50,475,426,377.93333333333334,381.8666666666667,393.1333333333333,335.4,17,19,25,8
2018_17_DAL_NYG,NYG,DAL,17,2018,301,143,387,51,444,438,374.06666666666666,360.6666666666667,391.3333333333333,429.6,15,12,23,30
2018_17_DET_GB,GB,DET,17,2018,158,46,274,130,204,404,406.1333333333333,340,317,372.8666666666667,28,9,3,14
2018_17_IND_TEN,TEN,IND,17,2018,165,93,285,158,258,443,334.66666666666674,391.3333333333333,329.46666666666664,374.06666666666666,7,23,5,15
2018_17_JAX_HOU,HOU,JAX,17,2018,234,134,107,30,368,137,387.8666666666667,334.46666666666664,381.46666666666664,319.8666666666667,21,6,18,4
2018_17_LAC_DEN,DEN,LAC,17,2018,292,82,176,116,374,292,364.2,393.1333333333333,358.2,377.93333333333334,13,25,11,17
2018_17_MIA_BUF,BUF,MIA,17,2018,224,166,150,99,390,249,311.7333333333334,319.8666666666667,404.06666666666666,334.46666666666664,2,4,27,6
2018_17_NYJ_NE,NE,NYJ,17,2018,250,131,167,104,381,271,404.06666666666666,317,311.7333333333334,406.1333333333333,27,3,2,28
2018_17_OAK_KC,KC,LV,17,2018,310,99,185,127,409,312,438.1333333333333,358.2,377.8,364.2,31,11,16,13
2018_17_PHI_WAS,WAS,PHI,17,2018,98,21,243,129,119,372,329.46666666666664,381.46666666666664,334.66666666666674,387.8666666666667,5,18,7,21
2018_17_SF_LA,LA,SF,17,2018,222,155,282,127,377,409,438.93333333333334,382.6666666666667,266.1333333333333,356.8666666666667,32,20,1,10
2018_18_IND_HOU,HOU,IND,18,2018,235,105,222,200,340,422,386.625,394.5625,322.125,329.87500000000006,6,8,3,4
2018_18_LAC_BAL,BAL,LAC,18,2018,194,90,160,89,284,249,384,386.8125,384.625,364.8125,5,7,8,6
2018_18_PHI_CHI,CHI,PHI,18,2018,303,65,266,42,368,308,355.3125,380.875,361.75,316.3125,1,4,5,2
2018_18_SEA_DAL,DAL,SEA,18,2018,226,164,233,73,390,306,365.5,375.0625,378.4375,264.125,2,3,7,1
2018_19_DAL_LA,LA,DAL,19,2018,186,273,266,50,459,316,435.0625,366.94117647058823,384.3125,371,7,1,7,4
2018_19_IND_KC,KC,IND,19,2018,278,180,203,87,458,290,436.3125,396.1764705882353,355.3125,383.88235294117646,8,5,2,6
2018_19_LAC_NE,NE,LAC,19,2018,343,155,331,19,498,350,402.625,378.70588235294116,314.125,378.11764705882354,6,3,1,5
2018_19_PHI_NO,NO,PHI,19,2018,301,137,201,49,438,250,387.4375,376.5882352941176,387.9375,356.05882352941177,4,2,8,3
2018_20_LA_NO,NO,LA,20,2018,249,48,309,77,297,386,390.4117647058824,436.47058823529414,369.1418685121107,363.9446366782007,1,3,2,1
2018_20_NE_KC,KC,NE,20,2018,295,41,348,176,336,524,437.5882352941176,408.2352941176471,389.93079584775086,377.01730103806227,4,2,4,3
2018_21_NE_LA,LA,NE,21,2018,229,62,262,154,291,416,433.6666666666667,414.6666666666667,385.22222222222223,431.94444444444446,2,1,1,2
2019_01_ATL_MIN,MIN,ATL,1,2019,98,172,304,73,270,377,0,0,0,0,32,32,32,32
2019_01_BAL_MIA,MIA,BAL,1,2019,190,21,379,265,211,644,0,0,0,0,32,32,32,32
2019_01_BUF_NYJ,NYJ,BUF,1,2019,175,68,254,128,243,382,0,0,0,0,32,32,32,32
2019_01_CIN_SEA,SEA,CIN,1,2019,195,72,418,34,267,452,0,0,0,0,32,32,32,32
2019_01_DEN_OAK,LV,DEN,1,2019,259,98,268,95,357,363,0,0,0,0,32,32,32,32
2019_01_DET_ARI,ARI,DET,1,2019,308,112,385,116,420,501,0,0,0,0,32,32,32,32
2019_01_GB_CHI,CHI,GB,1,2019,228,46,203,47,274,250,0,0,0,0,32,32,32,32
2019_01_HOU_NO,NO,HOU,1,2019,370,148,268,180,518,448,0,0,0,0,32,32,32,32
2019_01_IND_LAC,LAC,IND,1,2019,333,125,190,203,458,393,0,0,0,0,32,32,32,32
2019_01_KC_JAX,JAX,KC,1,2019,350,81,378,113,431,491,0,0,0,0,32,32,32,32
2019_01_LA_CAR,CAR,LA,1,2019,239,127,186,166,366,352,0,0,0,0,32,32,32,32
2019_01_NYG_DAL,DAL,NYG,1,2019,405,89,323,151,494,474,0,0,0,0,32,32,32,32
2019_01_PIT_NE,NE,PIT,1,2019,373,99,276,32,472,308,0,0,0,0,32,32,32,32
2019_01_SF_TB,TB,SF,1,2019,194,121,166,98,315,264,0,0,0,0,32,32,32,32
2019_01_TEN_CLE,CLE,TEN,1,2019,285,102,248,123,387,371,0,0,0,0,32,32,32,32
2019_01_WAS_PHI,PHI,WAS,1,2019,313,123,380,28,436,408,0,0,0,0,32,32,32,32
2019_02_ARI_BAL,BAL,ARI,2,2019,272,182,349,20,454,369,644,420,211,501,32,20,1,30
2019_02_BUF_NYG,NYG,BUF,2,2019,250,129,253,151,379,404,474,382,494,243,27,16,29,2
2019_02_CHI_DEN,DEN,CHI,2,2019,292,90,120,153,382,273,363,274,357,250,12,7,11,3
2019_02_CLE_NYJ,NYJ,CLE,2,2019,201,93,325,70,294,395,243,387,382,371,2,17,16,14
2019_02_DAL_WAS,WAS,DAL,2,2019,221,47,269,213,268,482,408,494,436,474,19,29,22,27
2019_02_IND_TEN,TEN,IND,2,2019,154,124,146,167,278,313,371,393,387,458,14,18,17,25
2019_02_JAX_HOU,HOU,JAX,2,2019,159,126,213,103,285,316,448,431,518,491,23,21,31,28
2019_02_KC_OAK,LV,KC,2,2019,198,129,443,31,327,474,357,491,363,431,11,28,12,21
2019_02_LAC_DET,DET,LAC,2,2019,245,94,293,137,339,430,501,458,420,393,30,25,20,18
2019_02_MIN_GB,GB,MIN,2,2019,209,144,230,198,353,428,250,270,274,377,3,6,7,15
2019_02_NE_MIA,MIA,NE,2,2019,186,42,264,124,228,388,211,472,644,308,1,26,32,8
2019_02_NO_LA,LA,NO,2,2019,283,115,203,57,398,260,352,518,366,448,10,31,13,23
2019_02_PHI_ATL,ATL,PHI,2,2019,320,57,255,49,377,304,377,436,270,408,15,22,6,19
2019_02_SEA_PIT,PIT,SEA,2,2019,187,81,300,151,268,451,308,267,472,452,8,5,26,24
2019_02_SF_CIN,CIN,SF,2,2019,311,25,312,259,336,571,452,264,267,315,24,4,5,9
2019_02_TB_CAR,CAR,TB,2,2019,333,39,208,100,372,308,366,315,352,264,13,9,10,4
2019_03_ATL_IND,IND,ATL,3,2019,310,79,304,93,389,397,353,377,324.5,370,11,19,7,15
2019_03_BAL_KC,KC,BAL,3,2019,374,140,267,203,514,470,482.5,549,342,394.5,30,32,9,24
2019_03_CAR_ARI,ARI,CAR,3,2019,173,121,261,173,294,434,394.5,369,549,311.5,24,14,32,6
2019_03_CHI_WAS,WAS,CHI,3,2019,332,69,231,90,401,321,338,273.5,488,372.5,8,3,31,16
2019_03_CIN_BUF,BUF,CIN,3,2019,243,175,250,66,418,316,393,394,426.5,417.5,22,23,27,25
2019_03_DEN_GB,GB,DEN,3,2019,235,77,213,149,312,362,301.5,372.5,349,273.5,5,16,10,3
2019_03_DET_PHI,PHI,DET,3,2019,259,127,201,86,386,287,370,420,377,444,15,26,19,29
2019_03_HOU_LAC,LAC,HOU,3,2019,318,73,351,39,391,390,444,366.5,420,373.5,29,13,26,17
2019_03_LA_CLE,CLE,LA,3,2019,195,95,268,90,290,358,391,375,268.5,389,21,18,2,20
2019_03_MIA_DAL,DAL,MIA,3,2019,246,235,229,72,481,301,488,219.5,338,430,31,1,8,28
2019_03_NO_SEA,SEA,NO,3,2019,406,108,177,88,514,265,359,389,288,375,12,20,4,18
2019_03_NYG_TB,TB,NYG,3,2019,380,144,336,72,524,408,311.5,426.5,369,393,6,27,14,22
2019_03_NYJ_NE,NE,NYJ,3,2019,320,68,98,36,388,134,430,268.5,219.5,391,28,2,1,21
2019_03_OAK_MIN,MIN,LV,3,2019,174,211,242,88,385,330,349,342,301.5,482.5,10,9,5,30
2019_03_PIT_SF,SF,PIT,3,2019,277,168,174,79,445,253,417.5,288,394,359,25,4,23,12
2019_03_TEN_JAX,JAX,TEN,3,2019,204,88,304,91,292,395,373.5,324.5,366.5,353,17,7,13,11
2019_04_CAR_HOU,HOU,CAR,4,2019,160,136,232,94,296,326,374.3333333333333,390.6666666666667,426.3333333333333,361,17,22,26,12
2019_04_CIN_PIT,PIT,CIN,4,2019,260,66,171,73,326,244,276.3333333333333,368,426.6666666666667,401.3333333333333,2,14,27,23
2019_04_CLE_BAL,BAL,CLE,4,2019,247,173,342,193,420,535,522.6666666666666,357.3333333333333,493,369.3333333333333,30,9,29,16
2019_04_DAL_NO,NO,DAL,4,2019,193,117,223,45,310,268,347.6666666666667,485.6666666666667,410.6666666666667,246.66666666666666,7,28,24,2
2019_04_JAX_DEN,DEN,JAX,4,2019,303,68,213,269,371,482,369,346.3333333333333,305,348,15,6,4,8
2019_04_KC_DET,DET,KC,4,2019,291,186,315,123,477,438,375.6666666666667,493,375.3333333333333,522.6666666666666,19,29,18,30
2019_04_LAC_MIA,MIA,LAC,4,2019,180,72,317,79,252,396,246.66666666666666,426.3333333333333,485.6666666666667,374.3333333333333,1,27,28,17
2019_04_MIN_CHI,CHI,MIN,4,2019,204,72,233,40,276,273,289.3333333333333,361,359,338,3,12,10,5
2019_04_NE_BUF,BUF,NE,4,2019,280,135,150,74,415,224,401.3333333333333,416,368,223.66666666666666,23,25,14,1
2019_04_OAK_IND,IND,LV,4,2019,265,81,189,188,346,377,365,338,383.6666666666667,361,13,5,21,12
2019_04_PHI_GB,GB,PHI,4,2019,422,77,160,176,499,336,305,375.3333333333333,369,375.6666666666667,4,18,15,19
2019_04_SEA_ARI,ARI,SEA,4,2019,241,115,240,115,356,355,361,410.6666666666667,390.6666666666667,347.6666666666667,12,24,22,7
2019_04_TB_LA,LA,TB,4,2019,517,28,385,88,545,473,369.3333333333333,382.3333333333333,357.3333333333333,420.3333333333333,16,20,9,25
2019_04_TEN_ATL,ATL,TEN,4,2019,397,58,227,138,455,365,383.6666666666667,348,365,346.3333333333333,21,8,13,6
2019_04_WAS_NYG,NYG,WAS,4,2019,225,164,144,55,389,199,420.3333333333333,359,382.3333333333333,289.3333333333333,26,10,20,3
2019_05_ARI_CIN,CIN,ARI,5,2019,262,108,253,266,370,519,337,359.75,288.75,396.75,5,12,4,20
2019_05_ATL_HOU,HOU,ATL,5,2019,426,166,330,57,592,387,354.75,401.5,374.5,352.25,11,20,18,10
2019_05_BAL_PIT,PIT,BAL,5,2019,203,77,161,138,280,299,288.75,497,337,401.75,3,30,6,23
2019_05_BUF_TEN,TEN,BUF,5,2019,183,102,219,109,285,328,352.25,404.75,401.5,368,9,22,22,16
2019_05_CHI_OAK,LV,CHI,5,2019,229,169,231,42,398,273,347.75,286,360.25,339,8,2,14,8
2019_05_CLE_SF,SF,CLE,5,2019,181,275,120,102,456,222,426.6666666666667,401.75,276.3333333333333,497,27,21,2,30
2019_05_DEN_LAC,LAC,DEN,5,2019,211,35,182,191,246,373,418.75,369.5,248,380.25,26,16,1,19
2019_05_GB_DAL,DAL,GB,5,2019,463,122,238,120,585,358,431.25,353.5,338.25,365.5,28,10,7,15
2019_05_IND_KC,KC,IND,5,2019,321,36,151,180,357,331,479.25,360.25,401,347.75,29,13,21,9
2019_05_JAX_CAR,CAR,JAX,5,2019,181,285,374,149,466,523,374.5,380.25,354.75,369.5,17,18,12,17
2019_05_LA_SEA,SEA,LA,5,2019,268,167,395,82,435,477,396.75,413.25,359.75,405,19,25,13,25
2019_05_MIN_NYG,NYG,MIN,5,2019,182,64,306,211,246,517,412.5,339,319,286,24,7,5,3
2019_05_NE_WAS,WAS,NE,5,2019,122,145,348,130,267,478,319,368,412.5,404.75,4,15,26,24
2019_05_NYJ_PHI,PHI,NYJ,5,2019,189,84,120,67,273,187,365.5,223.66666666666666,353.5,416,14,1,11,28
2019_05_TB_NO,NO,TB,5,2019,345,112,204,94,457,298,338.25,405,431.25,413.25,6,23,29,27
2019_06_ATL_ARI,ARI,ATL,6,2019,340,102,356,103,442,459,391.6,398.6,343.6,402.2,17,19,5,20
2019_06_CAR_TB,TB,CAR,6,2019,400,42,227,59,442,286,383.6,392.8,362,408.8,14,18,9,22
2019_06_CIN_BAL,BAL,CIN,6,2019,236,269,235,33,505,268,457.4,343.6,287,391.6,27,6,2,17
2019_06_DAL_NYJ,NYJ,DAL,6,2019,338,56,278,129,394,407,214.5,462,342.375,354.4,1,28,4,7
2019_06_DET_GB,GB,DET,6,2019,283,170,265,56,453,321,354.4,401,462,479.25,8,20,27,28
2019_06_HOU_KC,KC,HOU,6,2019,273,53,280,192,326,472,454.8,402.2,354.4,398.6,26,21,7,19
2019_06_NO_JAX,JAX,NO,6,2019,163,75,240,104,238,344,408.8,362,392.8,383.6,23,9,18,13
2019_06_NYG_NE,NE,NYG,6,2019,334,114,161,52,448,213,390,379.2,308.6,374.6,16,13,3,11
2019_06_PHI_MIN,MIN,PHI,6,2019,333,122,306,108,455,414,374.6,347,379.2,216.33333333333331,12,7,12,1
2019_06_PIT_LAC,LAC,PIT,6,2019,320,32,132,124,352,256,384.2,287,370.2,457.4,15,3,10,26
2019_06_SEA_CLE,CLE,SEA,6,2019,249,157,295,170,406,465,365.8,404.4,432.5333333333334,426,10,22,25,24
2019_06_SF_LA,LA,SF,6,2019,78,109,243,99,187,342,426,434,404.4,356.8125,24,25,21,8
2019_06_TEN_DEN,DEN,TEN,6,2019,177,103,207,39,280,246,370.2,338.8,384.2,389.4,11,5,14,15
2019_06_WAS_MIA,MIA,WAS,6,2019,217,84,166,145,301,311,248,308.6,418.75,390,2,4,23,16
2019_07_ARI_NYG,NYG,ARI,7,2019,223,107,104,156,330,260,351.5,400,399.6666666666667,408.6666666666667,7,21,20,22
2019_07_BAL_SEA,SEA,BAL,7,2019,241,106,143,199,347,342,414.5,465.3333333333333,372.5,331,24,28,14,7
2019_07_HOU_IND,IND,HOU,7,2019,326,62,308,100,388,408,354.4,413.8333333333333,454.8,433.3333333333333,8,23,27,25
2019_07_JAX_CIN,CIN,JAX,7,2019,276,33,255,216,309,471,331,380.3333333333333,465.3333333333333,359,6,15,28,13
2019_07_KC_DEN,DEN,KC,7,2019,213,71,193,80,284,273,355.1666666666667,433.3333333333333,323.3333333333333,413.8333333333333,9,26,6,23
2019_07_LA_ATL,ATL,LA,7,2019,224,38,291,90,262,381,408.6666666666667,386.1666666666667,400,418.6666666666667,22,17,21,24
2019_07_LAC_TEN,TEN,LAC,7,2019,323,97,329,39,420,368,323.3333333333333,378.8333333333333,355.1666666666667,281.8333333333333,5,14,10,3
2019_07_MIA_BUF,BUF,MIA,7,2019,202,117,282,109,319,391,389.4,258.6,338.8,309.08000000000004,19,2,8,5
2019_07_MIN_DET,DET,MIN,7,2019,364,81,338,166,445,504,385,388,374.12,358.1666666666667,16,18,15,12
2019_07_NE_NYJ,NYJ,NE,7,2019,86,81,249,74,167,323,250.4,399.6666666666667,451,351.5,1,20,26,9
2019_07_NO_CHI,CHI,NO,7,2019,251,17,281,151,268,432,283.4,359,357.8,380.3333333333333,3,12,11,17
2019_07_OAK_GB,GB,LV,7,2019,429,60,329,155,489,484,370.8333333333333,357.8,387.6666666666667,283.4,13,10,18,4
2019_07_PHI_DAL,DAL,PHI,7,2019,239,189,191,115,428,306,452.8333333333333,358.1666666666667,244.41666666666666,388,27,11,1,19
2019_07_SF_WAS,WAS,SF,7,2019,77,104,151,137,181,288,309,415.6,256.8333333333333,378.2,4,25,2,16
2019_08_ARI_NO,NO,ARI,8,2019,373,137,220,40,510,260,369.42857142857144,380,281.2,348.42857142857144,12,18,3,8
2019_08_CAR_SF,SF,CAR,8,2019,175,232,158,130,407,288,394.3333333333333,375,287.6666666666667,393.3333333333333,25,14,4,22
2019_08_CIN_LA,LA,CIN,8,2019,372,98,329,104,470,433,385.42857142857144,327.85714285714283,387.7142857142857,393.2857142857143,19,6,19,21
2019_08_CLE_NE,NE,CLE,8,2019,259,79,194,159,338,353,388.7142857142857,372.5,238.4857142857143,414.5,22,13,1,28
2019_08_DEN_IND,IND,DEN,8,2019,202,127,174,113,329,287,360,345,412.8611111111111,410.42857142857144,11,8,27,26
2019_08_GB_KC,KC,GB,8,2019,267,88,305,118,355,423,410.42857142857144,387.7142857142857,345,375.8285714285715,29,21,7,12
2019_08_LAC_CHI,CHI,LAC,8,2019,253,162,201,36,415,237,280.8333333333333,377.2857142857143,371.1666666666667,337.14285714285717,3,15,10,6
2019_08_MIA_PIT,PIT,MIA,8,2019,251,158,190,60,409,250,281.8333333333333,280.6666666666667,378.8333333333333,377.6666666666667,4,2,15,14
2019_08_NYG_DET,DET,NYG,8,2019,342,59,322,80,401,402,395,348.42857142857144,407.3333333333333,380,26,9,25,16
2019_08_NYJ_JAX,JAX,NYJ,8,2019,279,111,218,46,390,264,393.2857142857143,236.5,327.85714285714283,386.8888888888889,23,1,5,18
2019_08_OAK_HOU,HOU,LV,8,2019,279,130,285,93,409,378,413,378.8333333333333,359.19999999999993,390.52777777777777,30,17,9,20
2019_08_PHI_BUF,BUF,PHI,8,2019,169,98,172,218,267,390,377.6666666666667,350.7142857142857,280.6666666666667,449.2857142857143,16,10,2,30
2019_08_SEA_ATL,ATL,SEA,8,2019,460,69,182,151,529,333,387.7142857142857,404.85714285714283,385.42857142857144,447.7142857142857,21,28,17,29
2019_08_TB_TEN,TEN,TB,8,2019,193,72,301,106,265,407,337.14285714285717,393.3333333333333,377.2857142857143,375,7,24,13,11
2019_08_WAS_MIN,MIN,WAS,8,2019,285,161,163,85,446,248,404.57142857142856,290.7142857142857,393.57142857142856,397.3714285714286,27,5,23,24
2019_09_CHI_PHI,PHI,CHI,9,2019,239,146,125,62,385,187,355.625,300,363.83333333333337,357.2448979591837,10,5,14,12
2019_09_CLE_DEN,DEN,CLE,9,2019,193,127,273,90,320,363,337.75,369.7142857142857,356.125,381.46938775510205,7,15,10,17
2019_09_DAL_NYG,NYG,DAL,9,2019,210,100,257,172,310,429,355.125,449.2857142857143,395.75,350.7142857142857,8,28,22,8
2019_09_DET_OAK,LV,DET,9,2019,289,171,406,90,460,496,378.7142857142857,395.85714285714283,412.42857142857144,356.0816326530612,16,21,28,9
2019_09_GB_LAC,LAC,GB,9,2019,294,159,161,45,453,206,359.75,392.125,297.60416666666663,403.5,11,18,4,24
2019_09_HOU_JAX,JAX,HOU,9,2019,309,74,201,216,383,417,392.875,412.5,239.9375,378.72916666666663,19,26,1,16
2019_09_IND_PIT,PIT,IND,9,2019,191,90,227,139,281,366,300,355.57142857142856,276.2857142857143,336.7142857142857,5,9,2,7
2019_09_MIN_KC,KC,MIN,9,2019,275,147,220,96,422,316,403.5,409.75,392.125,285.375,24,25,19,3
2019_09_NE_BAL,BAL,NE,9,2019,163,210,285,74,373,359,447.7142857142857,382.375,404.85714285714283,370.0625,27,17,25,15
2019_09_NYJ_MIA,MIA,NYJ,9,2019,288,50,260,83,338,343,276.2857142857143,240.42857142857142,300,392.81632653061223,2,1,5,20
2019_09_SF_ARI,ARI,SF,9,2019,241,153,317,101,394,418,365,396.14285714285717,387,362.57142857142856,14,23,18,13
2019_09_TB_SEA,SEA,TB,9,2019,378,145,335,99,523,434,395.875,395.2857142857143,405.375,326.8367346938776,22,20,26,6
2019_09_TEN_CAR,CAR,TEN,9,2019,232,156,331,121,388,452,362.57142857142856,328.125,396.14285714285717,395.04166666666663,13,6,23,21
2019_09_WAS_BUF,BUF,WAS,9,2019,160,122,144,127,282,271,361.85714285714283,285.375,356.3265306122449,409.75,12,3,11,27
2019_10_ARI_TB,TB,ARI,10,2019,358,118,350,75,476,425,400.125,368.22222222222223,411.765625,398.5714285714286,20,11,25,20
2019_10_ATL_NO,NO,ATL,10,2019,304,52,182,143,356,325,387,405.375,365,395.875,15,21,11,18
2019_10_BAL_CIN,CIN,BAL,10,2019,167,157,243,127,324,370,341,438.375,396,379.453125,5,25,19,16
2019_10_BUF_CLE,CLE,BUF,10,2019,238,147,266,84,385,350,368.875,351.875,335.53125,283.578125,12,8,5,2
2019_10_CAR_GB,GB,CAR,10,2019,233,163,307,120,396,427,371.44444444444446,365.75,370.1111111111111,343.609375,14,10,14,7
2019_10_DET_CHI,CHI,DET,10,2019,173,81,269,98,254,367,285.875,408.375,359.296875,388.875,3,23,10,17
2019_10_KC_TEN,TEN,KC,10,2019,181,225,446,97,406,543,341.8888888888889,405.55555555555554,365.39682539682536,399.3333333333333,6,22,12,21
2019_10_LA_PIT,PIT,LA,10,2019,242,42,243,88,284,331,297.625,396,356.875,341,4,17,9,6
2019_10_LAC_OAK,LV,LAC,10,2019,218,78,207,146,296,353,388.875,370.1111111111111,408.375,371.44444444444446,16,13,24,15
2019_10_MIA_IND,IND,MIA,10,2019,204,109,169,70,313,239,356.875,284,297.625,253.25,9,2,4,1
2019_10_MIN_DAL,DAL,MIN,10,2019,397,50,220,153,447,373,446.75,399.3333333333333,349.484375,405.55555555555554,26,19,8,23
2019_10_NYG_NYJ,NYJ,NYG,10,2019,230,76,308,23,306,331,253.25,350.1111111111111,284,447.031746031746,1,7,3,26
2019_10_SEA_SF,SF,SEA,10,2019,248,87,232,147,335,379,398.875,410,368.625,399.58730158730157,18,24,13,22
2019_11_ARI_SF,SF,ARI,11,2019,424,34,150,135,458,285,391.77777777777777,373.9,406.55555555555554,407.7125,20,14,23,24
2019_11_ATL_CAR,CAR,ATL,11,2019,325,77,314,54,402,368,372.55555555555554,396.44444444444446,374.17283950617286,383.55555555555554,13,21,14,17
2019_11_BUF_MIA,MIA,BUF,11,2019,323,23,256,168,346,424,279,351.6666666666667,352,370.6666666666667,2,8,9,13
2019_11_CHI_LA,LA,CHI,11,2019,173,110,199,74,283,273,388.77777777777777,282.3333333333333,296.1111111111111,403.77777777777777,18,3,4,22
2019_11_CIN_OAK,LV,CIN,11,2019,292,113,115,173,405,288,378.55555555555554,339.1111111111111,368.2098765432099,430.77777777777777,15,7,11,26
2019_11_DAL_DET,DET,DAL,11,2019,209,121,444,75,330,519,403.77777777777777,446.77777777777777,282.3333333333333,396.4074074074074,23,28,2,20
2019_11_DEN_MIN,MIN,DEN,11,2019,319,37,278,124,356,402,396.7,335.77777777777777,446.775,368.968253968254,22,6,28,12
2019_11_HOU_BAL,BAL,HOU,11,2019,235,256,169,122,491,291,430.77777777777777,413,339.1111111111111,391.77777777777777,27,25,5,19
2019_11_JAX_IND,IND,JAX,11,2019,148,264,296,29,412,325,352,391.77777777777777,279,413,9,20,1,25
2019_11_KC_LAC,LAC,KC,11,2019,353,93,182,130,446,312,368.4,419.3,379.5875,348.3,11,26,16,7
2019_11_NE_PHI,PHI,NE,11,2019,214,81,231,74,295,305,358.8888888888889,379.77777777777777,287.44444444444446,439.41269841269843,10,16,3,27
2019_11_NO_TB,TB,NO,11,2019,313,36,228,109,349,337,408.55555555555554,383.55555555555554,374.5308641975309,396.44444444444446,24,17,15,21
2019_11_NYJ_WAS,WAS,NYJ,11,2019,214,54,293,115,268,408,283.77777777777777,259.1111111111111,352.984126984127,347.98765432098764,4,1,10,6
2019_11_PIT_CLE,CLE,PIT,11,2019,193,104,221,58,297,279,370.6666666666667,296.1111111111111,351.6666666666667,388.77777777777777,12,5,8,18
2019_12_BAL_LA,LA,BAL,12,2019,212,22,208,285,234,493,378.2,436.8,281.4,400.8,17,27,3,24
2019_12_CAR_NO,NO,CAR,12,2019,311,118,256,121,429,377,378.9,375.5,402.6,393.6,18,16,25,22
2019_12_DAL_NE,NE,DAL,12,2019,190,101,212,109,291,321,372.3,454,352.5,396.4,14,28,8,23
2019_12_DEN_BUF,BUF,DEN,12,2019,185,244,82,85,429,167,358.9,342.4,285.7,392.63,12,7,5,21
2019_12_DET_WAS,WAS,DET,12,2019,156,86,207,175,242,382,282.2,396.4,274,454,3,22,2,28
2019_12_GB_SF,SF,GB,12,2019,253,112,119,117,365,236,398.4,373.9,365.01,371.875,23,15,12,13
2019_12_IND_HOU,HOU,IND,12,2019,298,99,129,175,397,304,400.8,358,436.8,385.1,24,11,27,19
2019_12_JAX_TEN,TEN,JAX,12,2019,259,219,272,117,478,389,348.3,385.1,419.3,358,9,20,26,9
2019_12_MIA_CLE,CLE,MIA,12,2019,327,147,214,92,474,306,363.3,285.7,294.4,358.9,13,4,6,10
2019_12_NYG_CHI,CHI,NYG,12,2019,278,65,150,109,343,259,281.4,348.2,378.2,258.525,2,8,16,1
2019_12_OAK_NYJ,NYJ,LV,12,2019,315,88,147,68,403,215,274,381.2,282.2,334,1,19,4,7
2019_12_PIT_CIN,CIN,PIT,12,2019,192,86,203,159,278,362,334,294.4,381.2,363.3,6,5,18,11
2019_12_SEA_PHI,PHI,SEA,12,2019,256,106,200,174,362,374,352.5,406.9,372.3,392.4875,10,26,14,20
2019_12_TB_ATL,ATL,TB,12,2019,326,57,313,133,383,446,393.6,402.6,375.5,378.9,21,25,15,17
2019_13_BUF_DAL,DAL,BUF,13,2019,355,103,259,124,458,383,441.90909090909093,365.27272727272725,364.90909090909093,326.45454545454544,32,15,14,6
2019_13_CHI_DET,DET,CHI,13,2019,280,105,338,88,385,426,395.09090909090907,287,278.54545454545456,340.09090909090907,25,3,1,8
2019_13_CLE_PIT,PIT,CLE,13,2019,212,124,196,106,336,302,300.54545454545456,373.3636363636364,328.90909090909093,287.54545454545456,5,18,7,4
2019_13_GB_NYG,NYG,GB,13,2019,240,95,243,79,335,322,340.09090909090907,361.3636363636364,287,395.3636363636364,8,12,3,25
2019_13_LA_ARI,ARI,LA,13,2019,163,74,427,132,237,559,365.8181818181818,365.09090909090907,397.79797979797974,441.90909090909093,16,14,26,32
2019_13_LAC_DEN,DEN,LAC,13,2019,134,84,265,115,218,380,326.45454545454544,375.45454545454544,365.27272727272725,409.54545454545456,6,19,16,30
2019_13_MIN_SEA,SEA,MIN,13,2019,240,218,276,78,458,354,403.90909090909093,393,353.3636363636364,341.7979797979798,28,24,11,9
2019_13_NE_HOU,HOU,NE,13,2019,240,52,326,145,292,471,400.45454545454544,364.90909090909093,353.09090909090907,441.90909090909093,27,13,10,32
2019_13_NO_ATL,ATL,NO,13,2019,312,89,184,95,401,279,392.6363636363636,383.45454545454544,406.54545454545456,375.6363636363636,23,21,29,20
2019_13_NYJ_CIN,CIN,NYJ,13,2019,243,44,239,62,287,301,328.90909090909093,285.72727272727275,300.54545454545456,366.09090909090907,7,2,5,17
2019_13_OAK_KC,KC,LV,13,2019,175,96,222,122,271,344,409.54545454545456,366.09090909090907,375.45454545454544,285.72727272727275,30,17,19,2
2019_13_PHI_MIA,MIA,PHI,13,2019,366,58,310,92,424,402,287.54545454545456,353.3636363636364,373.3636363636364,403.90909090909093,4,10,18,28
2019_13_SF_BAL,BAL,SF,13,2019,105,178,165,174,283,339,441.90909090909093,395.3636363636364,365.09090909090907,361.3636363636364,32,26,15,13
2019_13_TB_JAX,JAX,TB,13,2019,240,49,268,74,289,342,385.45454545454544,406.54545454545456,360.09090909090907,392.6363636363636,22,29,12,23
2019_13_TEN_IND,IND,TEN,13,2019,319,82,182,154,401,336,353.09090909090907,360.09090909090907,400.45454545454544,385.45454545454544,9,11,27,22
2019_13_WAS_CAR,CAR,WAS,13,2019,278,65,147,248,343,395,375.6363636363636,278.54545454545456,383.45454545454544,395.09090909090907,20,1,21,24
2019_14_BAL_BUF,BUF,BAL,14,2019,146,104,145,118,250,263,366.75,428.6666666666667,443.25,390.6666666666667,15,31,32,24
2019_14_CAR_ATL,ATL,CAR,14,2019,313,159,293,100,472,393,393.3333333333333,372.9166666666667,374.75,288.25,26,17,19,2
2019_14_CIN_CLE,CLE,CIN,14,2019,192,146,288,179,338,467,367.4166666666667,325.4166666666667,303.5,287,16,7,5,1
2019_14_DAL_CHI,CHI,DAL,14,2019,244,151,334,82,395,416,298.5833333333333,443.25,394.25,366.75,3,32,27,15
2019_14_DEN_HOU,HOU,DEN,14,2019,292,134,309,90,426,399,391.4166666666667,317.4166666666667,373.75,375.8333333333333,25,6,18,20
2019_14_DET_MIN,MIN,DET,14,2019,242,120,205,70,362,275,389.75,394.25,408.4166666666667,298.5833333333333,23,27,30,3
2019_14_IND_TB,TB,IND,14,2019,474,75,251,66,549,317,401.1666666666667,357.0833333333333,377.4166666666667,358.0833333333333,29,10,21,13
2019_14_KC_NE,NE,KC,14,2019,204,94,283,75,298,358,373.75,398,391.4166666666667,364.25,18,28,25,14
2019_14_LAC_JAX,JAX,LAC,14,2019,171,88,340,195,259,535,377.4166666666667,375.8333333333333,401.1666666666667,317.4166666666667,21,20,29,6
2019_14_MIA_NYJ,NYJ,MIA,14,2019,270,112,245,118,382,363,287,298.9166666666667,325.4166666666667,357.4166666666667,1,4,7,11
2019_14_NYG_PHI,PHI,NYG,14,2019,325,118,203,73,443,276,357.4166666666667,339.66666666666663,298.9166666666667,358.0833333333333,11,8,4,13
2019_14_PIT_ARI,ARI,PIT,14,2019,194,71,152,140,265,292,355.0833333333333,303.5,381.25,367.4166666666667,9,5,22,16
2019_14_SEA_LA,LA,SEA,14,2019,293,162,245,106,455,351,381.25,408.4166666666667,355.0833333333333,389.75,22,30,9,23
2019_14_SF_NO,NO,SF,14,2019,349,116,384,162,465,546,374.75,390.6666666666667,393.3333333333333,428.6666666666667,19,24,26,31
2019_14_TEN_OAK,LV,TEN,14,2019,262,97,391,161,359,552,364.25,358.0833333333333,398,357.0833333333333,14,13,28,10
2019_14_WAS_GB,GB,WAS,14,2019,195,174,170,121,369,291,358.0833333333333,288.25,339.66666666666663,372.9166666666667,13,2,8,17
2019_15_ATL_SF,SF,ATL,15,2019,200,120,210,89,320,299,402.61538461538464,399.38461538461536,381.6923076923077,374.46153846153845,28,27,20,19
2019_15_BUF_PIT,PIT,BUF,15,2019,202,51,139,130,253,269,302.61538461538464,357.7692307692308,348.15384615384613,415.9230769230769,3,11,9,31
2019_15_CHI_GB,GB,CHI,15,2019,203,100,334,96,303,430,358.9230769230769,306,288.46153846153845,441.15384615384613,12,5,1,32
2019_15_CLE_ARI,ARI,CLE,15,2019,219,226,247,152,445,399,348.15384615384613,365.15384615384613,302.61538461538464,336.3076923076923,9,15,3,8
2019_15_DEN_KC,KC,DEN,15,2019,340,92,208,52,432,260,394.9230769230769,323.6923076923077,367.9230769230769,394.0769230769231,26,6,16,25
2019_15_HOU_TEN,TEN,HOU,15,2019,279,163,243,140,442,383,373,394.0769230769231,363.84615384615387,323.6923076923077,18,25,13,6
2019_15_IND_NO,NO,IND,15,2019,307,117,165,46,424,211,381.6923076923077,354,402.61538461538464,412.53846153846155,20,10,28,30
2019_15_JAX_OAK,LV,JAX,15,2019,267,128,201,77,395,278,363.84615384615387,368.3076923076923,373,388.0769230769231,13,17,18,24
2019_15_LA_DAL,DAL,LA,15,2019,212,263,289,22,475,311,441.15384615384613,386.9230769230769,306,404,32,22,5,29
2019_15_MIA_NYG,NYG,MIA,15,2019,284,138,279,122,422,401,334.7692307692308,303.84615384615387,364,294.3076923076923,7,4,14,2
2019_15_MIN_LAC,LAC,MIN,15,2019,307,62,207,137,369,344,388.0769230769231,387.61538461538464,368.3076923076923,385.0769230769231,24,23,17,21
2019_15_NE_CIN,CIN,NE,15,2019,151,164,128,175,315,303,336.3076923076923,367.9230769230769,365.15384615384613,394.9230769230769,8,16,15,26
2019_15_NYJ_BAL,BAL,NYJ,15,2019,212,218,218,103,430,321,415.9230769230769,294.3076923076923,357.7692307692308,303.84615384615387,31,2,11,4
2019_15_PHI_WAS,WAS,PHI,15,2019,261,101,266,157,362,423,288.46153846153845,364,358.9230769230769,334.7692307692308,1,14,12,7
2019_15_SEA_CAR,CAR,SEA,15,2019,277,145,286,154,422,440,374.46153846153845,404,399.38461538461536,386.9230769230769,19,29,27,22
2019_15_TB_DET,DET,TB,15,2019,260,45,458,49,305,507,385.0769230769231,412.53846153846155,387.61538461538464,354,21,30,23,10
2019_16_ARI_SEA,SEA,ARI,16,2019,169,91,167,253,260,420,406.57142857142856,355.07142857142856,377.85714285714283,367.57142857142856,29,12,18,16
2019_16_BAL_CLE,CLE,BAL,16,2019,192,57,238,243,249,481,367.57142857142856,416.92857142857144,355.07142857142856,296.2142857142857,16,30,12,2
2019_16_BUF_NE,NE,BUF,16,2019,271,143,208,92,414,300,363.2857142857143,351.42857142857144,334.7857142857143,299.07142857142856,14,10,7,3
2019_16_CAR_IND,IND,CAR,16,2019,119,218,236,87,337,323,343.7857142857143,377.85714285714283,384.7142857142857,406.57142857142856,9,18,23,29
2019_16_CIN_MIA,MIA,CIN,16,2019,419,96,396,59,515,455,310.7857142857143,334.7857142857143,341,363.2857142857143,4,7,8,14
2019_16_DAL_PHI,PHI,DAL,16,2019,319,118,265,54,437,319,368.2142857142857,443.57142857142856,293.7142857142857,381.5,17,32,1,21
2019_16_DET_DEN,DEN,DET,16,2019,198,150,117,96,348,213,319.14285714285717,379.35714285714283,397.57142857142856,419.2857142857143,6,20,28,31
2019_16_GB_MIN,MIN,GB,16,2019,122,57,216,184,179,400,384.5,354.92857142857144,386.7142857142857,314.85714285714283,22,11,24,5
2019_16_HOU_TB,TB,HOU,16,2019,335,106,184,68,441,252,419.2857142857143,393.2857142857143,379.35714285714283,377.92857142857144,31,26,20,19
2019_16_JAX_ATL,ATL,JAX,16,2019,384,135,188,115,519,303,392.2142857142857,361.85714285714283,396.7142857142857,366.07142857142856,25,13,27,15
2019_16_KC_CHI,CHI,KC,16,2019,157,101,251,106,258,357,314.85714285714283,397.57142857142856,354.92857142857144,319.14285714285717,5,28,11,6
2019_16_LA_SF,SF,LA,16,2019,248,119,323,72,367,395,396.7142857142857,381.5,392.2142857142857,443.57142857142856,27,21,25,32
2019_16_NO_TEN,TEN,NO,16,2019,272,149,299,102,421,401,377.92857142857144,384.7142857142857,393.2857142857143,343.7857142857143,19,23,26,9
2019_16_NYG_WAS,WAS,NYG,16,2019,302,80,352,206,382,558,293.7142857142857,341,368.2142857142857,310.7857142857143,1,8,17,4
2019_16_OAK_LAC,LAC,LV,16,2019,279,19,291,99,298,390,386.7142857142857,366.07142857142856,384.5,361.85714285714283,24,15,22,13
2019_16_PIT_NYJ,NYJ,PIT,16,2019,183,85,213,75,268,288,296.2142857142857,299.07142857142856,416.92857142857144,351.42857142857144,2,3,30,10
2019_17_ARI_LA,LA,ARI,17,2019,319,113,325,71,432,396,382.4,359.4,394.73333333333335,396.8,23,13,26,28
2019_17_ATL_TB,TB,ATL,17,2019,201,136,313,87,337,400,420.73333333333335,400.6666666666667,383.8666666666667,357.93333333333334,30,29,24,12
2019_17_CHI_MIN,MIN,CHI,17,2019,126,174,207,158,300,365,370.8,311.06666666666666,357.93333333333334,394.8666666666667,18,4,12,27
2019_17_CLE_CIN,CIN,CLE,17,2019,190,179,279,74,369,353,342.8,359.6666666666667,324.4,421.2,7,14,6,31
2019_17_GB_DET,DET,GB,17,2019,141,171,323,120,312,443,368.26666666666665,357.93333333333334,321.06666666666666,370.8,17,12,5,18
2019_17_IND_JAX,JAX,IND,17,2019,295,67,162,132,362,294,357.93333333333334,343.3333333333333,400.6666666666667,374.2,12,8,29,20
2019_17_LAC_KC,KC,LAC,17,2019,174,162,281,108,336,389,394.8666666666667,380.8,311.06666666666666,367.6666666666667,27,22,4,16
2019_17_MIA_NE,NE,MIA,17,2019,221,135,340,63,356,403,366.6666666666667,324.4,348,342.8,15,6,9,7
2019_17_NO_CAR,CAR,NO,17,2019,299,41,267,115,340,382,374.2,385.8,343.3333333333333,380.8,20,25,8,22
2019_17_NYJ_BUF,BUF,NYJ,17,2019,237,73,199,86,310,285,348,294.3333333333333,366.6666666666667,298.3333333333333,9,1,15,2
2019_17_OAK_DEN,DEN,LV,17,2019,177,70,391,97,247,488,321.06666666666666,367.6666666666667,368.26666666666665,380.8,5,16,17,22
2019_17_PHI_NYG,NYG,PHI,17,2019,301,122,289,121,423,410,355.46666666666664,372.8,299.6,435.26666666666665,10,19,3,32
2019_17_PIT_BAL,BAL,PIT,17,2019,96,223,95,91,319,186,421.2,298.3333333333333,359.6666666666667,294.3333333333333,31,2,14,1
2019_17_SF_SEA,SEA,SF,17,2019,233,125,285,128,358,413,396.8,394.73333333333335,359.4,382.4,28,26,13,23
2019_17_TEN_HOU,HOU,TEN,17,2019,225,109,222,245,334,467,383.8666666666667,380.8,420.73333333333335,385.8,24,22,30,25
2019_17_WAS_DAL,DAL,WAS,17,2019,303,223,206,88,526,294,435.26666666666665,299.6,372.8,355.46666666666664,32,3,19,10
2019_18_BUF_HOU,HOU,BUF,18,2019,247,141,280,172,388,452,380.75,345.625,386.1875,293.75,5,1,7,1
2019_18_MIN_NO,NO,MIN,18,2019,258,97,242,136,355,378,385.5625,366.375,372.0625,314.4375,6,3,5,2
2019_18_SEA_PHI,PHI,SEA,18,2019,177,120,325,64,297,389,375.125,394.375,359.6875,395.875,4,8,4,8
2019_18_TEN_NE,NE,TEN,18,2019,209,98,76,201,307,277,366,386.1875,329.3125,380.75,2,7,3,6
2019_19_HOU_KC,KC,HOU,19,2019,321,118,388,94,439,482,391.1875,381.1764705882353,381.3125,351.88235294117646,5,4,6,2
2019_19_MIN_SF,SF,MIN,19,2019,131,186,172,21,317,193,395.875,367.05882352941177,394.375,383.7647058823529,7,2,8,7
2019_19_SEA_GB,GB,SEA,19,2019,243,109,277,110,352,387,363.25,394.05882352941177,364.75,370.52941176470586,1,6,4,5
2019_19_TEN_BAL,BAL,TEN,19,2019,365,185,91,217,550,308,414.8125,379.7647058823529,291.3125,362.52941176470586,8,3,1,3
2019_20_GB_SF,SF,GB,20,2019,77,285,326,62,362,388,391.2352941176471,362.5882352941176,356.8200692041523,393.64359861591697,3,1,1,3
2019_20_TEN_KC,KC,TEN,20,2019,294,112,237,85,406,322,394,375.77777777777777,387.10726643598616,422.3229166666667,4,2,2,4
2019_21_SF_KC,KC,SF,21,2019,286,129,219,141,415,360,394.6666666666667,389.6111111111111,372.79012345679007,364,2,1,2,1
2020_01_ARI_SF,SF,ARI,1,2020,259,123,230,180,382,410,0,0,0,0,32,32,32,32
2020_01_CHI_DET,DET,CHI,1,2020,297,138,242,149,435,391,0,0,0,0,32,32,32,32
2020_01_CLE_BAL,BAL,CLE,1,2020,284,111,189,138,395,327,0,0,0,0,32,32,32,32
2020_01_DAL_LA,LA,DAL,1,2020,275,153,266,136,428,402,0,0,0,0,32,32,32,32
2020_01_GB_MIN,MIN,GB,1,2020,259,134,364,158,393,522,0,0,0,0,32,32,32,32
2020_01_HOU_KC,KC,HOU,1,2020,211,166,253,118,377,371,0,0,0,0,32,32,32,32
2020_01_IND_JAX,JAX,IND,1,2020,173,91,363,88,264,451,0,0,0,0,32,32,32,32
2020_01_LAC_CIN,CIN,LAC,1,2020,193,122,208,155,315,363,0,0,0,0,32,32,32,32
2020_01_LV_CAR,CAR,LV,1,2020,269,129,239,133,398,372,0,0,0,0,32,32,32,32
2020_01_MIA_NE,NE,MIA,1,2020,155,217,191,87,372,278,0,0,0,0,32,32,32,32
2020_01_NYJ_BUF,BUF,NYJ,1,2020,312,98,215,52,410,267,0,0,0,0,32,32,32,32
2020_01_PHI_WAS,WAS,PHI,1,2020,178,80,270,57,258,327,0,0,0,0,32,32,32,32
2020_01_PIT_NYG,NYG,PIT,1,2020,279,29,229,141,308,370,0,0,0,0,32,32,32,32
2020_01_SEA_ATL,ATL,SEA,1,2020,450,72,322,84,522,406,0,0,0,0,32,32,32,32
2020_01_TB_NO,NO,TB,1,2020,198,82,239,86,280,325,0,0,0,0,32,32,32,32
2020_01_TEN_DEN,DEN,TEN,1,2020,216,107,249,130,323,379,0,0,0,0,32,32,32,32
2020_02_ATL_DAL,DAL,ATL,2,2020,450,125,273,113,575,386,402,522,428,406,24,32,28,25
2020_02_BAL_HOU,HOU,BAL,2,2020,275,51,204,230,326,434,371,395,377,327,14,22,17,11
2020_02_BUF_MIA,MIA,BUF,2,2020,328,99,415,112,427,527,278,410,372,267,4,27,16,3
2020_02_CAR_TB,TB,CAR,2,2020,217,122,367,87,339,454,325,398,280,372,9,23,5,16
2020_02_CIN_CLE,CLE,CIN,2,2020,219,215,316,68,434,384,327,315,395,363,11,7,22,12
2020_02_DEN_PIT,PIT,DEN,2,2020,311,109,276,104,420,380,370,323,308,379,13,8,6,18
2020_02_DET_GB,GB,DET,2,2020,240,259,244,89,499,333,522,435,393,391,32,29,21,20
2020_02_JAX_TEN,TEN,JAX,2,2020,239,123,339,165,362,504,379,264,323,451,18,2,8,30
2020_02_KC_LAC,LAC,KC,2,2020,311,183,302,125,494,427,363,377,315,371,12,17,7,14
2020_02_LA_PHI,PHI,LA,2,2020,242,121,267,191,363,458,327,428,258,402,11,28,1,24
2020_02_MIN_IND,IND,MIN,2,2020,214,151,113,80,365,193,451,393,264,522,30,21,2,32
2020_02_NE_SEA,SEA,NE,2,2020,288,154,397,67,442,464,406,372,522,278,25,16,32,4
2020_02_NO_LV,LV,NO,2,2020,284,116,312,112,400,424,372,280,398,325,16,5,23,9
2020_02_NYG_CHI,CHI,NYG,2,2020,190,135,241,75,325,316,391,308,435,370,20,6,29,13
2020_02_SF_NYJ,NYJ,SF,2,2020,179,104,202,182,283,384,267,382,410,410,3,19,27,27
2020_02_WAS_ARI,ARI,WAS,2,2020,286,160,223,117,446,340,410,258,382,327,27,1,19,11
2020_03_CAR_LAC,LAC,CAR,3,2020,330,117,235,81,447,316,428.5,426,402,332,27,25,20,5
2020_03_CHI_ATL,ATL,CHI,3,2020,238,144,316,130,382,446,454,358,488.5,312,29,12,31,4
2020_03_CIN_PHI,PHI,CIN,3,2020,225,172,312,48,397,360,345,349.5,443,380.5,6,8,28,14
2020_03_DAL_SEA,SEA,DAL,3,2020,315,117,472,61,432,533,424,488.5,418,454,24,31,23,29
2020_03_DET_ARI,ARI,DET,3,2020,270,109,270,90,379,360,428,384,299,510.5,26,17,3,32
2020_03_GB_NO,NO,GB,3,2020,288,122,283,98,410,381,352,510.5,386,384,10,32,18,17
2020_03_HOU_PIT,PIT,HOU,3,2020,237,169,264,29,406,293,395,348.5,351.5,414.5,19,7,9,22
2020_03_KC_BAL,BAL,KC,3,2020,97,158,385,132,255,517,414.5,402,348.5,428.5,22,20,7,27
2020_03_LA_BUF,BUF,LA,3,2020,311,101,321,167,412,488,468.5,443,352.5,345,30,28,11,6
2020_03_LV_NE,NE,LV,3,2020,162,250,261,126,412,387,418,386,424,352,23,18,24,10
2020_03_MIA_JAX,JAX,MIA,3,2020,275,72,160,138,347,298,384,352.5,370.5,468.5,17,11,13,30
2020_03_NYJ_IND,IND,NYJ,3,2020,234,119,168,109,353,277,408,275,293,383,21,1,2,15
2020_03_SF_NYG,NYG,SF,3,2020,179,66,343,93,245,436,312,383,358,275,4,15,12,1
2020_03_TB_DEN,DEN,TB,3,2020,229,42,297,68,271,365,351.5,332,395,426,9,5,19,25
2020_03_TEN_MIN,MIN,TEN,3,2020,251,226,321,134,477,455,293,370.5,408,384,2,13,21,17
2020_03_WAS_CLE,CLE,WAS,3,2020,156,158,224,103,314,327,380.5,299,349.5,428,14,3,8,26
2020_04_ARI_CAR,CAR,ARI,4,2020,276,168,133,129,444,262,389.3333333333333,411.6666666666667,434.6666666666667,376,18,21,25,13
2020_04_ATL_GB,GB,ATL,4,2020,327,88,285,78,415,363,467.3333333333333,430,371.3333333333333,387.3333333333333,29,24,11,15
2020_04_BAL_WAS,WAS,BAL,4,2020,314,69,208,144,383,352,308.3333333333333,361.3333333333333,358.3333333333333,440.3333333333333,3,11,8,26
2020_04_BUF_LV,LV,BUF,4,2020,311,86,288,63,397,351,386.3333333333333,449.6666666666667,416,458,16,27,22,28
2020_04_CLE_DAL,DAL,CLE,4,2020,502,85,202,307,587,509,503.3333333333333,358.3333333333333,426.6666666666667,308.3333333333333,30,10,23,3
2020_04_DEN_NYJ,NYJ,DEN,4,2020,246,129,242,117,375,359,275.6666666666667,324.6666666666667,389.6666666666667,343,1,4,17,6
2020_04_IND_CHI,CHI,IND,4,2020,249,28,190,103,277,293,387.3333333333333,389.6666666666667,430,275.6666666666667,17,19,24,1
2020_04_JAX_CIN,CIN,JAX,4,2020,300,205,351,89,505,440,353,371.6666666666667,362.3333333333333,334.3333333333333,8,14,10,5
2020_04_LAC_TB,TB,LAC,4,2020,369,115,290,46,484,336,343,434.6666666666667,324.6666666666667,389.3333333333333,7,25,4,16
2020_04_MIN_HOU,HOU,MIN,4,2020,300,96,260,162,396,422,330,354.3333333333333,398.6666666666667,398.6666666666667,5,9,19,19
2020_04_NE_KC,KC,NE,4,2020,236,94,190,185,330,375,440.3333333333333,416,361.3333333333333,386.3333333333333,26,22,9,14
2020_04_NO_DET,DET,NO,4,2020,206,90,246,164,296,410,376,371.3333333333333,411.6666666666667,467.3333333333333,15,13,21,29
2020_04_NYG_LA,LA,NYG,4,2020,200,58,190,136,258,326,458,289.6666666666667,449.6666666666667,400.6666666666667,28,2,27,20
2020_04_PHI_SF,SF,PHI,4,2020,338,116,193,93,454,286,400.6666666666667,362.3333333333333,289.6666666666667,353,20,12,2,7
2020_04_SEA_MIA,MIA,SEA,4,2020,315,103,360,98,418,458,334.3333333333333,426.6666666666667,371.6666666666667,503.3333333333333,6,23,12,30
2020_05_ARI_NYJ,NYJ,ARI,5,2020,195,123,380,127,318,507,300.5,374.25,333.25,403,2,11,4,20
2020_05_BUF_TEN,TEN,BUF,5,2020,195,139,285,95,334,380,398.6666666666667,425,354.3333333333333,389,19,26,7,17
2020_05_CAR_ATL,ATL,CAR,5,2020,226,166,313,124,392,437,413.25,403,454.25,374.25,24,20,27,14
2020_05_CIN_BAL,BAL,CIN,5,2020,180,161,183,70,341,253,359,391,327,388.75,7,16,2,16
2020_05_IND_CLE,CLE,IND,5,2020,265,124,243,68,389,311,396,365.5,524.25,359.75,17,9,28,11
2020_05_JAX_HOU,HOU,JAX,5,2020,359,129,301,75,488,376,346.5,388.75,371.25,391,5,14,13,18
2020_05_LA_WAS,WAS,LA,5,2020,111,38,309,129,149,438,327,408,359,298.75,3,21,10,1
2020_05_LAC_NO,NO,LAC,5,2020,325,95,264,111,420,375,381,410,356,378.25,13,22,9,15
2020_05_LV_KC,KC,LV,5,2020,340,80,347,144,420,491,412.75,389,405.75,425,23,15,21,25
2020_05_MIA_SF,SF,MIA,5,2020,171,131,350,94,302,444,414,355.25,343.25,434.5,25,6,5,26
2020_05_MIN_SEA,SEA,MIN,5,2020,217,124,249,201,341,450,434.5,371.25,355.25,346.5,27,10,8,6
2020_05_NYG_DAL,DAL,NYG,5,2020,288,126,222,89,414,311,524.25,298.75,396,408,28,1,19,22
2020_05_PHI_PIT,PIT,PHI,5,2020,239,136,276,94,375,370,398.6666666666667,343.25,330,414,19,4,3,24
2020_05_TB_CHI,CHI,TB,5,2020,243,35,253,106,278,359,359.75,378.25,365.5,410,8,12,12,23
2020_06_ARI_DAL,DAL,ARI,6,2020,266,97,188,261,363,449,502.2,400.8,301.2,304,28,20,3,4
2020_06_ATL_MIN,MIN,ATL,6,2020,343,32,371,99,375,470,387,409,415.8,409.8,16,22,27,22
2020_06_BAL_PHI,PHI,BAL,6,2020,213,194,186,182,407,368,348.6,355.4,393.93333333333334,363.4,6,8,17,9
2020_06_CHI_CAR,CAR,CHI,6,2020,216,112,198,63,328,261,409.8,343.4,409,374.4,23,5,20,11
2020_06_CIN_IND,IND,CIN,6,2020,371,59,313,98,430,411,354.6,363.4,394.6,355.4,7,10,18,8
2020_06_CLE_PIT,PIT,CLE,6,2020,168,129,165,75,297,240,392.75,394.6,349.9375,354.6,18,19,6,7
2020_06_DEN_NE,NE,DEN,6,2020,195,117,189,135,312,324,405.75,333.25,412.75,300.5,21,4,23,2
2020_06_DET_JAX,JAX,DET,6,2020,243,44,223,180,287,403,386.2,356,374.8,381,15,9,12,13
2020_06_GB_TB,TB,GB,6,2020,166,158,160,94,324,254,374.4,454.25,343.4,413.25,12,27,5,24
2020_06_HOU_TEN,TEN,HOU,6,2020,366,263,335,92,629,427,382.5,374.8,413.75,386.2,14,13,25,15
2020_06_KC_BUF,BUF,KC,6,2020,122,84,225,245,206,470,416,414.2,385.73333333333335,409.4,26,25,14,21
2020_06_LA_SF,SF,LA,6,2020,268,122,198,113,390,311,391.6,414,373,291.4,17,24,10,1
2020_06_NYJ_MIA,MIA,NYJ,6,2020,200,110,186,115,310,301,373,304,391.6,400.8,11,3,16,19
2020_06_WAS_NYG,NYG,WAS,6,2020,112,132,280,86,244,366,301.2,291.4,502.2,414,2,1,28,26
2020_07_BUF_NYJ,NYJ,BUF,7,2020,120,100,307,126,220,433,303.5,381,362.5,423.5,2,13,6,26
2020_07_CAR_NO,NO,CAR,7,2020,287,138,254,37,425,291,388.8,396.1666666666667,403,329.6666666666667,16,18,22,3
2020_07_CHI_LA,LA,CHI,7,2020,220,160,261,49,380,310,396.8333333333333,329.6666666666667,391.3333333333333,396.1666666666667,19,4,19,20
2020_07_CLE_CIN,CIN,CLE,7,2020,422,81,316,82,503,398,371.3333333333333,368.8333333333333,367.1666666666667,376.7916666666667,11,9,11,12
2020_07_DAL_WAS,WAS,DAL,7,2020,194,208,114,83,402,197,303.8333333333333,479,291.6666666666667,408.8333333333333,3,28,1,23
2020_07_DET_ATL,ATL,DET,7,2020,338,66,340,64,404,404,419.1666666666667,365.4,385,366.36,25,7,14,10
2020_07_GB_HOU,HOU,GB,7,2020,309,79,283,96,388,379,383.5,414.2,423.5833333333333,364.32,14,23,27,9
2020_07_JAX_LAC,LAC,JAX,7,2020,351,135,173,140,486,313,403,369.6666666666667,388.8,363.8333333333333,20,10,18,8
2020_07_KC_DEN,DEN,KC,7,2020,254,177,213,101,431,314,331.4,423.5,387,381,5,26,17,13
2020_07_NYG_PHI,PHI,NYG,7,2020,359,96,187,160,455,347,358.3333333333333,291.6666666666667,357.5,303.8333333333333,6,1,5,2
2020_07_PIT_TEN,TEN,PIT,7,2020,220,82,268,94,302,362,431.8,373.6,385.24,363.68,27,12,15,7
2020_07_SEA_ARI,ARI,SEA,7,2020,360,159,388,200,519,588,408.8333333333333,415.8,479,387,21,24,28,17
2020_07_SF_NE,NE,SF,7,2020,162,94,277,197,256,474,387,391.3333333333333,331.4,396.8333333333333,15,17,4,21
2020_07_TB_LV,LV,TB,7,2020,284,76,369,85,360,454,409.4,366,414.2,420.875,22,8,24,25
2020_08_ATL_CAR,CAR,ATL,8,2020,179,147,281,131,326,412,381.14285714285717,417,393.9714285714286,370.91428571428565,14,26,20,10
2020_08_DAL_PHI,PHI,DAL,8,2020,132,119,180,133,251,313,372.14285714285717,438.7142857142857,299.57142857142856,317.85714285714283,11,27,2,4
2020_08_IND_DET,DET,IND,8,2020,336,29,262,119,365,381,371.8333333333333,367.1666666666667,416.6388888888889,371.3333333333333,10,8,26,11
2020_08_LA_MIA,MIA,LA,8,2020,93,55,355,131,148,486,362.5,394.42857142857144,303.5,326.85714285714283,6,18,3,5
2020_08_LAC_DEN,DEN,LAC,8,2020,248,108,278,210,356,488,348,416.8333333333333,405.25,360.22222222222223,4,25,24,8
2020_08_LV_CLE,CLE,LV,8,2020,122,101,111,209,223,320,373,401.1666666666667,390.14285714285717,380.6666666666667,12,20,19,16
2020_08_MIN_GB,GB,MIN,8,2020,291,109,160,173,400,333,408.3333333333333,385,384.25,419.1666666666667,23,15,17,27
2020_08_NE_BUF,BUF,NE,8,2020,154,190,174,188,344,362,388.42857142857144,365.1666666666667,291.57142857142856,405.1111111111111,16,7,1,23
2020_08_NO_CHI,CHI,NO,8,2020,272,96,280,122,368,402,326.85714285714283,394.8333333333333,394.42857142857144,378.6388888888889,3,19,21,15
2020_08_NYJ_KC,KC,NYJ,8,2020,446,50,133,93,496,226,407.85714285714283,291.57142857142856,345.6285714285714,388.42857142857144,22,1,6,18
2020_08_PIT_BAL,BAL,PIT,8,2020,208,265,182,48,473,230,357.5,371.6666666666667,358.3333333333333,410.1666666666667,5,9,7,25
2020_08_SF_SEA,SEA,SF,8,2020,261,101,322,52,362,374,444.5,403.14285714285717,427.1944444444444,368.2857142857143,28,21,28,9
2020_08_TB_NYG,NYG,TB,8,2020,274,101,279,81,375,360,299.57142857142856,378.57142857142856,372.14285714285717,402.3428571428571,2,13,13,22
2020_08_TEN_CIN,CIN,TEN,8,2020,249,118,233,218,367,451,390.14285714285717,410.1666666666667,373,371.6666666666667,17,24,14,12
2020_09_BAL_IND,IND,BAL,9,2020,227,112,170,110,339,280,369.14285714285717,374,370.85714285714283,351.42857142857144,10,12,10,5
2020_09_CAR_KC,KC,CAR,9,2020,372,36,338,104,408,442,418.875,374.25,283.375,416.375,24,13,1,23
2020_09_CHI_TEN,TEN,CHI,9,2020,158,92,335,56,250,391,416,332,386.8367346938776,395.72916666666663,22,5,16,17
2020_09_DEN_ATL,ATL,DEN,9,2020,284,92,313,103,376,416,416.375,349.14285714285717,374.25,427,23,6,12,25
2020_09_DET_MIN,MIN,DET,9,2020,220,275,305,129,495,434,377.57142857142856,370.85714285714283,407.14285714285717,369.14285714285717,15,11,19,9
2020_09_GB_SF,SF,GB,9,2020,291,55,305,111,346,416,399.5,407.14285714285717,434.1875,377.57142857142856,20,21,26,14
2020_09_HOU_JAX,JAX,HOU,9,2020,304,115,281,107,419,388,361.57142857142856,384.14285714285717,414.85714285714283,409.1714285714285,8,17,22,21
2020_09_LV_LAC,LAC,LV,9,2020,326,128,165,160,454,325,427,389.57142857142856,349.14285714285717,351.57142857142856,27,18,4,6
2020_09_MIA_ARI,ARI,MIA,9,2020,283,178,248,91,461,339,424.57142857142856,331.85714285714283,440.40000000000003,407.51020408163265,26,4,28,20
2020_09_NE_NYJ,NYJ,NE,9,2020,262,65,274,159,327,433,283.375,364.7142857142857,418.875,382.0816326530612,1,9,24,15
2020_09_NO_TB,TB,NO,9,2020,209,8,282,138,217,420,376.25,395.85714285714283,309,332.73469387755097,14,19,2,3
2020_09_NYG_WAS,WAS,NYG,9,2020,387,37,212,166,424,378,317.85714285714283,309,438.7142857142857,376.25,3,2,27,13
2020_09_PIT_DAL,DAL,PIT,9,2020,243,144,309,46,387,355,423,351.42857142857144,357,374,25,7,7,11
2020_09_SEA_BUF,BUF,SEA,9,2020,415,34,390,57,449,447,382.875,432.7142857142857,364.77083333333337,398.97959183673476,16,28,8,18
2020_10_BAL_NE,NE,BAL,10,2020,142,173,249,115,315,364,373.25,362.25,288.828125,365.375,13,10,1,9
2020_10_BUF_ARI,ARI,BUF,10,2020,245,217,296,73,462,369,429.125,390.22222222222223,332.75,434.3015873015873,26,19,4,28
2020_10_CIN_PIT,PIT,CIN,10,2020,333,44,213,139,377,352,351.875,387.25,418.5,415.27083333333337,5,18,24,22
2020_10_DEN_LV,LV,DEN,10,2020,154,203,257,66,357,323,381.5,357.5,430.375,411.328125,15,8,27,21
2020_10_HOU_CLE,CLE,HOU,10,2020,132,231,163,90,363,253,354.25,384.625,391.02083333333337,368.75,6,17,14,10
2020_10_IND_TEN,TEN,IND,10,2020,147,157,308,133,304,441,395.25,365.375,339.375,362.25,22,11,6,8
2020_10_JAX_GB,GB,JAX,10,2020,325,80,169,109,405,278,408.25,368.75,392.8125,384.625,25,12,17,13
2020_10_LAC_MIA,MIA,LAC,10,2020,169,111,187,99,280,286,332.75,430.375,429.125,381.5,3,27,26,12
2020_10_MIN_CHI,CHI,MIN,10,2020,124,41,292,99,165,391,338.55555555555554,392.25,397.55555555555554,378.75,4,20,18,11
2020_10_PHI_NYG,NYG,PHI,10,2020,244,151,208,156,395,364,316.6666666666667,357,329.6507936507936,423,1,7,3,25
2020_10_SEA_LA,LA,SEA,10,2020,302,106,248,113,408,361,405.875,434.5,335.6875,391.140625,24,28,5,15
2020_10_SF_NO,NO,SF,10,2020,139,114,247,49,253,296,398.875,393.55555555555554,356.34375,408.12698412698415,23,21,7,20
2020_10_TB_CAR,CAR,TB,10,2020,148,65,341,210,213,551,381.77777777777777,358.55555555555554,417.6666666666667,398.53968253968253,16,9,23,19
2020_10_WAS_DET,DET,WAS,10,2020,276,105,390,89,381,479,378.75,331.125,392.25,317.625,14,2,16,2
2020_11_ARI_SEA,SEA,ARI,11,2020,197,165,269,57,362,326,426.3333333333333,432.77777777777777,406.1111111111111,387.8641975308642,27,28,25,24
2020_11_ATL_NO,NO,ATL,11,2020,233,166,232,52,399,284,382.6666666666667,411.8888888888889,382.71604938271605,356.5714285714286,17,23,21,9
2020_11_CIN_WAS,WAS,CIN,11,2020,166,164,233,70,330,303,347.55555555555554,383.3333333333333,379,354.6666666666667,3,18,19,7
2020_11_DAL_MIN,MIN,DAL,11,2020,314,125,203,180,439,383,392.1111111111111,419,319.2716049382716,351.82539682539687,20,26,1,5
2020_11_DET_CAR,CAR,DET,11,2020,258,116,178,40,374,218,364.9,379,377.8,347.55555555555554,10,16,17,4
2020_11_GB_IND,IND,GB,11,2020,288,140,311,66,428,377,373.77777777777777,407.8888888888889,385.1111111111111,358.6666666666667,13,22,23,10
2020_11_KC_LV,LV,KC,11,2020,275,89,352,108,364,460,378.77777777777777,417.6666666666667,353.6666666666667,381.77777777777777,15,25,6,20
2020_11_LA_TB,TB,LA,11,2020,216,42,376,37,258,413,377.8,406.1111111111111,364.9,426.3333333333333,14,21,12,28
2020_11_MIA_DEN,DEN,MIA,11,2020,270,189,200,56,459,256,353.6666666666667,326.8888888888889,378.77777777777777,414.3333333333333,4,2,18,27
2020_11_NE_HOU,HOU,NE,11,2020,344,55,365,86,399,451,370,366.77777777777777,355.22222222222223,362.44444444444446,12,11,8,11
2020_11_NYJ_LAC,LAC,NYJ,11,2020,366,29,205,96,395,301,414.3333333333333,288.22222222222223,326.8888888888889,372.3015873015873,24,1,3,15
2020_11_PHI_CLE,CLE,PHI,11,2020,204,135,235,106,339,341,355.22222222222223,357.77777777777777,370,325.3703703703704,6,7,14,2
2020_11_PIT_JAX,JAX,PIT,11,2020,151,73,267,106,224,373,358.6666666666667,354.6666666666667,407.8888888888889,383.3333333333333,8,5,26,22
2020_11_TEN_BAL,BAL,TEN,11,2020,186,129,266,173,315,439,362.44444444444446,385.1111111111111,366.77777777777777,373.77777777777777,9,19,13,16
2020_12_ARI_NE,NE,ARI,12,2020,84,110,170,138,194,308,375.2,422.1,372.9,419.9,16,32,14,29
2020_12_BAL_PIT,PIT,BAL,12,2020,266,68,110,129,334,239,356.5,357.7,345.2,390.5,9,10,3,21
2020_12_CAR_MIN,MIN,CAR,12,2020,307,96,267,107,403,374,396.8,365.72727272727275,415.4,364.3636363636364,24,13,28,11
2020_12_CHI_GB,GB,CHI,12,2020,211,182,242,121,393,363,404.8,321.2,379.2,392.125,26,3,18,22
2020_12_CLE_JAX,JAX,CLE,12,2020,235,140,258,207,375,465,345.2,353.6,356.5,356.1,5,7,7,6
2020_12_HOU_DET,DET,HOU,12,2020,295,109,318,77,404,395,362.9,372.9,365.81,375.2,11,15,12,15
2020_12_KC_TB,TB,KC,12,2020,345,75,462,87,420,549,366.90909090909093,421.9,406.73737373737373,377.3,14,31,26,17
2020_12_LAC_BUF,BUF,LAC,12,2020,177,172,316,76,349,392,388.1,412.4,432.4125,289.5,22,28,32,1
2020_12_LV_ATL,ATL,LV,12,2020,185,125,240,40,310,280,399.1,377.3,384.3,421.9,25,18,20,30
2020_12_MIA_NYJ,NYJ,MIA,12,2020,197,87,257,104,284,361,289.5,319.8,412.4,364.2,1,2,27,10
2020_12_NO_DEN,DEN,NO,12,2020,13,100,78,229,113,307,364.2,384.3,319.8,399.1,12,21,2,24
2020_12_NYG_CIN,CIN,NYG,12,2020,136,40,244,142,176,386,375.3,324.5,345.8,357.7,17,4,4,9
2020_12_SEA_PHI,PHI,SEA,12,2020,221,70,230,76,291,306,356.1,419.9,353.6,422.1,8,30,5,31
2020_12_SF_LA,LA,SF,12,2020,198,126,252,112,324,364,406.8,383.8,365.82000000000005,384.2875,27,20,13,19
2020_12_TEN_IND,IND,TEN,12,2020,295,56,221,229,351,450,379.2,390.5,404.8,357.7,19,23,25,9
2020_12_WAS_DAL,DAL,WAS,12,2020,215,60,177,182,275,359,415.4,345.8,396.8,375.3,29,6,23,16
2020_13_BUF_SF,SF,BUF,13,2020,316,86,375,81,402,456,382,384.54545454545456,399.27272727272725,410.54545454545456,19,20,25,29
2020_13_CIN_MIA,MIA,CIN,13,2020,296,110,193,40,406,233,323.54545454545456,357.1818181818182,289,330.09090909090907,2,11,1,4
2020_13_CLE_TEN,TEN,CLE,13,2020,389,62,340,118,451,458,395.90909090909093,363.72727272727275,376.6363636363636,347.90909090909093,22,13,19,8
2020_13_DAL_BAL,BAL,DAL,13,2020,107,294,285,111,401,396,346.90909090909093,402.6363636363636,354.45454545454544,347,6,25,10,7
2020_13_DEN_KC,KC,DEN,13,2020,318,134,151,179,452,330,433.45454545454544,341.3636363636364,371.73553719008265,377.27272727272725,30,5,17,20
2020_13_DET_CHI,CHI,DET,13,2020,267,140,402,60,407,462,325,366.6363636363636,403.72727272727275,374.90909090909093,3,14,27,18
2020_13_IND_HOU,HOU,IND,13,2020,341,90,285,109,431,394,374.90909090909093,376.6363636363636,366.6363636363636,395.90909090909093,16,17,15,24
2020_13_JAX_MIN,MIN,JAX,13,2020,305,145,280,124,450,404,397.3636363636364,347.90909090909093,366.4793388429752,363.72727272727275,23,8,14,13
2020_13_LA_ARI,ARI,LA,13,2020,173,92,351,119,265,470,411.72727272727275,399.27272727272725,358.72727272727275,382,29,24,12,21
2020_13_LV_NYJ,NYJ,LV,13,2020,186,206,381,72,392,453,289,368.45454545454544,323.54545454545456,391,1,15,2,23
2020_13_NE_LAC,LAC,NE,13,2020,209,70,130,165,279,295,410.54545454545456,358.72727272727275,384.54545454545456,411.72727272727275,28,12,22,30
2020_13_NO_ATL,ATL,NO,13,2020,273,70,232,207,343,439,391,377.27272727272725,368.45454545454544,341.3636363636364,21,18,16,5
2020_13_NYG_SEA,SEA,NYG,13,2020,263,111,105,190,374,295,409.54545454545456,330.09090909090907,350.1818181818182,357.1818181818182,27,4,9,11
2020_13_PHI_GB,GB,PHI,13,2020,295,149,188,117,444,305,403.72727272727275,350.1818181818182,325,409.54545454545456,26,9,3,28
2020_13_WAS_PIT,PIT,WAS,13,2020,305,21,296,45,326,341,354.45454545454544,347,346.90909090909093,402.6363636363636,10,7,6,26
2020_14_ARI_NYG,NYG,ARI,14,2020,145,78,244,159,223,403,327.16666666666663,399.5,406.5833333333333,405.1666666666667,2,24,29,28
2020_14_ATL_LAC,LAC,ATL,14,2020,243,105,263,70,348,333,399.5833333333333,387,353.4166666666667,382.4166666666667,25,22,12,18
2020_14_BAL_CLE,CLE,BAL,14,2020,355,138,176,231,493,407,371.5833333333333,351.4166666666667,400.5,402.0833333333333,15,9,25,27
2020_14_DAL_CIN,CIN,DAL,14,2020,222,101,185,101,323,286,346.8333333333333,402.0833333333333,330.4166666666667,351.4166666666667,8,28,3,9
2020_14_DEN_CAR,CAR,DEN,14,2020,283,125,280,96,408,376,366.4166666666667,340.4166666666667,397.31666666666666,435,13,5,22,32
2020_14_GB_DET,DET,GB,14,2020,273,51,290,120,324,410,374.5833333333333,407.0833333333333,331.8333333333333,346.4166666666667,16,31,4,6
2020_14_HOU_CHI,CHI,HOU,14,2020,267,169,219,108,436,327,331.8333333333333,379.5833333333333,374.5833333333333,378.0833333333333,4,19,14,16
2020_14_IND_LV,LV,IND,14,2020,345,79,244,212,424,456,375.5,378.0833333333333,297.5833333333333,379.5833333333333,17,18,1,17
2020_14_KC_MIA,MIA,KC,14,2020,316,80,393,94,396,487,330.4166666666667,435,346.8333333333333,340.4166666666667,3,32,8,5
2020_14_MIN_TB,TB,MIN,14,2020,196,107,225,162,303,387,371.3333333333333,401.75,432.4916666666666,352.5833333333333,14,27,31,11
2020_14_NE_LA,LA,NE,14,2020,137,186,146,107,323,253,405.1666666666667,353.4166666666667,399.5,399.5833333333333,29,12,23,24
2020_14_NO_PHI,PHI,NO,14,2020,167,246,291,96,413,387,346.4166666666667,382.4166666666667,407.0833333333333,387,6,20,30,20
2020_14_NYJ_SEA,SEA,NYJ,14,2020,239,174,132,69,413,201,406.5833333333333,297.5833333333333,327.16666666666663,375.5,30,1,2,15
2020_14_PIT_BUF,BUF,PIT,14,2020,238,104,187,47,342,234,390.5,352.0833333333333,383.6666666666667,346.5,23,10,19,7
2020_14_TEN_JAX,JAX,TEN,14,2020,263,91,212,249,354,461,352.5833333333333,400.5,401.75,371.5833333333333,11,26,26,13
2020_14_WAS_SF,SF,WAS,14,2020,260,108,108,98,368,206,383.6666666666667,346.5,390.5,352.0833333333333,21,7,21,10
2020_15_BUF_DEN,DEN,BUF,15,2020,132,140,359,182,272,541,343.15384615384613,386.7692307692308,369.61538461538464,343,7,23,14,6
2020_15_CAR_GB,GB,CAR,15,2020,143,195,258,115,338,373,407.3076923076923,369.61538461538464,370.6923076923077,343.15384615384613,31,14,15,7
2020_15_CHI_MIN,MIN,CHI,15,2020,271,158,202,199,429,401,400.61538461538464,339.84615384615387,366.0769230769231,375.53846153846155,28,5,13,16
2020_15_CLE_NYG,NYG,CLE,15,2020,221,74,297,106,295,403,319.15384615384613,380.9230769230769,399.7692307692308,355.6923076923077,2,18,27,12
2020_15_DET_TEN,TEN,DET,15,2020,273,195,307,123,468,430,405.15384615384613,370.6923076923077,352.6923076923077,407.3076923076923,29,15,11,31
2020_15_HOU_IND,IND,HOU,15,2020,228,127,373,83,355,456,384.0769230769231,375.53846153846155,379.2307692307692,339.84615384615387,22,16,17,5
2020_15_JAX_BAL,BAL,JAX,15,2020,250,158,226,62,408,288,355.6923076923077,352.6923076923077,380.9230769230769,405.15384615384613,12,11,18,29
2020_15_KC_NO,NO,KC,15,2020,234,60,254,167,294,421,382.7692307692308,439,351.53846153846155,335.46153846153845,20,32,10,3
2020_15_LAC_LV,LV,LAC,15,2020,279,173,314,96,452,410,379.2307692307692,395.61538461538464,384.0769230769231,382.84615384615387,17,25,22,21
2020_15_NE_MIA,MIA,NE,15,2020,145,250,209,117,395,326,335.46153846153845,345.6923076923077,439,398.84615384615387,3,9,32,26
2020_15_NYJ_LA,LA,NYJ,15,2020,209,114,207,93,323,300,398.84615384615387,290.15384615384613,345.6923076923077,407.0769230769231,26,1,9,30
2020_15_PHI_ARI,ARI,PHI,15,2020,432,103,338,117,535,455,399.7692307692308,351.53846153846155,319.15384615384613,382.7692307692308,27,10,2,20
2020_15_PIT_CIN,CIN,PIT,15,2020,89,152,170,86,241,256,345,343,393.15384615384613,386.7692307692308,8,6,24,23
2020_15_SEA_WAS,WAS,SEA,15,2020,295,84,121,181,379,302,335.6923076923077,407.0769230769231,382.46153846153845,290.15384615384613,4,30,19,1
2020_15_SF_DAL,DAL,SF,15,2020,221,87,319,150,308,469,393.15384615384613,382.46153846153845,345,335.6923076923077,24,19,8,4
2020_15_TB_ATL,ATL,TB,15,2020,356,37,390,51,393,441,382.84615384615387,366.0769230769231,395.61538461538464,400.61538461538464,21,13,25,28
2020_16_ATL_KC,KC,ATL,16,2020,278,117,300,90,395,390,437.7142857142857,383.57142857142856,376.42857142857144,371.42857142857144,32,20,16,14
2020_16_BUF_NE,NE,BUF,16,2020,78,145,344,130,223,474,344.2857142857143,397.7857142857143,339.7142857142857,338.07142857142856,9,26,7,5
2020_16_CAR_WAS,WAS,CAR,16,2020,291,108,197,113,399,310,338.7857142857143,369.85714285714283,399.57142857142856,402.35714285714283,6,13,27,28
2020_16_CHI_JAX,JAX,CHI,16,2020,211,76,265,128,287,393,348.07142857142856,344.2142857142857,359.42857142857144,402.64285714285717,10,8,12,29
2020_16_CIN_HOU,HOU,CIN,16,2020,324,166,371,169,490,540,381.2857142857143,337.57142857142856,382,336.7857142857143,17,4,18,3
2020_16_CLE_NYJ,NYJ,CLE,16,2020,218,131,285,45,349,330,290.85714285714283,382.5,393.42857142857144,317.42857142857144,1,19,24,2
2020_16_DEN_LAC,LAC,DEN,16,2020,253,89,264,133,342,397,396.64285714285717,338.07142857142856,384.42857142857144,397.7857142857143,25,5,21,26
2020_16_IND_PIT,PIT,IND,16,2020,341,22,270,127,363,397,336.7857142857143,382,337.57142857142856,381.2857142857143,3,18,4,17
2020_16_LA_SEA,SEA,LA,16,2020,225,95,234,118,320,352,399.57142857142856,393.42857142857144,338.7857142857143,290.85714285714283,27,24,6,1
2020_16_MIA_LV,LV,MIA,16,2020,336,104,276,130,440,406,384.42857142857144,339.7142857142857,396.64285714285717,344.2857142857143,21,7,25,9
2020_16_MIN_NO,NO,MIN,16,2020,319,264,291,90,583,381,376.42857142857144,402.64285714285717,437.7142857142857,344.2142857142857,16,29,32,8
2020_16_NYG_BAL,BAL,NYG,16,2020,183,249,252,54,432,306,359.42857142857144,317.42857142857144,348.07142857142856,382.5,12,2,10,19
2020_16_PHI_DAL,DAL,PHI,16,2020,377,151,342,151,528,493,387.07142857142856,358.92857142857144,388.64285714285717,409.42857142857144,22,11,23,30
2020_16_SF_ARI,ARI,SF,16,2020,247,120,182,227,367,409,409.42857142857144,388.64285714285717,358.92857142857144,387.07142857142856,30,23,11,22
2020_16_TB_DET,DET,TB,16,2020,152,73,491,111,225,602,374.92857142857144,371.42857142857144,409.64285714285717,383.57142857142856,15,14,31,20
2020_16_TEN_GB,GB,TEN,16,2020,231,234,121,156,465,277,402.35714285714283,409.64285714285717,369.85714285714283,374.92857142857144,28,31,13,15
2020_17_ARI_LA,LA,ARI,17,2020,231,110,192,48,341,240,390.6666666666667,406.6,394.26666666666665,390,23,31,25,21
2020_17_ATL_TB,TB,ATL,17,2020,399,94,265,127,493,392,386.8,384,364.93333333333334,434.8666666666667,18,17,12,32
2020_17_BAL_CIN,CIN,BAL,17,2020,48,147,121,404,195,525,351.06666666666666,364.26666666666665,388.53333333333336,316.6666666666667,10,11,20,2
2020_17_DAL_NYG,NYG,DAL,17,2020,229,125,244,108,354,352,316.6666666666667,396.46666666666664,364.26666666666665,367.8666666666667,2,26,11,14
2020_17_GB_CHI,CHI,GB,17,2020,252,108,240,79,360,319,347.46666666666664,406.53333333333336,344,400.8,9,30,7,27
2020_17_JAX_IND,IND,JAX,17,2020,164,273,261,53,437,314,383,344,338.53333333333336,347.46666666666664,16,7,4,9
2020_17_LAC_KC,KC,LAC,17,2020,218,51,302,135,269,437,434.8666666666667,393,384,342,32,24,17,5
2020_17_LV_DEN,DEN,LV,17,2020,339,122,371,106,461,477,342,388.1333333333333,393,344.1333333333333,5,19,24,8
2020_17_MIA_BUF,BUF,MIA,17,2020,388,78,393,70,466,463,402.8666666666667,344.1333333333333,336.2,388.1333333333333,29,8,3,19
2020_17_MIN_DET,DET,MIN,17,2020,293,129,405,125,422,530,364.93333333333334,401.2,386.8,390.2,12,28,18,22
2020_17_NO_CAR,CAR,NO,17,2020,271,74,201,156,345,357,365.8666666666667,390.2,342.8,401.2,13,22,6,28
2020_17_NYJ_NE,NE,NYJ,17,2020,261,166,266,111,427,377,336.2,294.73333333333335,402.8666666666667,379,3,1,29,15
2020_17_PIT_CLE,CLE,PIT,17,2020,196,192,317,85,388,402,379,338.53333333333336,294.73333333333335,383,15,4,1,16
2020_17_SEA_SF,SF,SEA,17,2020,273,86,181,121,359,302,390,394.26666666666665,406.6,390.6666666666667,21,25,31,23
2020_17_TEN_HOU,HOU,TEN,17,2020,385,96,216,288,481,504,388.53333333333336,400.8,351.06666666666666,406.53333333333336,20,27,10,30
2020_17_WAS_PHI,PHI,WAS,17,2020,119,118,162,103,237,265,367.8666666666667,342.8,396.46666666666664,365.8666666666667,14,6,26,13
2020_18_BAL_TEN,TEN,BAL,18,2020,165,51,179,236,216,415,407.25,374.3125,394.3125,341.3125,12,4,10,1
2020_18_CHI_NO,NO,CHI,18,2020,265,123,199,48,388,247,388.125,348.25,364.5625,401.0625,8,3,6,12
2020_18_CLE_PIT,PIT,CLE,18,2020,501,52,263,127,553,390,342.5,379.5625,379.5625,342.5,2,5,7,3
2020_18_IND_BUF,BUF,IND,18,2020,324,96,309,163,420,472,406.8125,386.375,351.5625,342.125,11,6,4,2
2020_18_LA_SEA,SEA,LA,18,2020,174,136,184,164,310,348,388.5,387.5625,388.0625,396.1875,9,7,9,11
2020_18_TB_WAS,WAS,TB,18,2020,306,86,381,142,392,523,337.9375,393.4375,359.6875,384.5,1,10,5,8
2020_19_BAL_BUF,BUF,BAL,19,2020,206,32,222,150,238,372,407.5882352941176,376.70588235294116,391.4117647058824,396,7,1,6,8
2020_19_CLE_KC,KC,CLE,19,2020,321,123,204,112,444,316,424.5,380.1764705882353,395.75,354.88235294117646,8,2,7,4
2020_19_LA_GB,GB,LA,19,2020,296,188,174,96,484,270,401.0625,385.2352941176471,348.25,383.88235294117646,6,3,3,5
2020_19_TB_NO,NO,TB,19,2020,190,104,199,127,294,326,388.11764705882354,401.05882352941177,342.29411764705884,341.11764705882354,4,5,2,1
2020_20_BUF_KC,KC,BUF,20,2020,325,114,287,129,439,416,425.6470588235294,398.1666666666667,376.401384083045,376.44444444444446,4,2,1,2
2020_20_TB_GB,GB,TB,20,2020,346,67,280,76,413,356,405.94117647058823,396.8888888888889,378.4567474048443,382.8888888888889,3,1,3,4
2020_21_KC_TB,TB,KC,21,2020,201,145,270,107,346,377,394.7368421052632,426.3888888888889,406.312693498452,399.15740740740745,1,2,2,1
2021_01_ARI_TEN,TEN,ARI,1,2021,218,86,289,136,304,425,0,0,0,0,32,32,32,32
2021_01_BAL_LV,LV,BAL,1,2021,435,82,235,189,517,424,0,0,0,0,32,32,32,32
2021_01_CHI_LA,LA,CHI,1,2021,321,74,216,134,395,350,0,0,0,0,32,32,32,32
2021_01_CLE_KC,KC,CLE,1,2021,337,73,321,153,410,474,0,0,0,0,32,32,32,32
2021_01_DAL_TB,TB,DAL,1,2021,379,52,403,60,431,463,0,0,0,0,32,32,32,32
2021_01_DEN_NYG,NYG,DEN,1,2021,267,60,264,165,327,429,0,0,0,0,32,32,32,32
2021_01_GB_NO,NO,GB,1,2021,151,171,201,43,322,244,0,0,0,0,32,32,32,32
2021_01_JAX_HOU,HOU,JAX,1,2021,291,160,332,76,451,408,0,0,0,0,32,32,32,32
2021_01_LAC_WAS,WAS,LAC,1,2021,135,126,337,90,261,427,0,0,0,0,32,32,32,32
2021_01_MIA_NE,NE,MIA,1,2021,281,125,202,74,406,276,0,0,0,0,32,32,32,32
2021_01_MIN_CIN,CIN,MIN,1,2021,261,149,362,67,410,429,0,0,0,0,32,32,32,32
2021_01_NYJ_CAR,CAR,NYJ,1,2021,279,111,258,45,390,303,0,0,0,0,32,32,32,32
2021_01_PHI_ATL,ATL,PHI,1,2021,164,124,264,173,288,437,0,0,0,0,32,32,32,32
2021_01_PIT_BUF,BUF,PIT,1,2021,270,117,188,75,387,263,0,0,0,0,32,32,32,32
2021_01_SEA_IND,IND,SEA,1,2021,251,113,254,140,364,394,0,0,0,0,32,32,32,32
2021_01_SF_DET,DET,SF,1,2021,338,116,319,131,454,450,0,0,0,0,32,32,32,32
2021_02_ATL_TB,TB,ATL,2,2021,276,82,300,55,358,355,431,288,463,437,25,5,30,26
2021_02_BUF_MIA,MIA,BUF,2,2021,182,71,179,143,253,322,276,387,406,263,4,12,16,3
2021_02_CIN_CHI,CHI,CIN,2,2021,116,123,207,69,239,276,350,410,395,429,10,19,15,24
2021_02_DAL_LAC,LAC,DAL,2,2021,338,95,237,198,433,435,427,463,261,431,22,30,2,25
2021_02_DEN_JAX,JAX,DEN,2,2021,118,75,328,96,193,424,408,429,451,327,17,24,28,9
2021_02_DET_GB,GB,DET,2,2021,255,96,246,108,351,354,244,454,322,450,1,29,8,27
2021_02_HOU_CLE,CLE,HOU,2,2021,213,156,227,82,369,309,474,451,410,408,31,28,19,17
2021_02_KC_BAL,BAL,KC,2,2021,239,251,343,62,490,405,424,410,517,474,20,19,32,31
2021_02_LA_IND,IND,LA,2,2021,272,109,278,101,381,379,364,395,394,350,11,15,14,10
2021_02_LV_PIT,PIT,LV,2,2021,295,39,382,52,334,434,263,517,387,424,3,32,12,20
2021_02_MIN_ARI,ARI,MIN,2,2021,400,103,244,177,503,421,425,429,304,410,21,24,7,19
2021_02_NE_NYJ,NYJ,NE,2,2021,210,152,186,101,362,287,303,406,390,276,6,16,13,4
2021_02_NO_CAR,CAR,NO,2,2021,305,89,111,48,394,159,390,322,303,244,13,8,6,1
2021_02_NYG_WAS,WAS,NYG,2,2021,336,87,249,163,423,412,261,327,427,429,2,9,22,24
2021_02_SF_PHI,PHI,SF,2,2021,190,151,189,117,341,306,437,450,288,454,26,27,5,29
2021_02_TEN_SEA,SEA,TEN,2,2021,343,77,347,212,420,559,394,304,364,425,14,7,11,21
2021_03_ARI_JAX,JAX,ARI,3,2021,219,159,316,91,378,407,300.5,464,426.5,425,6,31,26,25
2021_03_ATL_NYG,NYG,ATL,3,2021,266,100,243,69,366,312,369.5,321.5,342,394.5,13,7,9,20
2021_03_BAL_DET,DET,BAL,3,2021,217,93,287,116,310,403,404,457,297.5,407.5,21,30,4,23
2021_03_CAR_HOU,HOU,CAR,3,2021,168,42,304,117,210,421,380,392,421.5,240.5,16,19,24,1
2021_03_CHI_CLE,CLE,CHI,3,2021,246,215,68,46,461,114,421.5,294.5,380,343,24,3,16,10
2021_03_CIN_PIT,PIT,CIN,3,2021,318,45,172,96,363,268,298.5,343,475.5,294.5,5,10,32,3
2021_03_GB_SF,SF,GB,3,2021,257,63,261,100,320,361,378,297.5,389,404,15,4,18,21
2021_03_IND_TEN,TEN,IND,3,2021,197,180,194,87,377,281,431.5,372.5,407,387,28,14,22,17
2021_03_LAC_KC,KC,LAC,3,2021,260,186,281,77,446,358,407.5,430,457,449,23,27,30,29
2021_03_MIA_LV,LV,MIA,3,2021,386,140,215,133,526,348,475.5,264.5,298.5,354.5,32,2,5,12
2021_03_NO_NE,NE,NO,3,2021,270,49,128,142,319,270,346.5,240.5,332.5,392,11,1,8,19
2021_03_NYJ_DEN,DEN,NYJ,3,2021,235,120,160,43,355,203,426.5,332.5,300.5,346.5,26,8,6,11
2021_03_PHI_DAL,DAL,PHI,3,2021,238,160,326,64,398,390,449,389,430,378,29,18,27,15
2021_03_SEA_MIN,MIN,SEA,3,2021,323,140,298,106,463,404,425,407,464,431.5,25,22,31,28
2021_03_TB_LA,LA,TB,3,2021,343,76,432,35,419,467,387,394.5,372.5,321.5,17,20,14,7
2021_03_WAS_BUF,BUF,WAS,3,2021,359,122,212,78,481,290,354.5,342,264.5,369.5,12,9,2,13
2021_04_ARI_LA,LA,ARI,4,2021,280,121,268,216,401,484,397.6666666666667,445,418.6666666666667,326.3333333333333,19,31,25,11
2021_04_BAL_DEN,DEN,BAL,4,2021,178,106,316,102,284,418,402.6666666666667,439,289.3333333333333,372.6666666666667,21,30,3,16
2021_04_CAR_DAL,DAL,CAR,4,2021,188,230,301,113,418,414,432,401.6666666666667,389.3333333333333,323.3333333333333,27,20,17,9
2021_04_CLE_MIN,MIN,CLE,4,2021,203,65,155,184,268,339,437.6666666666667,434.6666666666667,406,234.33333333333334,29,28,23,1
2021_04_DET_CHI,CHI,DET,4,2021,209,188,299,90,397,389,234.33333333333334,372.6666666666667,434.6666666666667,439,1,16,28,30
2021_04_HOU_BUF,BUF,HOU,4,2021,256,199,87,48,455,135,396.6666666666667,323.3333333333333,324.6666666666667,401.6666666666667,18,9,10,20
2021_04_IND_MIA,MIA,IND,4,2021,199,35,228,139,234,367,292.3333333333333,342,492.3333333333333,413.3333333333333,4,13,32,24
2021_04_JAX_CIN,CIN,JAX,4,2021,348,78,204,139,426,343,318,326.3333333333333,320,445,5,11,8,31
2021_04_KC_PHI,PHI,KC,4,2021,387,103,278,200,490,478,389.3333333333333,420.3333333333333,432,406,17,26,27,23
2021_04_LV_LAC,LAC,LV,4,2021,222,168,196,48,390,244,406,492.3333333333333,420.3333333333333,292.3333333333333,23,32,26,4
2021_04_NYG_NO,NO,NYG,4,2021,235,170,402,83,405,485,250.33333333333334,368.3333333333333,337.3333333333333,318.3333333333333,2,15,12,6
2021_04_PIT_GB,GB,PIT,4,2021,248,131,232,62,379,294,318.6666666666667,320,358.6666666666667,318,7,8,14,5
2021_04_SEA_SF,SF,SEA,4,2021,322,143,149,105,465,254,358.6666666666667,406,318.6666666666667,437.6666666666667,14,23,7,29
2021_04_TB_NE,NE,TB,4,2021,320,-1,269,120,319,389,337.3333333333333,418.6666666666667,250.33333333333334,397.6666666666667,12,25,2,19
2021_04_TEN_NYJ,NYJ,TEN,4,2021,297,66,298,177,363,475,289.3333333333333,413.3333333333333,402.6666666666667,342,3,24,21,13
2021_04_WAS_ATL,ATL,WAS,4,2021,283,99,290,122,382,412,318.3333333333333,324.6666666666667,368.3333333333333,396.6666666666667,6,10,15,18
2021_05_BUF_KC,KC,BUF,5,2021,272,120,315,121,392,436,434.75,411.25,414.5,276.25,31,25,26,2
2021_05_CHI_LV,LV,CHI,5,2021,206,71,119,143,277,262,430.25,275,402,376.75,29,1,21,16
2021_05_CLE_LAC,LAC,CLE,5,2021,398,112,305,230,510,535,402,410.75,430.25,395.25,21,23,29,18
2021_05_DEN_PIT,PIT,DEN,5,2021,253,147,288,106,400,394,313.5,373,333.75,433.75,6,15,9,30
2021_05_DET_MIN,MIN,DET,5,2021,275,120,203,108,395,311,395.25,376.75,410.75,275,18,16,23,1
2021_05_GB_CIN,CIN,GB,5,2021,281,103,344,133,384,477,345,333.75,330.5,313.5,11,9,7,6
2021_05_IND_BAL,BAL,IND,5,2021,442,86,402,123,528,525,433.75,348.25,373,277.75,30,13,15,3
2021_05_LA_SEA,SEA,LA,5,2021,283,92,365,118,375,483,368,398.5,385.25,454.75,14,20,17,32
2021_05_MIA_TB,TB,MIA,5,2021,452,121,275,39,573,314,411.25,277.75,332.75,348.25,25,3,8,13
2021_05_NE_HOU,HOU,NE,5,2021,312,67,231,126,379,357,276.25,332.75,411.25,411.25,2,8,25,25
2021_05_NO_WAS,WAS,NO,5,2021,248,131,279,98,379,377,346.5,289,334.25,397.5,12,4,10,19
2021_05_NYG_DAL,DAL,NYG,5,2021,324,201,294,73,525,367,428.5,397.5,404.75,289,27,19,22,4
2021_05_NYJ_ATL,ATL,NYJ,5,2021,342,108,192,64,450,256,334.25,307.75,346.5,428.75,10,5,12,28
2021_05_PHI_CAR,CAR,PHI,5,2021,177,109,198,91,286,289,404.75,414.5,428.5,434.75,22,26,27,31
2021_05_SF_ARI,ARI,SF,5,2021,239,94,192,152,333,344,454.75,385.25,398.5,368,32,17,20,14
2021_05_TEN_JAX,JAX,TEN,5,2021,273,198,197,184,471,381,330.5,428.75,345,307.75,7,28,11,5
2021_06_ARI_CLE,CLE,ARI,6,2021,240,73,229,144,313,373,435.6,430.4,423.6,377,25,24,23,12
2021_06_BUF_TEN,TEN,BUF,6,2021,216,146,353,82,362,435,419.2,416.2,358.6,426.2,21,20,8,24
2021_06_CIN_DET,DET,CIN,6,2021,202,36,278,142,238,420,363.6,352.8,395.2,362.4,10,6,18,9
2021_06_DAL_NE,NE,DAL,6,2021,229,120,445,122,349,567,337.6,447.8,296.8,391.4,5,27,3,17
2021_06_GB_CHI,CHI,GB,6,2021,174,140,195,154,314,349,272.4,362.4,399.6,352.8,1,9,19,7
2021_06_HOU_IND,IND,HOU,6,2021,223,174,243,124,397,367,383.6,296.8,452.6,337.6,14,3,28,6
2021_06_KC_WAS,WAS,KC,6,2021,182,94,397,109,276,506,353,426.2,306.6,416.2,7,23,4,21
2021_06_LA_NYG,NYG,LA,6,2021,242,60,251,131,302,382,391.4,415.4,447.8,369.4,16,19,27,11
2021_06_LAC_BAL,BAL,LAC,6,2021,167,187,195,26,354,221,452.6,423.6,383.6,435.6,28,22,15,25
2021_06_LV_DEN,DEN,LV,6,2021,334,112,341,86,446,427,377.2,399.6,330.8,272.4,12,18,5,1
2021_06_MIA_JAX,JAX,MIA,6,2021,319,84,354,77,403,431,358.6,285,419.2,443.6,8,2,22,26
2021_06_MIN_CAR,CAR,MIN,6,2021,207,118,373,198,325,571,381,395.2,389.4,363.6,13,17,16,10
2021_06_SEA_PIT,PIT,SEA,6,2021,229,119,209,144,348,353,330.8,369.4,377.2,415.4,4,11,13,20
2021_06_TB_PHI,PHI,TB,6,2021,115,100,297,102,215,399,389.4,443.6,381,285,15,26,14,2
2021_07_ATL_MIA,MIA,ATL,7,2021,291,132,336,72,423,408,309.3333333333333,357.4,366,297.4,5,9,12,2
2021_07_CAR_NYG,NYG,CAR,7,2021,219,103,145,56,322,201,376.5,371.6666666666667,409.8333333333333,424.5,15,14,18,22
2021_07_CHI_TB,TB,CHI,7,2021,226,182,184,143,408,327,436.1666666666667,279.3333333333333,360.3333333333333,360.1666666666667,25,1,10,9
2021_07_CIN_BAL,BAL,CIN,7,2021,296,115,416,111,411,527,436.1666666666667,364,389.8333333333333,342.6666666666667,25,12,16,6
2021_07_DEN_CLE,CLE,DEN,7,2021,199,182,187,41,381,228,415.1666666666667,388.6666666666667,420.8333333333333,404.1666666666667,22,18,21,17
2021_07_DET_LA,LA,DET,7,2021,334,47,285,137,381,422,409.8333333333333,342.6666666666667,376.5,364,21,8,13,11
2021_07_HOU_ARI,ARI,HOU,7,2021,261,172,135,42,433,177,420.8333333333333,308.5,415.1666666666667,385.8333333333333,23,4,19,14
2021_07_IND_SF,SF,IND,7,2021,181,111,150,148,292,298,377,385.8333333333333,430.4,308.5,16,17,23,3
2021_07_KC_TEN,TEN,KC,7,2021,275,103,288,77,378,365,409.6666666666667,439.5,419.3333333333333,340.1666666666667,20,26,20,5
2021_07_NO_SEA,SEA,NO,7,2021,167,90,222,94,257,316,366.6666666666667,306.6,333.6666666666667,353,13,3,4,7
2021_07_NYJ_NE,NE,NYJ,7,2021,411,148,253,62,559,315,339.5,297.4,467.6666666666667,357.4,6,2,26,8
2021_07_PHI_LV,LV,PHI,7,2021,323,119,236,135,442,371,404.1666666666667,360.3333333333333,388.6666666666667,436.1666666666667,19,11,15,24
2021_07_WAS_GB,GB,WAS,7,2021,274,57,268,195,331,463,360.1666666666667,340.1666666666667,279.3333333333333,439.5,10,7,1,25
2021_08_CAR_ATL,ATL,CAR,8,2021,146,82,129,203,228,332,365.8333333333333,347.2857142857143,328.27777777777777,368.7142857142857,15,7,6,17
2021_08_CIN_NYJ,NYJ,CIN,8,2021,422,97,305,41,519,346,300.3333333333333,387.2857142857143,376.0833333333333,432.57142857142856,3,20,20,29
2021_08_DAL_MIN,MIN,DAL,8,2021,184,101,360,78,285,438,424.5,467.6666666666667,371.6666666666667,339.5,27,30,19,7
2021_08_GB_ARI,ARI,GB,8,2021,274,74,184,151,348,335,422.57142857142856,356,289.7142857142857,357.7142857142857,26,10,2,12
2021_08_JAX_SEA,SEA,JAX,8,2021,195,69,238,82,264,320,351,366,307.9428571428572,309.3333333333333,8,16,4,5
2021_08_LA_HOU,HOU,LA,8,2021,310,44,310,165,354,475,289.7142857142857,405.7142857142857,422.57142857142856,354,2,23,26,10
2021_08_MIA_BUF,BUF,MIA,8,2021,249,102,205,68,351,273,419.3333333333333,325.57142857142856,409.6666666666667,364.6285714285714,25,5,24,13
2021_08_NE_LAC,LAC,NE,8,2021,223,163,217,142,386,359,389.8333333333333,370.85714285714283,436.1666666666667,299.91428571428565,21,18,30,3
2021_08_NYG_KC,KC,NYG,8,2021,275,107,241,72,382,313,428.85714285714283,368.7142857142857,405.14285714285717,347.2857142857143,28,17,21,8
2021_08_PHI_DET,DET,PHI,8,2021,222,57,114,236,279,350,354,361.85714285714283,405.7142857142857,409.57142857142856,9,12,22,23
2021_08_PIT_CLE,CLE,PIT,8,2021,225,96,266,115,321,381,410.2857142857143,333.6666666666667,365.7142857142857,366.6666666666667,24,6,15,16
2021_08_SF_CHI,CHI,SF,8,2021,175,176,322,145,351,467,286.14285714285717,362.8333333333333,432.14285714285717,371.1944444444444,1,13,28,18
2021_08_TB_NO,NO,TB,8,2021,215,152,375,71,367,446,308.1666666666667,432.14285714285717,348.3888888888889,286.14285714285717,4,29,9,1
2021_08_TEN_IND,IND,TEN,8,2021,231,83,265,93,314,358,373.2857142857143,405.14285714285717,364.85714285714283,428.85714285714283,19,22,14,27
2021_08_WAS_DEN,DEN,WAS,8,2021,213,83,270,112,296,382,365.7142857142857,357.7142857142857,410.2857142857143,356,14,11,25,11
2021_09_ARI_SF,SF,ARI,9,2021,326,39,282,163,365,445,377.7142857142857,413.25,295.40816326530614,353.375,16,24,1,10
2021_09_ATL_NO,NO,ATL,9,2021,282,109,343,34,391,377,316.57142857142856,346.14285714285717,434.12244897959187,345.10204081632656,3,8,27,8
2021_09_BUF_JAX,JAX,BUF,9,2021,151,79,264,72,230,336,359.42857142857144,409.57142857142856,338.57142857142856,318.06122448979596,11,23,5,3
2021_09_CHI_PIT,PIT,CHI,9,2021,205,105,291,136,310,427,340.42857142857144,294.25,397.53061224489795,375.85416666666663,6,1,20,16
2021_09_CLE_CIN,CIN,CLE,9,2021,288,85,218,153,373,371,382.125,399.125,327.66666666666663,339.58333333333337,17,19,4,6
2021_09_DEN_DAL,DAL,DEN,9,2021,232,78,249,190,310,439,463.42857142857144,357,404.57142857142856,360.75,28,10,22,11
2021_09_GB_KC,KC,GB,9,2021,166,77,190,122,243,312,423,353.375,361.75,413.25,26,9,12,24
2021_09_HOU_MIA,MIA,HOU,9,2021,244,47,240,73,291,313,319,297.75,410.79166666666663,414.375,4,2,23,25
2021_09_LAC_PHI,PHI,LAC,9,2021,162,176,356,89,338,445,360.375,389.2857142857143,344.625,369.1632653061224,12,18,7,15
2021_09_LV_NYG,NYG,LV,9,2021,110,149,296,117,259,413,361.75,409.57142857142856,423,361.85714285714283,13,23,26,13
2021_09_MIN_BAL,BAL,MIN,9,2021,266,247,187,131,513,318,432.57142857142856,404.57142857142856,387.2857142857143,463.42857142857144,27,21,18,28
2021_09_NE_CAR,CAR,NE,9,2021,172,78,139,151,250,290,345.375,369.375,348.60416666666663,389.35416666666663,7,15,9,19
2021_09_NYJ_IND,IND,NYJ,9,2021,272,260,412,88,532,500,365.875,331.57142857142856,399.25,381.38775510204084,14,5,21,17
2021_09_TEN_LA,LA,TEN,9,2021,294,94,143,69,388,212,414.375,399.25,297.75,365.875,25,20,2,14
2021_10_ATL_DAL,DAL,ATL,10,2021,317,114,131,103,431,234,444.25,350,367.25,325.875,28,9,16,4
2021_10_BAL_MIA,MIA,BAL,10,2021,314,60,238,94,374,332,315.8888888888889,442.625,299.44444444444446,393.75,1,27,1,21
2021_10_BUF_NYJ,NYJ,BUF,10,2021,298,70,366,139,368,505,352.625,400.375,386.640625,343.25,10,21,20,6
2021_10_CAR_ARI,ARI,CAR,10,2021,143,65,175,166,208,341,416.77777777777777,334.77777777777777,376.3015873015873,360.55555555555554,25,3,17,15
2021_10_CLE_NE,NE,CLE,10,2021,283,184,154,99,467,253,360.55555555555554,396,334.77777777777777,381.1111111111111,12,19,5,19
2021_10_DET_PIT,PIT,DET,10,2021,242,145,114,229,387,343,336.625,344.625,310.84375,360.375,4,7,2,14
2021_10_JAX_IND,IND,JAX,10,2021,180,127,162,179,307,341,384.3333333333333,343.25,350.2857142857143,400.375,17,6,10,23
2021_10_KC_LV,LV,KC,10,2021,261,50,422,94,311,516,410,403,348.90625,348.77777777777777,23,22,8,7
2021_10_LA_SF,SF,LA,10,2021,182,156,245,52,338,297,376.125,411.44444444444446,417.21875,378.44444444444446,15,24,26,18
2021_10_MIN_LAC,LAC,MIN,10,2021,195,82,294,103,277,397,396.25,393.75,357.578125,442.625,20,18,12,27
2021_10_NO_TEN,TEN,NO,10,2021,213,66,309,86,279,395,378.44444444444446,325.875,411.44444444444446,350,16,2,25,9
2021_10_PHI_DEN,DEN,PHI,10,2021,226,96,178,216,322,394,366.1111111111111,357.8888888888889,446.3809523809524,395.4761904761905,14,11,28,22
2021_10_SEA_GB,GB,SEA,10,2021,292,106,161,75,398,236,348.77777777777777,340.125,403,360.25,8,5,24,13
2021_10_TB_WAS,WAS,TB,10,2021,256,94,220,53,350,273,360.75,433.875,357,315.52083333333337,13,26,11,3
2021_11_ARI_SEA,SEA,ARI,11,2021,207,86,328,95,293,423,328.55555555555554,395.9,354.2469135802469,335.4,4,24,11,5
2021_11_BAL_CHI,CHI,BAL,11,2021,280,92,219,123,372,342,309,430.3333333333333,337.04761904761904,322.3456790123457,2,29,6,2
2021_11_CIN_LV,LV,CIN,11,2021,215,72,148,159,287,307,399,381.1111111111111,415.55555555555554,396,25,20,27,22
2021_11_DAL_KC,KC,DAL,11,2021,260,126,216,82,386,298,414.3,442.77777777777777,400.1,337.1111111111111,27,30,24,7
2021_11_DET_CLE,CLE,DET,11,2021,176,184,77,168,360,245,381.7,344.44444444444446,371.2,342.22222222222223,21,10,16,8
2021_11_GB_MIN,MIN,GB,11,2021,341,90,385,95,431,480,394.1111111111111,353.7,383,329.7125,23,12,19,3
2021_11_HOU_TEN,TEN,HOU,11,2021,323,103,107,83,426,190,368.5,299.44444444444446,332.7875,315.8888888888889,16,1,4,1
2021_11_IND_BUF,BUF,IND,11,2021,228,91,106,264,319,370,412,376.6,354.3333333333333,343.025,26,19,12,9
2021_11_MIA_NYJ,NYJ,MIA,11,2021,291,102,273,115,393,388,354.3333333333333,321.7,412,431.5625,13,3,26,29
2021_11_NE_ATL,ATL,NE,11,2021,158,40,207,134,198,341,337.1111111111111,371.2,442.77777777777777,381.7,7,17,30,18
2021_11_NO_PHI,PHI,NO,11,2021,147,242,214,109,389,323,361.5,333.55555555555554,361.7,367.3950617283951,15,5,14,15
2021_11_NYG_TB,TB,NYG,11,2021,318,94,167,66,412,233,416,350.3333333333333,359.55555555555554,409.95238095238096,28,11,13,25
2021_11_PIT_LAC,LAC,PIT,11,2021,382,159,273,55,541,328,383,342.22222222222223,394.1111111111111,344.44444444444446,22,8,20,10
2021_11_SF_JAX,JAX,SF,11,2021,158,54,176,171,212,347,343,371.8888888888889,375.7407407407407,398.7283950617284,9,18,17,23
2021_11_WAS_CAR,CAR,WAS,11,2021,189,111,206,190,300,396,335.4,359.55555555555554,395.9,416,6,14,21,28
2021_12_ATL_JAX,JAX,ATL,12,2021,228,141,190,149,369,339,329.9,323.2,369.4,368.17999999999995,6,3,17,16
2021_12_BUF_NO,NO,BUF,12,2021,163,44,260,113,207,373,332.5,402.7,364.25,375.94,8,27,14,21
2021_12_CAR_MIA,MIA,CAR,12,2021,230,111,179,64,341,243,327.72727272727275,332.1818181818182,357.8484848484848,362.8686868686869,5,7,11,13
2021_12_CHI_DET,DET,CHI,12,2021,171,76,317,68,247,385,334.5,315.3,379.53,421.5,9,2,22,30
2021_12_CLE_BAL,BAL,CLE,12,2021,165,148,247,40,313,287,421.5,379.72727272727275,315.3,335.4040404040404,29,22,2,8
2021_12_LA_GB,GB,LA,12,2021,307,92,302,68,399,370,365.1818181818182,400,397.4646464646465,372.3125,16,26,24,18
2021_12_LAC_DEN,DEN,LAC,12,2021,155,147,303,72,302,375,361.7,398.8,361.5,340.8,13,25,12,10
2021_12_LV_DAL,DAL,LV,12,2021,375,64,373,143,439,516,428.3,387.8,411.4700000000001,373.7,30,23,28,19
2021_12_MIN_SF,SF,MIN,12,2021,230,208,262,67,438,329,369.4,397.8,329.9,366.33,18,24,5,15
2021_12_NYJ_HOU,HOU,NYJ,12,2021,158,96,145,157,254,302,288.5,358.2,374.25,328.33,1,12,20,4
2021_12_PHI_NYG,NYG,PHI,12,2021,202,70,129,208,272,337,338.6,364,415.6,332.5959595959596,10,15,29,7
2021_12_PIT_CIN,CIN,PIT,12,2021,190,198,263,51,388,314,373.7,340.8,387.8,398.8,19,11,23,26
2021_12_SEA_WAS,WAS,SEA,12,2021,223,152,247,34,375,281,363.2,325,331.86,398.61,14,4,6,25
2021_12_TB_IND,IND,TB,12,2021,306,107,226,142,413,368,376,415.6,403.54545454545456,338.6,21,28,27,9
2021_12_TEN_NE,NE,TEN,12,2021,310,105,93,270,415,363,368.45454545454544,373.72727272727275,324.4646464646464,289.4949494949495,17,20,3,1
2021_13_ARI_CHI,CHI,ARI,13,2021,229,109,123,137,338,260,321.6363636363636,398.3636363636364,326.54545454545456,325.32323232323233,4,22,8,7
2021_13_BAL_PIT,PIT,BAL,13,2021,236,85,253,107,321,360,338.3636363636364,411.6363636363636,375,371.297520661157,10,26,19,17
2021_13_DAL_NO,NO,DAL,13,2021,264,153,238,146,417,384,321.09090909090907,429.27272727272725,400,399.45454545454544,3,28,25,24
2021_13_DEN_KC,KC,DEN,13,2021,184,89,257,154,273,411,411.72727272727275,356.27272727272725,429.6161616161616,396.6363636363636,27,12,28,23
2021_13_IND_HOU,HOU,IND,13,2021,94,84,158,238,178,396,285.3636363636364,379.0833333333333,353.09090909090907,411.6333333333334,1,18,12,26
2021_13_JAX_LA,LA,JAX,13,2021,295,128,145,61,423,206,397.27272727272725,333.45454545454544,368.25619834710744,324.6363636363636,21,9,16,5
2021_13_LAC_CIN,CIN,LAC,13,2021,300,96,317,79,396,396,375,396.6363636363636,338.3636363636364,356.27272727272725,16,20,11,13
2021_13_MIN_DET,DET,MIN,13,2021,296,100,340,100,396,440,326.54545454545456,391.54545454545456,321.6363636363636,375.6363636363636,6,19,4,20
2021_13_NE_BUF,BUF,NE,13,2021,145,99,19,222,244,241,400,372.3333333333333,321.09090909090907,372.8333333333333,24,15,3,18
2021_13_NYG_MIA,MIA,NYG,13,2021,244,68,187,91,312,278,328.8333333333333,332.54545454545456,324.75,361.54545454545456,7,8,6,14
2021_13_PHI_NYJ,NYJ,PHI,13,2021,226,70,242,185,296,427,353.09090909090907,361.75,285.3636363636364,333.05,11,13,1,9
2021_13_SF_SEA,SEA,SF,13,2021,231,146,299,71,377,370,321,375.6363636363636,364.27272727272725,391.54545454545456,2,17,15,22
2021_13_TB_ATL,ATL,TB,13,2021,297,121,368,57,418,425,324.6363636363636,411.27272727272725,333.45454545454544,379.3636363636364,5,25,10,21
2021_13_WAS_LV,LV,WAS,13,2021,249,76,196,112,325,308,399.45454545454544,364.27272727272725,429.27272727272725,321,23,14,27,2
2021_14_ATL_CAR,CAR,ATL,14,2021,253,91,190,128,344,318,324.75,332.4166666666667,328.8333333333333,412.4166666666667,4,9,5,26
2021_14_BAL_CLE,CLE,BAL,14,2021,190,100,287,118,290,405,372,407.3333333333333,412.4583333333333,336.9166666666667,15,26,27,9
2021_14_BUF_TB,TB,BUF,14,2021,363,137,308,173,500,481,412.4166666666667,387,332.4166666666667,361.38888888888886,27,20,8,12
2021_14_CHI_GB,GB,CHI,14,2021,341,119,224,137,460,361,368,323,397.5,386.8333333333333,14,3,22,18
2021_14_DAL_WAS,WAS,DAL,14,2021,175,100,211,122,275,333,359.5833333333333,425.5,393.25,329.0833333333333,12,28,19,6
2021_14_DET_DEN,DEN,DET,14,2021,179,184,215,118,363,333,360.8333333333333,332.3333333333333,400.1666666666667,395.5833333333333,13,8,24,20
2021_14_JAX_TEN,TEN,JAX,14,2021,191,102,221,8,293,229,372.8333333333333,322.8333333333333,372.3333333333333,399.4166666666667,16,2,14,23
2021_14_LA_ARI,ARI,LA,14,2021,383,103,287,89,486,376,386.8333333333333,399.4166666666667,323,322.8333333333333,19,24,2,1
2021_14_LV_KC,KC,LV,14,2021,258,132,263,44,390,307,400.1666666666667,393.25,360.8333333333333,359.5833333333333,25,21,11,10
2021_14_NO_NYJ,NYJ,NO,14,2021,202,78,175,203,280,378,348.3333333333333,329.0833333333333,367.1875,425.5,11,7,13,28
2021_14_NYG_LAC,LAC,NYG,14,2021,275,152,191,135,427,326,396.5833333333333,328,376.75,327.43055555555554,23,6,16,4
2021_14_PIT_MIN,MIN,PIT,14,2021,216,242,308,106,458,414,395.5833333333333,336.9166666666667,332.3333333333333,407.3333333333333,22,10,7,25
2021_14_SEA_HOU,HOU,SEA,14,2021,331,63,260,193,394,453,276.4166666666667,325.6666666666667,380.4930555555555,375.1666666666667,1,5,17,15
2021_14_SF_CIN,CIN,SF,14,2021,348,86,296,100,434,396,376.75,375.1666666666667,396.5833333333333,325.6666666666667,18,17,21,3
2021_15_ARI_DET,DET,ARI,15,2021,216,126,313,105,342,418,332.38461538461536,394.46153846153845,361,397.61538461538464,8,25,16,26
2021_15_ATL_SF,SF,ATL,15,2021,235,162,236,62,397,298,376.7692307692308,331.3076923076923,381.15384615384613,326.2307692307692,20,7,21,5
2021_15_CAR_BUF,BUF,CAR,15,2021,210,119,156,151,329,307,394.2307692307692,326.2307692307692,419.15384615384613,331.3076923076923,24,4,32,8
2021_15_CIN_DEN,DEN,CIN,15,2021,186,133,157,113,319,270,361,381.15384615384613,332.38461538461536,376.7692307692308,14,22,9,20
2021_15_DAL_NYG,NYG,DAL,15,2021,181,124,217,125,305,342,327.84615384615387,418.38461538461536,398.9230769230769,353.0769230769231,6,31,27,15
2021_15_GB_BAL,BAL,GB,15,2021,215,143,268,96,358,364,407.15384615384613,375.0769230769231,365.6923076923077,325.9230769230769,30,19,17,4
2021_15_HOU_JAX,JAX,HOU,15,2021,210,107,209,75,317,284,315.61538461538464,285.46153846153845,366.6923076923077,335.46153846153845,2,1,18,11
2021_15_KC_LAC,LAC,KC,15,2021,236,192,410,86,428,496,398.9230769230769,399.38461538461536,327.84615384615387,386.61538461538464,27,28,6,22
2021_15_LV_CLE,CLE,LV,15,2021,147,89,236,98,236,334,365.6923076923077,386.61538461538464,407.15384615384613,399.38461538461536,16,23,30,28
2021_15_MIN_CHI,CHI,MIN,15,2021,285,115,87,132,400,219,325.9230769230769,400.38461538461536,375.0769230769231,342.84615384615387,3,29,19,12
2021_15_NE_IND,IND,NE,15,2021,57,226,299,81,283,380,380.38461538461536,362.2307692307692,277.1048951048951,388,21,15,1,23
2021_15_NO_TB,TB,NO,15,2021,214,118,154,61,332,215,419.15384615384613,332.84615384615387,394.2307692307692,343.0769230769231,32,9,24,13
2021_15_NYJ_MIA,MIA,NYJ,15,2021,196,183,170,102,379,272,327.53846153846155,343.0769230769231,328.3496503496504,332.84615384615387,5,12,7,10
2021_15_SEA_LA,LA,SEA,15,2021,244,123,156,80,367,236,397.61538461538464,335.46153846153845,394.46153846153845,285.46153846153845,26,10,25,2
2021_15_TEN_PIT,PIT,TEN,15,2021,148,35,153,201,183,354,342.84615384615387,366.6923076923077,400.38461538461536,315.61538461538464,11,17,29,3
2021_15_WAS_PHI,PHI,WAS,15,2021,296,238,194,63,534,257,366.7692307692308,353.0769230769231,348.6993006993007,418.38461538461536,18,13,14,31
2021_16_BAL_CIN,CIN,BAL,16,2021,525,77,304,39,602,343,373.2142857142857,403.64285714285717,358,374.2857142857143,18,29,15,20
2021_16_BUF_NE,NE,BUF,16,2021,145,149,314,114,294,428,363.5,389.57142857142856,373.42857142857144,324.85714285714283,16,25,19,4
2021_16_CHI_SEA,SEA,CHI,16,2021,181,170,250,88,351,338,328.35714285714283,331.2142857142857,395.42857142857144,387.42857142857144,6,9,26,24
2021_16_CLE_GB,GB,CLE,16,2021,202,109,222,219,311,441,374.2857142857143,356.42857142857144,403.64285714285717,382.85714285714283,20,14,29,23
2021_16_DEN_LV,LV,DEN,16,2021,201,160,153,18,361,171,382.85714285714283,358,356.42857142857144,373.2142857142857,23,15,14,18
2021_16_DET_ATL,ATL,DET,16,2021,215,47,208,130,262,338,328.92857142857144,333.07142857142856,378.2142857142857,396.14285714285717,7,11,21,27
2021_16_IND_ARI,ARI,IND,16,2021,245,133,225,126,378,351,396.14285714285717,373.42857142857144,333.07142857142856,363.5,27,19,11,16
2021_16_JAX_NYJ,NYJ,JAX,16,2021,102,273,280,132,375,412,338,315.7142857142857,331.2142857142857,285.35714285714283,12,2,9,1
2021_16_LA_MIN,MIN,LA,16,2021,315,66,197,159,381,356,387.42857142857144,395.42857142857144,331.2142857142857,328.35714285714283,24,26,9,6
2021_16_LAC_HOU,HOU,LAC,16,2021,254,189,336,89,443,425,285.35714285714283,401,315.7142857142857,406.2857142857143,1,28,2,30
2021_16_MIA_NO,NO,MIA,16,2021,135,83,198,86,218,284,324.42857142857144,331.2142857142857,412.92857142857144,338,3,9,32,12
2021_16_NYG_PHI,PHI,NYG,16,2021,199,130,118,84,329,202,378.7142857142857,326.2142857142857,346.2142857142857,412.92857142857144,22,5,13,32
2021_16_PIT_KC,KC,PIT,16,2021,258,127,194,130,385,324,406.2857142857143,331.42857142857144,401,365.7857142857143,30,10,28,17
2021_16_SF_TEN,TEN,SF,16,2021,209,90,322,83,299,405,365.7857142857143,378.2142857142857,331.42857142857144,328.92857142857144,17,21,10,7
2021_16_TB_CAR,CAR,TB,16,2021,251,67,232,159,318,391,324.85714285714283,412.92857142857144,389.57142857142856,324.42857142857144,4,32,25,3
2021_16_WAS_DAL,DAL,WAS,16,2021,400,108,188,85,508,273,412.92857142857144,346.2142857142857,326.2142857142857,378.7142857142857,32,13,5,22
2021_17_ARI_DAL,DAL,ARI,17,2021,257,45,286,127,302,413,419.26666666666665,394.93333333333334,341.3333333333333,371.93333333333334,32,27,13,19
2021_17_ATL_BUF,BUF,ATL,17,2021,120,233,197,96,353,293,392.1333333333333,324.46666666666664,358.8666666666667,333.4,25,6,15,11
2021_17_CAR_NO,NO,CAR,17,2021,222,73,132,88,295,220,317.3333333333333,324.4,328.06666666666666,411.46666666666664,2,5,7,31
2021_17_CLE_PIT,PIT,CLE,17,2021,123,190,185,93,313,278,330.93333333333334,362.06666666666666,404.8666666666667,370.06666666666666,9,17,30,18
2021_17_DEN_LAC,LAC,DEN,17,2021,237,104,246,83,341,329,402.6,345.53333333333336,295.8666666666667,381.4,29,14,1,22
2021_17_DET_SEA,SEA,DET,17,2021,236,265,262,95,501,357,329.8666666666667,333.4,331.6666666666667,324.46666666666664,8,11,10,6
2021_17_HOU_SF,SF,HOU,17,2021,249,175,163,86,424,249,380,295.8666666666667,361.3333333333333,402.6,21,1,16,29
2021_17_JAX_NE,NE,JAX,17,2021,290,181,193,80,471,273,358.8666666666667,322.1333333333333,392.1333333333333,340.46666666666664,15,4,25,12
2021_17_KC_CIN,CIN,KC,17,2021,446,60,259,155,506,414,388.46666666666664,404.8666666666667,399.6,330.93333333333334,24,30,28,9
2021_17_LA_BAL,BAL,LA,17,2021,197,165,309,73,362,382,399.6,392.8,388.46666666666664,387,28,26,24,23
2021_17_LV_IND,IND,LV,17,2021,148,122,255,85,270,340,371.93333333333334,381.4,394.93333333333334,345.53333333333336,19,22,27,14
2021_17_MIA_TEN,TEN,MIA,17,2021,120,198,205,74,318,279,361.3333333333333,328.06666666666666,380,317.3333333333333,16,7,21,2
2021_17_MIN_GB,GB,MIN,17,2021,307,174,194,27,481,221,370.06666666666666,387,362.06666666666666,392.8,18,23,17,26
2021_17_NYG_CHI,CHI,NYG,17,2021,173,87,24,161,260,185,331.6666666666667,317.93333333333334,329.8666666666667,375.4,10,3,8,20
2021_17_PHI_WAS,WAS,PHI,17,2021,247,94,214,118,341,332,341.3333333333333,375.4,419.26666666666665,317.93333333333334,13,20,32,3
2021_17_TB_NYJ,NYJ,TB,17,2021,234,150,410,62,384,472,340.46666666666664,411.46666666666664,322.1333333333333,324.4,12,31,4,5
2021_18_CAR_TB,TB,CAR,18,2021,326,85,219,110,411,329,415.25,317.875,343.1875,315.9375,32,4,13,3
2021_18_CHI_MIN,MIN,CHI,18,2021,250,104,325,90,354,415,376.625,327.1875,377,309.625,20,8,21,2
2021_18_CIN_CLE,CLE,CIN,18,2021,176,205,136,79,381,215,356.8125,395.8125,329.8125,405.4375,15,26,9,30
2021_18_DAL_PHI,PHI,DAL,18,2021,188,149,305,171,337,476,372.6875,411.9375,341.3125,396.0625,19,31,12,27
2021_18_GB_DET,DET,GB,18,2021,313,99,272,122,412,394,334.875,377,340.5625,376.625,10,21,11,20
2021_18_IND_JAX,JAX,IND,18,2021,223,101,185,94,324,279,319.0625,365.5625,365.875,378.8125,5,17,18,22
2021_18_KC_DEN,DEN,KC,18,2021,178,191,270,135,369,405,344.5,405.4375,398.75,395.8125,14,30,29,26
2021_18_LAC_LV,LV,LAC,18,2021,190,174,383,85,364,468,378.8125,398.75,365.5625,344.5,22,29,17,14
2021_18_NE_MIA,MIA,NE,18,2021,109,195,261,134,304,395,325,365.875,358.625,319.0625,7,18,16,5
2021_18_NO_ATL,ATL,NO,18,2021,216,62,178,195,278,373,322.5,315.9375,389.6875,317.875,6,3,24,4
2021_18_NYJ_BUF,BUF,NYJ,18,2021,254,166,87,48,420,135,389.6875,343.1875,322.5,415.25,24,13,6,32
2021_18_PIT_BAL,BAL,PIT,18,2021,141,249,244,79,390,323,397.25,329.8125,392.125,356.8125,28,9,25,15
2021_18_SEA_ARI,ARI,SEA,18,2021,240,118,238,202,358,440,396.0625,340.5625,411.9375,334.875,27,11,31,10
2021_18_SF_LA,LA,SF,18,2021,238,64,340,135,302,475,392.125,382.75,397.25,292.9375,25,23,28,1
2021_18_TEN_HOU,HOU,TEN,18,2021,301,64,287,124,365,411,292.9375,358.625,382.75,325,1,16,23,7
2021_18_WAS_NYG,NYG,WAS,18,2021,103,94,120,226,197,346,309.625,341.3125,327.1875,372.6875,2,12,8,19
2021_19_ARI_LA,LA,ARI,19,2021,242,140,137,61,382,198,386.8235294117647,393.8235294117647,388.1764705882353,346.4117647058824,6,9,9,5
2021_19_LV_CIN,CIN,LV,19,2021,244,83,310,103,327,413,385.1764705882353,377.94117647058823,358.2352941176471,402.8235294117647,5,4,6,11
2021_19_NE_BUF,BUF,NE,19,2021,308,174,232,89,482,321,391.47058823529414,367.5882352941176,330.94117647058823,323.7647058823529,8,2,3,2
2021_19_PHI_TB,TB,PHI,19,2021,271,106,258,95,377,353,415,370.5882352941176,318.52941176470586,415.70588235294116,11,3,1,12
2021_19_PIT_KC,KC,PIT,19,2021,406,106,215,56,512,271,405.4117647058824,329.4117647058824,345.94117647058823,396.8235294117647,10,1,4,10
2021_19_SF_DAL,DAL,SF,19,2021,270,77,172,169,347,341,415.70588235294116,388.1764705882353,370.5882352941176,386.8235294117647,12,7,7,8
2021_20_BUF_KC,KC,BUF,20,2021,378,182,329,109,560,438,411.3333333333333,396.5,326.1666666666667,365,7,6,2,4
2021_20_CIN_TEN,TEN,CIN,20,2021,220,140,348,65,360,413,361.70588235294116,381.94444444444446,297.1764705882353,379.8888888888889,1,3,1,6
2021_20_LA_TB,TB,LA,20,2021,329,51,366,73,380,439,412.8888888888889,386.55555555555554,369.6111111111111,382.94444444444446,8,5,5,7
2021_20_SF_GB,GB,SF,20,2021,225,67,131,106,292,237,378,385.55555555555554,339.4117647058824,411.8888888888889,2,4,3,8
2021_21_CIN_KC,KC,CIN,21,2021,275,139,250,116,414,366,419.1578947368421,383.57894736842104,398.6842105263158,361.6160990712074,4,2,3,1
2021_21_SF_LA,LA,SF,21,2021,337,70,232,50,407,282,389.3157894736842,377.7368421052632,411.1578947368421,373.4736842105263,3,1,4,2
2021_22_LA_CIN,CIN,LA,22,2021,269,79,283,43,348,326,382.7,390.2,418.9,372.95,1,2,2,1
2022_01_BAL_NYJ,NYJ,BAL,1,2022,309,83,213,63,392,276,0,0,0,0,32,32,32,32
2022_01_BUF_LA,LA,BUF,1,2022,240,52,297,121,292,418,0,0,0,0,32,32,32,32
2022_01_CLE_CAR,CAR,CLE,1,2022,235,54,147,217,289,364,0,0,0,0,32,32,32,32
2022_01_DEN_SEA,SEA,DEN,1,2022,195,76,340,103,271,443,0,0,0,0,32,32,32,32
2022_01_GB_MIN,MIN,GB,1,2022,277,126,260,111,403,371,0,0,0,0,32,32,32,32
2022_01_IND_HOU,HOU,IND,1,2022,240,77,352,177,317,529,0,0,0,0,32,32,32,32
2022_01_JAX_WAS,WAS,JAX,1,2022,313,85,275,123,398,398,0,0,0,0,32,32,32,32
2022_01_KC_ARI,ARI,KC,1,2022,205,103,360,128,308,488,0,0,0,0,32,32,32,32
2022_01_LV_LAC,LAC,LV,1,2022,279,76,295,64,355,359,0,0,0,0,32,32,32,32
2022_01_NE_MIA,MIA,NE,1,2022,270,65,213,78,335,291,0,0,0,0,32,32,32,32
2022_01_NO_ATL,ATL,NO,1,2022,215,201,269,151,416,420,0,0,0,0,32,32,32,32
2022_01_NYG_TEN,TEN,NYG,1,2022,266,93,188,238,359,426,0,0,0,0,32,32,32,32
2022_01_PHI_DET,DET,PHI,1,2022,215,181,243,216,396,459,0,0,0,0,32,32,32,32
2022_01_PIT_CIN,CIN,PIT,1,2022,338,133,194,75,471,269,0,0,0,0,32,32,32,32
2022_01_SF_CHI,CHI,SF,1,2022,121,99,164,176,220,340,0,0,0,0,32,32,32,32
2022_01_TB_DAL,DAL,TB,1,2022,198,71,212,152,269,364,0,0,0,0,32,32,32,32
2022_02_ARI_LV,LV,ARI,2,2022,252,80,277,143,332,420,359,308,355,488,15,9,13,31
2022_02_ATL_LA,LA,ATL,2,2022,272,65,196,90,337,286,292,416,418,420,8,24,25,26
2022_02_CAR_NYG,NYG,CAR,2,2022,176,103,145,146,279,291,426,289,359,364,27,6,15,17
2022_02_CHI_GB,GB,CHI,2,2022,234,203,70,180,437,250,371,220,403,340,18,1,23,12
2022_02_CIN_DAL,DAL,CIN,2,2022,235,107,199,89,342,288,269,471,364,269,3,30,17,3
2022_02_HOU_DEN,DEN,HOU,2,2022,219,149,177,80,368,257,443,317,271,529,28,10,4,32
2022_02_IND_JAX,JAX,IND,2,2022,235,96,195,54,331,249,398,529,398,317,22,32,22,10
2022_02_LAC_KC,KC,LAC,2,2022,235,93,334,75,328,409,488,355,308,359,31,13,9,15
2022_02_MIA_BAL,BAL,MIA,2,2022,318,155,469,86,473,555,276,335,392,291,5,11,19,7
2022_02_MIN_PHI,PHI,MIN,2,2022,333,163,221,62,496,283,459,403,396,371,29,23,20,18
2022_02_NE_PIT,PIT,NE,2,2022,168,91,252,124,259,376,269,291,471,335,3,7,30,11
2022_02_NYJ_CLE,CLE,NYJ,2,2022,229,184,324,93,413,417,364,392,289,276,17,19,6,5
2022_02_SEA_SF,SF,SEA,2,2022,184,189,197,36,373,233,340,271,220,443,12,4,1,28
2022_02_TB_NO,NO,TB,2,2022,236,100,190,72,336,262,420,364,416,269,26,17,24,3
2022_02_TEN_BUF,BUF,TEN,2,2022,317,101,123,80,418,203,418,359,292,426,25,15,8,27
2022_02_WAS_DET,DET,WAS,2,2022,256,191,337,88,447,425,396,398,459,398,20,22,29,22
2022_03_ATL_SEA,SEA,ATL,3,2022,325,112,229,179,437,408,252,351,356.5,314.5,2,13,15,9
2022_03_BAL_NE,NE,BAL,3,2022,321,145,218,188,466,406,333.5,374.5,264,445,10,18,3,31
2022_03_BUF_MIA,MIA,BUF,3,2022,186,41,400,115,227,515,445,418,374.5,281,31,29,18,4
2022_03_CIN_NYJ,NYJ,CIN,3,2022,285,76,275,69,361,344,404.5,379.5,388.5,305.5,25,20,22,7
2022_03_DAL_NYG,NYG,DAL,3,2022,196,167,215,176,363,391,352.5,305.5,290,379.5,14,7,6,20
2022_03_DET_MIN,MIN,DET,3,2022,260,123,277,139,383,416,343,421.5,477.5,411.5,11,30,32,28
2022_03_GB_TB,TB,GB,3,2022,271,34,255,67,305,322,313,404,378,235,8,24,19,1
2022_03_HOU_CHI,CHI,HOU,3,2022,106,281,245,92,387,337,235,287,404,405.5,1,5,24,26
2022_03_JAX_LAC,LAC,JAX,3,2022,297,26,262,151,323,413,382,364.5,408,389,21,17,27,23
2022_03_KC_IND,IND,KC,3,2022,222,82,262,58,304,320,389,408,364.5,382,23,27,17,21
2022_03_LA_ARI,ARI,LA,3,2022,314,70,249,100,384,349,364,314.5,345.5,351,16,9,12,13
2022_03_LV_TEN,TEN,LV,3,2022,264,109,307,96,373,403,281,345.5,418,364,4,12,29,16
2022_03_NO_CAR,CAR,NO,3,2022,170,145,353,84,315,437,290,378,352.5,313,6,19,14,8
2022_03_PHI_WAS,WAS,PHI,3,2022,211,87,340,72,298,412,411.5,477.5,421.5,343,28,32,30,11
2022_03_PIT_CLE,CLE,PIT,3,2022,220,171,207,104,391,311,388.5,264,404.5,333.5,22,3,25,10
2022_03_SF_DEN,DEN,SF,3,2022,184,101,211,88,285,299,405.5,356.5,287,252,26,15,5,2
2022_04_ARI_CAR,CAR,ARI,4,2022,197,40,207,132,237,339,298.3333333333333,370.6666666666667,397.6666666666667,326,3,19,29,8
2022_04_BUF_BAL,BAL,BUF,4,2022,144,162,213,125,306,338,385,450.3333333333333,377.6666666666667,372.3333333333333,26,31,23,20
2022_04_CHI_NYG,NYG,CHI,4,2022,82,262,174,149,344,323,356,285.6666666666667,334,303.6666666666667,11,2,9,4
2022_04_CLE_ATL,ATL,CLE,4,2022,139,202,234,177,341,411,370,389.3333333333333,313.6666666666667,279.6666666666667,18,27,7,1
2022_04_DEN_LV,LV,DEN,4,2022,188,212,237,85,400,322,364.6666666666667,365.3333333333333,311.6666666666667,337.3333333333333,15,16,6,10
2022_04_JAX_PHI,PHI,JAX,4,2022,204,210,174,71,414,245,455.6666666666667,380.6666666666667,373.6666666666667,362.3333333333333,32,25,21,14
2022_04_KC_TB,TB,KC,4,2022,385,3,249,189,388,438,310.3333333333333,378.6666666666667,376.6666666666667,360.6666666666667,5,24,22,13
2022_04_LA_SF,SF,LA,4,2022,239,88,254,57,327,311,337.3333333333333,326,365.3333333333333,370.6666666666667,10,8,16,19
2022_04_LAC_HOU,HOU,LAC,4,2022,246,131,340,81,377,421,303.6666666666667,362.3333333333333,285.6666666666667,380.6666666666667,4,14,2,25
2022_04_MIA_CIN,CIN,MIA,4,2022,310,67,303,85,377,388,367.6666666666667,372.3333333333333,390,450.3333333333333,17,20,28,31
2022_04_MIN_NO,NO,MIN,4,2022,236,111,286,81,347,367,397.6666666666667,356.3333333333333,298.3333333333333,419.6666666666667,29,12,3,30
2022_04_NE_GB,GB,NE,4,2022,251,199,136,167,450,303,376.6666666666667,377.6666666666667,310.3333333333333,385,22,23,5,26
2022_04_NYJ_PIT,PIT,NYJ,4,2022,204,119,254,98,323,352,279.6666666666667,390,389.3333333333333,367.6666666666667,1,28,27,17
2022_04_SEA_DET,DET,SEA,4,2022,384,145,320,235,529,555,419.6666666666667,313.6666666666667,356.3333333333333,370,30,7,12,18
2022_04_TEN_IND,IND,TEN,4,2022,356,38,137,127,394,264,360.6666666666667,311.6666666666667,378.6666666666667,364.6666666666667,13,6,24,15
2022_04_WAS_DAL,DAL,WAS,4,2022,223,62,170,142,285,312,334,373.6666666666667,356,455.6666666666667,9,21,11,32
2022_05_ATL_TB,TB,ATL,5,2022,351,69,147,151,420,298,329.75,362.75,393.5,394.75,8,17,27,28
2022_05_CHI_MIN,MIN,CHI,5,2022,319,117,208,78,436,286,359,295,385,353,15,3,26,11
2022_05_CIN_BAL,BAL,CIN,5,2022,174,155,217,101,329,318,365.25,370,422.25,376.25,18,20,30,23
2022_05_DAL_LA,LA,DAL,5,2022,320,38,102,163,358,265,322.25,321.75,334.75,358.25,7,5,9,13
2022_05_DET_NE,NE,DET,5,2022,188,176,229,101,364,330,359,447,395,374,15,32,29,22
2022_05_HOU_JAX,JAX,HOU,5,2022,286,136,140,116,422,256,346.75,322,445.25,377,10,6,31,24
2022_05_IND_DEN,DEN,IND,5,2022,274,125,251,106,399,357,354.5,369,373.5,299.75,12,19,21,4
2022_05_LAC_CLE,CLE,LAC,5,2022,230,213,228,238,443,466,394.75,377,362.75,322,28,24,17,6
2022_05_LV_KC,KC,LV,5,2022,292,103,241,155,395,396,393.5,373.5,329.75,354.5,27,21,8,12
2022_05_MIA_NYJ,NYJ,MIA,5,2022,210,135,166,137,345,303,380.5,376.25,290.5,370,25,23,2,20
2022_05_NYG_GB,GB,NYG,5,2022,222,94,217,125,316,342,395,353,359,295,29,11,15,3
2022_05_PHI_ARI,ARI,PHI,5,2022,250,124,239,139,374,378,362.75,445.25,283,346.75,17,31,1,10
2022_05_PIT_BUF,BUF,PIT,5,2022,432,120,327,54,552,381,422.25,290.5,365.25,380.5,30,2,18,25
2022_05_SEA_NO,NO,SEA,5,2022,209,235,268,151,444,419,385,374,359,447,26,22,15,32
2022_05_SF_CAR,CAR,SF,5,2022,275,64,253,153,339,406,283,334.75,362.75,322.25,1,9,17,7
2022_05_TEN_WAS,WAS,TEN,5,2022,359,43,181,105,402,286,358.25,299.75,321.75,369,13,4,5,19
2022_06_ARI_SEA,SEA,ARI,6,2022,197,136,222,144,333,366,383,365,396.8,431.8,22,16,24,27
2022_06_BAL_NYG,NYG,BAL,6,2022,173,83,210,211,256,421,350.8,358,379.2,359.6,9,10,21,13
2022_06_BUF_KC,KC,BUF,6,2022,338,68,329,125,406,454,393.8,448.2,378,308.6,23,28,20,4
2022_06_CAR_LA,LA,CAR,6,2022,253,111,119,93,364,212,329.4,294.2,310.4,349,5,2,6,9
2022_06_CIN_NO,NO,CIN,6,2022,178,228,300,75,406,375,396.8,359.6,383,358,25,11,22,12
2022_06_DAL_PHI,PHI,DAL,6,2022,155,136,181,134,291,315,431.8,310.4,365,329.4,27,4,16,7
2022_06_DEN_LAC,LAC,DEN,6,2022,238,73,188,98,311,286,394.8,363.4,404.4,366.6,24,15,25,17
2022_06_JAX_IND,IND,JAX,6,2022,389,45,165,243,434,408,366.6,361.8,363.4,308.8,17,14,15,5
2022_06_MIN_MIA,MIA,MIN,6,2022,418,73,175,78,491,253,361.6,374.4,373.4,293.2,13,20,18,1
2022_06_NE_CLE,CLE,NE,6,2022,266,70,309,98,336,407,404.4,360,394.8,423.6,26,12,23,26
2022_06_NYJ_GB,GB,NYJ,6,2022,254,60,110,179,314,289,379.2,373.4,350.8,361.6,21,19,11,14
2022_06_SF_ATL,ATL,SF,6,2022,129,168,296,50,297,346,349.8,349,347.8,294.2,8,7,8,2
2022_06_TB_PIT,PIT,TB,6,2022,211,77,243,75,288,318,308.6,347.8,448.2,349.8,3,6,28,10
2022_06_WAS_CHI,CHI,WAS,6,2022,190,237,99,128,427,227,293.2,367,374.4,297,1,18,19,3
2022_07_ATL_CIN,CIN,ATL,7,2022,481,78,124,107,559,231,362.1666666666667,341,398.3333333333333,348.5,14,8,26,8
2022_07_CHI_NE,NE,CHI,7,2022,198,70,179,243,268,422,367.8333333333333,315.5,393,343.6666666666667,16,6,24,7
2022_07_CLE_BAL,BAL,CLE,7,2022,120,160,258,113,280,371,368.5,393,335,367.8333333333333,18,25,3,17
2022_07_DET_DAL,DAL,DET,7,2022,207,139,228,117,346,345,311.1666666666667,423.6,408.3333333333333,360,5,28,27,12
2022_07_GB_WAS,WAS,GB,7,2022,201,166,194,38,367,232,343.6666666666667,368.3333333333333,315.5,359.3333333333333,10,17,2,11
2022_07_HOU_LV,LV,HOU,7,2022,241,164,302,108,405,410,378,308.8,393.8,361.8,22,4,25,13
2022_07_IND_TEN,TEN,IND,7,2022,132,138,243,65,270,308,297,377.8333333333333,367,369.5,2,21,16,20
2022_07_KC_SF,SF,KC,7,2022,369,101,423,112,470,535,348.5,395.8333333333333,341,449.1666666666667,11,26,5,28
2022_07_NO_ARI,ARI,NO,7,2022,204,137,409,85,341,494,365.1666666666667,398.3333333333333,374.6666666666667,362.1666666666667,15,27,21,14
2022_07_NYG_JAX,JAX,NYG,7,2022,310,142,202,236,452,438,369.5,335,377.8333333333333,368.5,19,7,22,19
2022_07_NYJ_DEN,DEN,NYJ,7,2022,225,105,121,155,330,276,350.5,359.3333333333333,380.8333333333333,368.3333333333333,12,13,23,18
2022_07_PIT_MIA,MIA,PIT,7,2022,261,111,257,95,372,352,383.1666666666667,305.1666666666667,354.1666666666667,342.8333333333333,24,3,10,6
2022_07_SEA_LAC,LAC,SEA,7,2022,293,53,210,213,346,423,380.8333333333333,374.6666666666667,350.5,365.1666666666667,23,20,9,15
2022_07_TB_CAR,CAR,TB,7,2022,177,173,290,46,350,336,280.5,342.8333333333333,335.1666666666667,305.1666666666667,1,9,4,1
2022_08_ARI_MIN,MIN,ARI,8,2022,232,173,326,78,405,404,354.1666666666667,361.7142857142857,383.1666666666667,412,16,18,24,28
2022_08_BAL_TB,TB,BAL,8,2022,325,44,238,231,369,469,341.85714285714283,355.85714285714283,290.42857142857144,389.85714285714283,9,17,2,25
2022_08_CAR_ATL,ATL,CAR,8,2022,253,167,317,169,420,486,325.2857142857143,290.42857142857144,390.2857142857143,341.85714285714283,5,1,26,10
2022_08_CHI_DAL,DAL,CHI,8,2022,250,200,156,240,450,396,316.14285714285717,330.7142857142857,412.3714285714286,353.57142857142856,4,7,29,16
2022_08_CIN_CLE,CLE,CIN,8,2022,278,172,232,36,450,268,389.85714285714283,390.2857142857143,355.85714285714283,325.2857142857143,25,26,17,7
2022_08_DEN_JAX,JAX,DEN,8,2022,133,191,252,101,324,353,381.2857142857143,347.57142857142856,349.7142857142857,347.42857142857144,21,12,15,12
2022_08_GB_BUF,BUF,GB,8,2022,218,153,203,208,371,411,449.1666666666667,348.85714285714283,395.8333333333333,347,30,13,27,11
2022_08_LV_NO,NO,LV,8,2022,231,136,173,38,367,211,412,382.5,361.7142857142857,325.6666666666667,29,24,18,8
2022_08_MIA_DET,DET,MIA,8,2022,321,82,382,107,403,489,410.5,381.57142857142856,316.97222222222223,311.85714285714283,28,23,6,5
2022_08_NE_NYJ,NYJ,NE,8,2022,355,51,194,127,406,321,347.42857142857144,353.57142857142856,347.57142857142856,330.7142857142857,11,15,13,9
2022_08_NYG_SEA,SEA,NYG,8,2022,212,87,176,78,299,254,381.57142857142856,349.7142857142857,375.85714285714283,381.2857142857143,23,14,20,21
2022_08_PIT_PHI,PHI,PIT,8,2022,308,111,196,144,419,340,408.3333333333333,311.85714285714283,311.1666666666667,381.57142857142856,27,3,4,22
2022_08_SF_LA,LA,SF,8,2022,187,56,269,111,243,380,335.1666666666667,365.85714285714283,280.5,415.7142857142857,8,19,1,30
2022_08_TEN_HOU,HOU,TEN,8,2022,152,43,55,314,195,369,325.6666666666667,292.5,382.5,366.1944444444444,6,2,23,19
2022_08_WAS_IND,IND,WAS,8,2022,201,135,279,96,336,375,367.85714285714283,347,293.14285714285717,348.85714285714283,20,10,3,14
2022_09_BAL_NO,NO,BAL,9,2022,223,48,133,188,271,321,406.375,370,361.0625,345.25,22,16,15,8
2022_09_BUF_NYJ,NYJ,BUF,9,2022,154,174,205,134,328,339,354.75,438,349.5,357.73469387755097,10,26,10,13
2022_09_CAR_CIN,CIN,CAR,9,2022,228,241,164,64,469,228,375,314.875,397.375,337.125,19,3,23,6
2022_09_GB_DET,DET,GB,9,2022,137,117,291,106,254,397,409.42857142857144,356.625,396.9183673469388,439.39583333333337,23,11,22,26
2022_09_IND_NE,NE,IND,9,2022,147,70,103,78,217,181,349.5,363.875,354.75,350.5,8,14,12,11
2022_09_LA_TB,TB,LA,9,2022,280,51,165,68,331,233,345.25,322,370,367.87755102040813,7,4,20,19
2022_09_LAC_ATL,ATL,LAC,9,2022,129,201,245,91,330,336,337.125,375.85714285714283,314.875,381.57142857142856,5,20,3,21
2022_09_LV_JAX,JAX,LV,9,2022,235,168,259,71,403,330,374.125,358,348.25,405.57142857142856,18,12,9,24
2022_09_MIA_CHI,CHI,MIA,9,2022,123,252,302,77,375,379,338.875,395,332.875,409.5625,6,21,5,25
2022_09_MIN_WAS,WAS,MIN,9,2022,149,137,262,56,286,318,350.5,361.42857142857144,363.875,367.7551020408163,9,13,16,18
2022_09_PHI_HOU,HOU,PHI,9,2022,154,168,243,143,322,386,307,409.85714285714283,303.42857142857144,315.87755102040813,2,24,1,4
2022_09_SEA_ARI,ARI,SEA,9,2022,175,122,275,158,297,433,367,371.25,360.52083333333337,337.75,15,17,14,7
2022_09_TEN_KC,KC,TEN,9,2022,446,77,80,172,523,252,415.7142857142857,303.42857142857144,365.85714285714283,307,25,1,17,2
2022_10_ARI_LA,LA,ARI,10,2022,209,66,238,78,275,316,310.875,359.22222222222223,343.46875,378.1111111111111,4,16,10,22
2022_10_ATL_CAR,CAR,ATL,10,2022,108,232,186,138,340,324,305.22222222222223,336.3333333333333,385.44444444444446,371.4285714285714,2,7,23,18
2022_10_CLE_MIA,MIA,CLE,10,2022,302,195,212,112,497,324,393.22222222222223,397.375,342.8888888888889,375,24,25,9,20
2022_10_DAL_GB,GB,DAL,10,2022,224,207,265,159,431,424,361.1111111111111,332.875,392.1587301587302,338.875,17,6,24,7
2022_10_DEN_TEN,TEN,DEN,10,2022,255,63,286,65,318,351,297,348.25,429.125,374.125,1,13,28,19
2022_10_DET_CHI,CHI,DET,10,2022,167,258,236,95,425,331,342.8888888888889,390,393.22222222222223,361.671875,9,22,25,15
2022_10_HOU_NYG,NYG,HOU,10,2022,197,191,319,101,388,420,337.75,308.875,371.25,406.875,8,3,17,26
2022_10_IND_LV,LV,IND,10,2022,248,77,222,207,325,429,354.5,343.55555555555554,377.734375,334.77777777777777,14,11,21,5
2022_10_JAX_KC,KC,JAX,10,2022,331,155,259,75,486,334,429.125,377.3333333333333,297,354.8888888888889,28,20,1,12
2022_10_LAC_SF,SF,LAC,10,2022,240,157,196,51,397,247,367.625,370.875,323.64583333333337,336.234375,18,19,4,6
2022_10_MIN_BUF,BUF,MIN,10,2022,330,175,357,147,505,504,425.625,356,351.40625,342.4375,27,15,11,8
2022_10_NO_PIT,PIT,NO,10,2022,199,217,174,29,416,203,315.375,391.3333333333333,409.66666666666663,364.55555555555554,5,23,27,16
2022_10_SEA_TB,TB,SEA,10,2022,258,161,275,39,419,314,343.6666666666667,378.1111111111111,312.1111111111111,359.22222222222223,12,21,3,14
2022_10_WAS_PHI,PHI,WAS,10,2022,175,94,211,152,269,363,406.875,343.3333333333333,308.875,356.60317460317464,26,10,2,13
2022_11_CAR_BAL,BAL,CAR,11,2022,209,115,196,36,324,232,364.55555555555554,308.7,391.3333333333333,335.1,18,3,24,7
2022_11_CHI_ATL,ATL,CHI,11,2022,131,149,153,160,280,313,335.1,351.1,308.7,384.1,7,12,4,23
2022_11_CIN_PIT,PIT,CIN,11,2022,265,102,355,62,367,417,326.55555555555554,385.44444444444446,370.4074074074074,305.22222222222223,5,24,19,2
2022_11_CLE_BUF,BUF,CLE,11,2022,197,171,324,80,368,404,434.44444444444446,389.22222222222223,372.44444444444446,404.7530864197531,27,25,21,26
2022_11_DAL_MIN,MIN,DAL,11,2022,159,73,307,151,232,458,372.44444444444446,343,434.44444444444446,368.8765432098765,21,8,28,18
2022_11_DET_NYG,NYG,DET,11,2022,341,89,165,160,430,325,343.3333333333333,383.44444444444446,321.22222222222223,352.01234567901236,9,23,5,14
2022_11_KC_LAC,LAC,KC,11,2022,280,115,329,163,395,492,357.1111111111111,435.44444444444446,370.8888888888889,372.5185185185185,17,28,20,22
2022_11_LA_NO,NO,LA,11,2022,274,88,223,148,362,371,372.5,306.8888888888889,325.4375,354.41975308641975,22,2,6,16
2022_11_LV_DEN,DEN,LV,11,2022,247,94,307,109,341,416,348.55555555555554,351.22222222222223,299.3333333333333,353.04938271604937,11,13,1,15
2022_11_NYJ_NE,NE,NYJ,11,2022,246,99,77,59,345,136,334.77777777777777,351.77777777777777,343.55555555555554,427,6,14,10,27
2022_11_PHI_IND,IND,PHI,11,2022,213,99,190,141,312,331,352.1,391.55555555555554,351.55,345.5185185185185,15,26,13,11
2022_11_SF_ARI,ARI,SF,11,2022,277,67,228,159,344,387,354.9,370.8888888888889,307.2875,357.1111111111111,16,20,3,17
2022_11_TEN_GB,GB,TEN,11,2022,227,56,337,88,283,425,368.1,299.3333333333333,341.9875,348.55555555555554,19,1,8,12
2022_11_WAS_HOU,HOU,WAS,11,2022,169,21,191,153,190,344,321.22222222222223,345.3,343.3333333333333,393.0875,4,10,9,25
2022_12_ATL_WAS,WAS,ATL,12,2022,138,176,174,167,314,341,345.1818181818182,330.09090909090907,309.2929292929293,347.6363636363636,9,5,2,10
2022_12_BAL_JAX,JAX,BAL,12,2022,321,38,254,162,359,416,373,360.5,434.8125,301.03,25,20,31,1
2022_12_BUF_DET,DET,BUF,12,2022,240,96,253,164,336,417,377.6,427.8,352,390.7,26,31,14,29
2022_12_CHI_NYJ,NYJ,CHI,12,2022,315,158,179,127,473,306,330.2,347.6363636363636,335.8,330.09090909090907,6,10,8,5
2022_12_CIN_TEN,TEN,CIN,12,2022,291,63,270,108,354,378,311.9,388.6,359.59000000000003,330.6,3,28,19,7
2022_12_DEN_CAR,CAR,DEN,12,2022,164,185,142,121,349,263,301.72727272727275,347.8,360.8686868686869,357.7,1,11,20,17
2022_12_GB_PHI,PHI,GB,12,2022,153,363,253,106,516,359,385.5,360.3636363636364,348.09000000000003,310.75757575757575,27,19,12,3
2022_12_HOU_MIA,MIA,HOU,12,2022,305,66,215,36,371,251,403.6,308.1,390.0375,345.17,30,2,28,9
2022_12_LA_KC,KC,LA,12,2022,320,117,106,116,437,222,441.1,313.3,360.9,371.45,32,4,21,22
2022_12_LAC_ARI,ARI,LAC,12,2022,191,181,274,65,372,339,353.90909090909093,360.9,372.3535353535354,441.1,15,21,24,32
2022_12_LV_SEA,SEA,LV,12,2022,328,65,295,283,393,578,371.7,357.7,351.2,347.8,23,17,13,11
2022_12_NE_MIN,MIN,NE,12,2022,310,57,382,45,367,427,358.4,335.8,354.5,330.2,18,8,16,6
2022_12_NO_SF,SF,NO,12,2022,222,96,204,63,318,267,372.5,371.54545454545456,353.81,312.71717171717177,24,22,15,4
2022_12_NYG_DAL,DAL,NYG,12,2022,261,169,228,90,430,318,354.5,352,358.4,377.6,16,14,18,25
2022_12_PIT_IND,IND,PIT,12,2022,199,110,174,172,309,346,348.45454545454544,330.6,386.0505050505051,388.6,12,7,26,27
2022_12_TB_CLE,CLE,TB,12,2022,210,189,246,96,399,342,390.7,351.2,427.8,371.7,29,13,30,23
2022_13_BUF_NE,NE,BUF,13,2022,195,60,223,132,255,355,344.09090909090907,426.8181818181818,359.1818181818182,373.8181818181818,9,29,15,23
2022_13_CLE_HOU,HOU,CLE,13,2022,201,82,131,174,283,305,302.90909090909093,391.45454545454544,400.6363636363636,350.3636363636364,1,26,28,13
2022_13_DEN_BAL,BAL,DEN,13,2022,198,103,189,88,301,277,365.54545454545456,340.09090909090907,371.72727272727275,306.02479338842977,19,6,21,3
2022_13_GB_CHI,CHI,GB,13,2022,254,155,182,175,409,357,344.1666666666667,360.25,342.09999999999997,396.375,10,16,7,27
2022_13_IND_DAL,DAL,IND,13,2022,170,220,233,106,390,339,361.3636363636364,345.1666666666667,348.90909090909093,331.8833333333334,17,11,12,6
2022_13_JAX_DET,DET,JAX,13,2022,340,100,185,95,440,280,373.8181818181818,371.72727272727275,426.8181818181818,365.54545454545456,23,21,29,19
2022_13_KC_CIN,CIN,KC,13,2022,286,152,223,138,438,361,387.6363636363636,440.72727272727275,315.72727272727275,305,25,30,4,2
2022_13_LAC_LV,LV,LAC,13,2022,250,154,335,72,404,407,377.72727272727275,358.90909090909093,373.6363636363636,355.5537190082645,24,14,22,14
2022_13_MIA_SF,SF,MIA,13,2022,266,121,295,33,387,328,367.54545454545456,400.6363636363636,362.0413223140496,302.90909090909093,20,28,18,1
2022_13_NO_TB,TB,NO,13,2022,281,76,250,66,357,316,350.3636363636364,362.8333333333333,391.45454545454544,367.9583333333333,13,18,26,20
2022_13_NYJ_MIN,MIN,NYJ,13,2022,173,128,369,120,301,489,359.1818181818182,343.1818181818182,344.09090909090907,343.85123966942143,15,8,10,9
2022_13_PIT_ATL,ATL,PIT,13,2022,167,146,197,154,313,351,330.99999999999994,332,342.5833333333333,344.8677685950413,4,5,8,11
2022_13_SEA_LA,LA,SEA,13,2022,178,171,367,90,349,457,305,373.6363636363636,440.72727272727275,377.72727272727275,2,22,30,24
2022_13_TEN_PHI,PHI,TEN,13,2022,391,67,157,87,458,244,397.3636363636364,315.72727272727275,360.23966942148763,387.6363636363636,27,3,16,25
2022_13_WAS_NYG,NYG,WAS,13,2022,200,134,275,165,334,440,348.90909090909093,342.5833333333333,361.3636363636364,330.99999999999994,12,7,17,5
2022_14_BAL_PIT,PIT,BAL,14,2022,276,65,104,215,341,319,333.5833333333333,360.1666666666667,329.49999999999994,334.8333333333333,5,13,4,5
2022_14_CAR_SEA,SEA,CAR,14,2022,264,46,120,223,310,343,380.5833333333333,305.6666666666667,308.6666666666667,340.73333333333335,20,2,2,7
2022_14_CLE_CIN,CIN,CLE,14,2022,239,136,276,71,375,347,391.8333333333333,384.25,434.0833333333333,301.25000000000006,22,21,26,1
2022_14_HOU_DAL,DAL,HOU,14,2022,284,127,213,114,411,327,363.75,301.25000000000006,344.65277777777783,384.25,15,1,8,21
2022_14_JAX_TEN,TEN,JAX,14,2022,254,137,368,60,391,428,309.75,364.0833333333333,402.4166666666667,379.3333333333333,4,16,24,18
2022_14_KC_DEN,DEN,KC,14,2022,263,106,352,89,369,441,334.8333333333333,434.0833333333333,360.1666666666667,391.8333333333333,6,26,14,22
2022_14_LV_LA,LA,LV,14,2022,230,71,137,165,301,302,308.6666666666667,379.9166666666667,380.5833333333333,362.9166666666667,3,19,20,15
2022_14_MIA_LAC,LAC,MIA,14,2022,367,82,145,92,449,237,362.9166666666667,394.5833333333333,379.9166666666667,369.1666666666667,14,23,19,17
2022_14_MIN_DET,DET,MIN,14,2022,330,134,425,22,464,447,379.3333333333333,354.3333333333333,364.0833333333333,355.3333333333333,18,10,16,11
2022_14_NE_ARI,ARI,NE,14,2022,255,113,235,103,368,338,355.4166666666667,336.66666666666663,359.075,420.8333333333333,12,7,13,25
2022_14_NYJ_BUF,BUF,NYJ,14,2022,147,102,269,76,249,345,420.8333333333333,355.3333333333333,336.66666666666663,354.3333333333333,25,11,6,10
2022_14_PHI_NYG,NYG,PHI,14,2022,216,123,217,253,339,470,347.6666666666667,402.4166666666667,350.70138888888886,309.75,8,24,9,3
2022_14_TB_SF,SF,TB,14,2022,195,209,253,69,404,322,369.1666666666667,350.9166666666667,394.5833333333333,358.9305555555555,17,9,23,12
2022_15_ARI_DEN,DEN,ARI,15,2022,197,168,173,73,365,246,337.46153846153845,356.38461538461536,434.61538461538464,336.7692307692308,8,15,32,7
2022_15_ATL_NO,NO,ATL,15,2022,231,134,97,231,365,328,359.2307692307692,329.6153846153845,350.87412587412587,333.46153846153845,17,5,13,5
2022_15_BAL_CLE,CLE,BAL,15,2022,161,143,138,198,304,336,381.38461538461536,357,390.53846153846155,334.15384615384613,26,16,29,6
2022_15_CIN_TB,TB,CIN,15,2022,312,92,200,53,404,253,348.6923076923077,390.53846153846155,371.84615384615387,381.38461538461536,11,29,23,26
2022_15_DAL_JAX,JAX,DAL,15,2022,318,192,256,154,510,410,369,367.38461538461536,316,303.2307692307693,21,20,4,1
2022_15_DET_NYJ,NYJ,DET,15,2022,317,50,252,107,367,359,354.53846153846155,385.84615384615387,407.61538461538464,361.46153846153845,14,28,31,18
2022_15_IND_MIN,MIN,IND,15,2022,460,92,182,171,552,353,361.46153846153845,344.6923076923077,385.84615384615387,363.56643356643355,19,9,28,19
2022_15_KC_HOU,HOU,KC,15,2022,129,94,336,189,223,525,303.2307692307693,434.61538461538464,367.38461538461536,337.46153846153845,1,32,20,8
2022_15_LA_GB,GB,LA,15,2022,229,138,111,72,367,183,360,308.0769230769231,349.15384615384613,373.9230769230769,18,2,12,24
2022_15_MIA_BUF,BUF,MIA,15,2022,304,150,234,188,454,422,407.61538461538464,382.46153846153845,354.53846153846155,369.53846153846155,31,27,14,22
2022_15_NE_LV,LV,NE,15,2022,231,97,112,226,328,338,373.9230769230769,336.7692307692308,308.0769230769231,356.38461538461536,24,7,2,15
2022_15_NYG_WAS,WAS,NYG,15,2022,249,159,160,128,408,288,350.0769230769231,347,347.76223776223776,407.61538461538464,13,10,10,31
2022_15_PHI_CHI,CHI,PHI,15,2022,152,157,315,112,309,427,349.15384615384613,407.61538461538464,360,347,12,31,17,9
2022_15_PIT_CAR,CAR,PIT,15,2022,225,21,179,156,246,335,308.53846153846155,334.15384615384613,375.15384615384613,357,3,6,25,16
2022_15_SF_SEA,SEA,SF,15,2022,238,70,217,170,308,387,375.15384615384613,371.84615384615387,308.53846153846155,348.6923076923077,25,23,3,11
2022_15_TEN_LAC,LAC,TEN,15,2022,313,74,185,127,387,312,369.53846153846155,316,382.46153846153845,369,22,4,27,21
2022_16_ATL_BAL,BAL,ATL,16,2022,115,184,218,115,299,333,355.5,329.49999999999994,375.85714285714283,359.64285714285717,16,5,25,17
2022_16_BUF_CHI,CHI,BUF,16,2022,144,80,172,254,224,426,346.2857142857143,410.92857142857144,409,385.2857142857143,11,31,30,29
2022_16_CIN_NE,NE,CIN,16,2022,240,61,375,73,301,448,336.85714285714283,380.7142857142857,370.64285714285717,352.64285714285717,7,27,21,13
2022_16_DEN_LA,LA,DEN,16,2022,230,158,259,104,388,363,299.14285714285717,339.42857142857144,360.5,348.5,2,8,18,12
2022_16_DET_CAR,CAR,DET,16,2022,250,320,355,45,570,400,304.07142857142856,383.92857142857144,334.2142857142857,355.42857142857144,3,28,6,15
2022_16_GB_MIA,MIA,GB,16,2022,310,82,238,79,392,317,385.2857142857143,360.5,410.92857142857144,299.14285714285717,29,18,31,2
2022_16_HOU_TEN,TEN,HOU,16,2022,99,184,218,70,283,288,315.7142857142857,297.50000000000006,370.7857142857143,441.07142857142856,4,1,22,32
2022_16_JAX_NYJ,NYJ,JAX,16,2022,182,66,229,147,248,376,355.42857142857144,379.07142857142856,383.92857142857144,370.42857142857144,15,26,28,20
2022_16_LAC_IND,IND,LAC,16,2022,143,69,235,101,212,336,345.2857142857143,370.7857142857143,375.07142857142856,315.7142857142857,10,22,24,4
2022_16_LV_PIT,PIT,LV,16,2022,244,106,174,58,350,232,334.2142857142857,370.64285714285717,304.07142857142856,336.85714285714283,6,21,3,7
2022_16_NO_CLE,CLE,NO,16,2022,135,124,92,152,259,244,375.85714285714283,359.64285714285717,355.5,329.49999999999994,25,17,16,5
2022_16_NYG_MIN,MIN,NYG,16,2022,299,83,334,126,382,460,375.07142857142856,342.7857142857143,345.2857142857143,354.2142857142857,24,9,10,14
2022_16_PHI_DAL,DAL,PHI,16,2022,347,115,355,87,462,442,370.42857142857144,409,379.07142857142856,346.2857142857143,20,30,26,11
2022_16_SEA_KC,KC,SEA,16,2022,224,77,215,133,301,348,441.07142857142856,370.35714285714283,297.50000000000006,372.92857142857144,32,19,1,23
2022_16_TB_ARI,ARI,TB,16,2022,221,121,281,115,342,396,348.5,352.64285714285717,339.42857142857144,380.7142857142857,12,13,8,27
2022_16_WAS_SF,SF,WAS,16,2022,234,153,289,79,387,368,372.92857142857144,354.2142857142857,370.35714285714283,342.7857142857143,23,14,19,9
2022_17_ARI_ATL,ATL,ARI,17,2022,169,132,222,126,301,348,329.7333333333333,348.06666666666666,351.73333333333335,355.53333333333336,5,11,12,15
2022_17_CAR_TB,TB,CAR,17,2022,432,67,341,74,499,415,355.53333333333336,321.8,348.06666666666666,385,17,4,9,25
2022_17_CHI_DET,DET,CHI,17,2022,255,265,75,200,520,275,385,338.1333333333333,321.8,411.93333333333334,27,9,4,29
2022_17_CLE_WAS,WAS,CLE,17,2022,143,136,169,146,279,315,355.1333333333333,368.06666666666666,373.8666666666667,351.93333333333334,16,20,21,13
2022_17_DAL_TEN,TEN,DAL,17,2022,232,97,282,87,329,369,313.53333333333336,376.53333333333336,296.86666666666673,411.2,3,25,1,28
2022_17_DEN_KC,KC,DEN,17,2022,328,46,222,117,374,339,431.73333333333335,341,368.8666666666667,305.06666666666666,30,10,20,2
2022_17_IND_NYG,NYG,IND,17,2022,177,217,141,128,394,269,350.6,336.4,375.53333333333336,368.46666666666664,13,8,22,19
2022_17_JAX_HOU,HOU,JAX,17,2022,211,84,181,169,295,350,296.86666666666673,378.8666666666667,313.53333333333336,348.26666666666665,1,26,3,10
2022_17_LA_LAC,LAC,LA,17,2022,239,192,132,166,431,298,368.46666666666664,305.06666666666666,336.4,341,21,2,7,8
2022_17_MIA_NE,NE,MIA,17,2022,204,76,265,86,280,351,334.46666666666664,385.73333333333335,385.2,357.6,6,28,26,16
2022_17_MIN_GB,GB,MIN,17,2022,168,163,262,102,331,364,357.6,375.53333333333336,385.73333333333335,350.6,18,24,27,11
2022_17_NO_PHI,PHI,NO,17,2022,274,67,229,129,341,358,411.2,351.93333333333334,376.53333333333336,368.06666666666666,29,15,23,18
2022_17_NYJ_SEA,SEA,NYJ,17,2022,183,198,240,75,381,315,368.8666666666667,348.26666666666665,431.73333333333335,378.8666666666667,22,12,30,24
2022_17_PIT_BAL,BAL,PIT,17,2022,130,120,168,198,250,366,351.73333333333335,335.26666666666665,329.7333333333333,361.4,14,7,5,17
2022_17_SF_LV,LV,SF,17,2022,365,135,284,170,500,454,361.4,373.8666666666667,335.26666666666665,355.1333333333333,19,23,6,14
2022_18_ARI_SF,SF,ARI,18,2022,178,169,209,61,347,270,378.875,348.0625,370.0625,327.93749999999994,26,13,23,5
2022_18_BAL_CIN,CIN,BAL,18,2022,215,55,286,110,270,396,385.2,345.375,334.46666666666664,337.1875,28,11,9,10
2022_18_CAR_NO,NO,CAR,18,2022,171,143,43,171,314,214,352.3125,327.625,406.8125,364.5,15,4,31,20
2022_18_CLE_PIT,PIT,CLE,18,2022,195,144,230,134,339,364,337.1875,364.75,345.375,350.375,9,19,13,16
2022_18_DAL_WAS,WAS,DAL,18,2022,169,151,128,64,320,192,350.375,376.0625,364.75,314.5,14,24,21,3
2022_18_DET_GB,GB,DET,18,2022,205,103,224,104,308,328,355.9375,393.4375,374.8125,334.1875,17,29,25,8
2022_18_HOU_IND,IND,HOU,18,2022,209,196,311,59,405,370,332.1875,296.75000000000006,353.3125,377.0625,7,1,18,27
2022_18_KC_LV,LV,KC,18,2022,219,99,202,168,318,370,370.0625,428.125,378.875,340.875,21,32,28,12
2022_18_LA_SEA,SEA,LA,18,2022,213,197,147,146,410,293,369.625,304.625,346.1875,372.375,20,2,14,24
2022_18_LAC_DEN,DEN,LAC,18,2022,283,205,298,59,488,357,340.875,372.375,428.125,304.625,10,22,32,2
2022_18_MIN_CHI,CHI,MIN,18,2022,147,118,341,141,265,482,334.1875,374.8125,393.4375,355.9375,8,23,30,19
2022_18_NE_BUF,BUF,NE,18,2022,254,90,243,107,344,350,411.93333333333334,331.0625,338.1333333333333,383.5625,31,6,11,29
2022_18_NYG_PHI,PHI,NYG,18,2022,229,135,168,129,364,297,406.8125,353.3125,352.3125,332.1875,30,16,17,7
2022_18_NYJ_MIA,MIA,NYJ,18,2022,152,162,149,38,314,187,383.5625,346.1875,331.0625,369.625,27,12,6,22
2022_18_TB_ATL,ATL,TB,18,2022,224,174,136,86,398,222,327.93749999999994,364.5,348.0625,327.625,5,18,15,4
2022_18_TEN_JAX,JAX,TEN,18,2022,212,19,179,147,231,326,377.0625,314.5,296.75000000000006,376.0625,25,3,1,26
2022_19_BAL_CIN,CIN,BAL,19,2022,209,51,226,155,260,381,378,348.3529411764706,348.5390625,378.4235294117647,9,1,8,11
2022_19_DAL_TB,TB,DAL,19,2022,351,52,305,128,403,433,356.11764705882354,365.2352941176471,332.0588235294117,348.5882352941176,3,4,4,9
2022_19_LAC_JAX,JAX,LAC,19,2022,288,117,273,67,405,340,368.47058823529414,371.47058823529414,315.1764705882353,349.52941176470586,5,6,2,10
2022_19_MIA_BUF,BUF,MIA,19,2022,352,107,220,42,459,262,407.6875,379.47058823529414,332.24609375,336.8235294117647,12,10,5,6
2022_19_NYG_MIN,MIN,NYG,19,2022,271,61,301,142,332,443,381.11764705882354,350,330.11764705882354,404.29411764705884,11,2,3,12
2022_19_SEA_SF,SF,SEA,19,2022,332,181,253,104,513,357,377,372,343.47058823529414,303.94117647058823,8,7,7,1
2022_20_CIN_BUF,BUF,CIN,20,2022,265,63,242,172,328,414,410.70588235294116,371.05882352941177,372.56055363321803,350.2733564013841,7,4,7,2
2022_20_DAL_SF,SF,DAL,20,2022,214,113,206,76,327,282,384.55555555555554,369,371.1666666666667,358.72222222222223,5,2,6,3
2022_20_JAX_KC,KC,JAX,20,2022,218,144,217,144,362,361,424.70588235294116,370.5,367,369.72222222222223,8,3,4,5
2022_20_NYG_PHI,PHI,NYG,20,2022,154,268,135,118,422,253,404.29411764705884,355.1666666666667,350,378.3888888888889,6,1,1,8
2022_21_CIN_KC,KC,CIN,21,2022,326,42,270,71,368,341,421.22222222222223,373.44444444444446,369.97222222222223,406.1111111111111,4,1,3,4
2022_21_SF_PHI,PHI,SF,21,2022,121,148,97,81,269,178,405.27777777777777,381.5263157894737,349.49074074074076,364.42105263157896,3,2,1,2
2022_22_KC_PHI,PHI,KC,22,2022,304,115,182,156,419,338,398.10526315789474,418.42105263157896,370.81440443213296,371.7368421052632,1,2,1,2
